PokerStars Hand #213862156939:  Hold'em No Limit ($0.01/$0.02 USD) - 2020/05/14 21:26:15 MSK [2020/05/14 14:26:15 ET]
Table 'Euforbo IV' 6-max Seat #5 is the button
Seat 1: lawlex_2 ($2 in chips) 
Seat 2: Gor4477 ($3.75 in chips) 
Seat 3: KAMBU-CR ($4.45 in chips) 
Seat 4: PTICIN ($1.16 in chips) 
Seat 5: Wawa79669 ($0.97 in chips) 
Seat 6: nneegri ($2.16 in chips) 
nneegri: posts small blind $0.01
lawlex_2: posts big blind $0.02
*** HOLE CARDS ***
Dealt to lawlex_2 [4c Jh]
Gor4477: folds 
KAMBU-CR: folds 
PTICIN: folds 
Wawa79669: calls $0.02
nneegri: raises $0.08 to $0.10
lawlex_2: folds 
Wawa79669: calls $0.08
*** FLOP *** [4h Qs 6c]
nneegri: checks 
Wawa79669: bets $0.21
nneegri: calls $0.21
*** TURN *** [4h Qs 6c] [3s]
nneegri: bets $0.66
Wawa79669: calls $0.66 and is all-in
*** RIVER *** [4h Qs 6c 3s] [2s]
*** SHOW DOWN ***
nneegri: shows [Kc Ah] (high card Ace)
Wawa79669: shows [6d Qd] (two pair, Queens and Sixes)
Wawa79669 collected $1.89 from pot
*** SUMMARY ***
Total pot $1.96 | Rake $0.07 
Board [4h Qs 6c 3s 2s]
Seat 1: lawlex_2 (big blind) folded before Flop
Seat 2: Gor4477 folded before Flop (didn't bet)
Seat 3: KAMBU-CR folded before Flop (didn't bet)
Seat 4: PTICIN folded before Flop (didn't bet)
Seat 5: Wawa79669 (button) showed [6d Qd] and won ($1.89) with two pair, Queens and Sixes
Seat 6: nneegri (small blind) showed [Kc Ah] and lost with high card Ace



PokerStars Hand #213862207381:  Hold'em No Limit ($0.01/$0.02 USD) - 2020/05/14 21:27:08 MSK [2020/05/14 14:27:08 ET]
Table 'Euforbo IV' 6-max Seat #6 is the button
Seat 1: lawlex_2 ($1.98 in chips) 
Seat 2: Gor4477 ($3.75 in chips) 
Seat 3: KAMBU-CR ($4.45 in chips) 
Seat 4: PTICIN ($1.16 in chips) 
Seat 5: Wawa79669 ($1.89 in chips) 
Seat 6: nneegri ($1.19 in chips) 
lawlex_2: posts small blind $0.01
Gor4477: posts big blind $0.02
*** HOLE CARDS ***
Dealt to lawlex_2 [Kh 8h]
KAMBU-CR: folds 
PTICIN: folds 
Wawa79669: folds 
nneegri: folds 
lawlex_2: folds 
Uncalled bet ($0.01) returned to Gor4477
Gor4477 collected $0.02 from pot
Gor4477: doesn't show hand 
*** SUMMARY ***
Total pot $0.02 | Rake $0 
Seat 1: lawlex_2 (small blind) folded before Flop
Seat 2: Gor4477 (big blind) collected ($0.02)
Seat 3: KAMBU-CR folded before Flop (didn't bet)
Seat 4: PTICIN folded before Flop (didn't bet)
Seat 5: Wawa79669 folded before Flop (didn't bet)
Seat 6: nneegri (button) folded before Flop (didn't bet)



PokerStars Hand #213862219159:  Hold'em No Limit ($0.01/$0.02 USD) - 2020/05/14 21:27:20 MSK [2020/05/14 14:27:20 ET]
Table 'Euforbo IV' 6-max Seat #1 is the button
Seat 1: lawlex_2 ($1.97 in chips) 
Seat 2: Gor4477 ($3.76 in chips) 
Seat 3: KAMBU-CR ($4.45 in chips) 
Seat 4: PTICIN ($1.16 in chips) 
Seat 5: Wawa79669 ($1.89 in chips) 
Seat 6: nneegri ($1.19 in chips) 
Gor4477: posts small blind $0.01
KAMBU-CR: posts big blind $0.02
*** HOLE CARDS ***
Dealt to lawlex_2 [Ks 6s]
PTICIN: folds 
Wawa79669: folds 
nneegri: folds 
lawlex_2: folds 
Gor4477: raises $0.04 to $0.06
KAMBU-CR: folds 
Uncalled bet ($0.04) returned to Gor4477
Gor4477 collected $0.04 from pot
Gor4477: doesn't show hand 
*** SUMMARY ***
Total pot $0.04 | Rake $0 
Seat 1: lawlex_2 (button) folded before Flop (didn't bet)
Seat 2: Gor4477 (small blind) collected ($0.04)
Seat 3: KAMBU-CR (big blind) folded before Flop
Seat 4: PTICIN folded before Flop (didn't bet)
Seat 5: Wawa79669 folded before Flop (didn't bet)
Seat 6: nneegri folded before Flop (didn't bet)



PokerStars Hand #213862236877:  Hold'em No Limit ($0.01/$0.02 USD) - 2020/05/14 21:27:38 MSK [2020/05/14 14:27:38 ET]
Table 'Euforbo IV' 6-max Seat #2 is the button
Seat 1: lawlex_2 ($1.97 in chips) 
Seat 2: Gor4477 ($3.78 in chips) 
Seat 3: KAMBU-CR ($4.43 in chips) 
Seat 5: Wawa79669 ($1.89 in chips) 
Seat 6: nneegri ($1.19 in chips) 
KAMBU-CR: posts small blind $0.01
PTICIN: is sitting out 
Wawa79669: posts big blind $0.02
*** HOLE CARDS ***
Dealt to lawlex_2 [Qc Th]
PTICIN leaves the table
nneegri: calls $0.02
lawlex_2: raises $0.03 to $0.05
Gor4477: folds 
MartinBrann joins the table at seat #4 
KAMBU-CR: folds 
Wawa79669: calls $0.03
nneegri: calls $0.03
*** FLOP *** [2c 7s Js]
Wawa79669: checks 
nneegri: bets $0.15
lawlex_2: folds 
Wawa79669: folds 
Uncalled bet ($0.15) returned to nneegri
nneegri collected $0.15 from pot
nneegri: doesn't show hand 
*** SUMMARY ***
Total pot $0.16 | Rake $0.01 
Board [2c 7s Js]
Seat 1: lawlex_2 folded on the Flop
Seat 2: Gor4477 (button) folded before Flop (didn't bet)
Seat 3: KAMBU-CR (small blind) folded before Flop
Seat 5: Wawa79669 (big blind) folded on the Flop
Seat 6: nneegri collected ($0.15)



PokerStars Hand #213862274967:  Hold'em No Limit ($0.01/$0.02 USD) - 2020/05/14 21:28:18 MSK [2020/05/14 14:28:18 ET]
Table 'Euforbo IV' 6-max Seat #3 is the button
Seat 1: lawlex_2 ($1.92 in chips) 
Seat 2: Gor4477 ($3.78 in chips) 
Seat 3: KAMBU-CR ($4.42 in chips) 
Seat 5: Wawa79669 ($1.84 in chips) 
Seat 6: nneegri ($1.29 in chips) 
Wawa79669: posts small blind $0.01
nneegri: posts big blind $0.02
*** HOLE CARDS ***
Dealt to lawlex_2 [Tc 3s]
lawlex_2: folds 
Gor4477: folds 
KAMBU-CR: raises $0.04 to $0.06
Wawa79669: calls $0.05
nneegri: raises $0.16 to $0.22
KAMBU-CR: folds 
Wawa79669: calls $0.16
*** FLOP *** [5h Th 7h]
Wawa79669: checks 
nneegri: bets $0.10
Wawa79669: calls $0.10
*** TURN *** [5h Th 7h] [Jc]
Wawa79669: bets $0.02
nneegri: raises $0.20 to $0.22
Wawa79669: calls $0.20
*** RIVER *** [5h Th 7h Jc] [Ks]
Wawa79669: checks 
nneegri: bets $0.75 and is all-in
Wawa79669: calls $0.75
*** SHOW DOWN ***
nneegri: shows [7d 7s] (three of a kind, Sevens)
Wawa79669: shows [Jd 5c] (two pair, Jacks and Fives)
nneegri collected $2.55 from pot
*** SUMMARY ***
Total pot $2.64 | Rake $0.09 
Board [5h Th 7h Jc Ks]
Seat 1: lawlex_2 folded before Flop (didn't bet)
Seat 2: Gor4477 folded before Flop (didn't bet)
Seat 3: KAMBU-CR (button) folded before Flop
Seat 5: Wawa79669 (small blind) showed [Jd 5c] and lost with two pair, Jacks and Fives
Seat 6: nneegri (big blind) showed [7d 7s] and won ($2.55) with three of a kind, Sevens



PokerStars Hand #213862350844:  Hold'em No Limit ($0.01/$0.02 USD) - 2020/05/14 21:29:37 MSK [2020/05/14 14:29:37 ET]
Table 'Euforbo IV' 6-max Seat #5 is the button
Seat 1: lawlex_2 ($1.92 in chips) 
Seat 2: Gor4477 ($3.78 in chips) 
Seat 3: KAMBU-CR ($4.36 in chips) 
Seat 4: MartinBrann ($2 in chips) 
Seat 5: Wawa79669 ($0.55 in chips) 
Seat 6: nneegri ($2.55 in chips) 
nneegri: posts small blind $0.01
lawlex_2: posts big blind $0.02
MartinBrann: posts big blind $0.02
*** HOLE CARDS ***
Dealt to lawlex_2 [3c Qs]
Gor4477: folds 
KAMBU-CR: raises $0.08 to $0.10
MartinBrann: calls $0.08
Wawa79669: calls $0.10
nneegri: folds 
lawlex_2: folds 
*** FLOP *** [9s 7d Ac]
KAMBU-CR: checks 
MartinBrann: checks 
Wawa79669: checks 
*** TURN *** [9s 7d Ac] [6h]
KAMBU-CR: bets $0.06
MartinBrann: folds 
Wawa79669: folds 
Uncalled bet ($0.06) returned to KAMBU-CR
KAMBU-CR collected $0.32 from pot
KAMBU-CR: doesn't show hand 
*** SUMMARY ***
Total pot $0.33 | Rake $0.01 
Board [9s 7d Ac 6h]
Seat 1: lawlex_2 (big blind) folded before Flop
Seat 2: Gor4477 folded before Flop (didn't bet)
Seat 3: KAMBU-CR collected ($0.32)
Seat 4: MartinBrann folded on the Turn
Seat 5: Wawa79669 (button) folded on the Turn
Seat 6: nneegri (small blind) folded before Flop



PokerStars Hand #213862407534:  Hold'em No Limit ($0.01/$0.02 USD) - 2020/05/14 21:30:35 MSK [2020/05/14 14:30:35 ET]
Table 'Euforbo IV' 6-max Seat #6 is the button
Seat 1: lawlex_2 ($1.90 in chips) 
Seat 2: Gor4477 ($3.78 in chips) 
Seat 3: KAMBU-CR ($4.58 in chips) 
Seat 4: MartinBrann ($1.90 in chips) 
Seat 5: Wawa79669 ($0.45 in chips) 
Seat 6: nneegri ($2.54 in chips) 
lawlex_2: posts small blind $0.01
Gor4477: posts big blind $0.02
*** HOLE CARDS ***
Dealt to lawlex_2 [Ts 3h]
KAMBU-CR: raises $0.04 to $0.06
MartinBrann: raises $0.04 to $0.10
Wawa79669: calls $0.10
nneegri: folds 
lawlex_2: folds 
Gor4477: folds 
KAMBU-CR: calls $0.04
*** FLOP *** [9s 3d Ad]
KAMBU-CR: checks 
MartinBrann: bets $0.25
Wawa79669: folds 
KAMBU-CR: folds 
Uncalled bet ($0.25) returned to MartinBrann
MartinBrann collected $0.32 from pot
MartinBrann: doesn't show hand 
*** SUMMARY ***
Total pot $0.33 | Rake $0.01 
Board [9s 3d Ad]
Seat 1: lawlex_2 (small blind) folded before Flop
Seat 2: Gor4477 (big blind) folded before Flop
Seat 3: KAMBU-CR folded on the Flop
Seat 4: MartinBrann collected ($0.32)
Seat 5: Wawa79669 folded on the Flop
Seat 6: nneegri (button) folded before Flop (didn't bet)



PokerStars Hand #213862485654:  Hold'em No Limit ($0.01/$0.02 USD) - 2020/05/14 21:31:56 MSK [2020/05/14 14:31:56 ET]
Table 'Euforbo IV' 6-max Seat #1 is the button
Seat 1: lawlex_2 ($1.89 in chips) 
Seat 2: Gor4477 ($3.76 in chips) 
Seat 3: KAMBU-CR ($4.48 in chips) 
Seat 4: MartinBrann ($2.12 in chips) 
Seat 5: Wawa79669 ($0.35 in chips) 
Seat 6: nneegri ($2.54 in chips) 
Gor4477: posts small blind $0.01
KAMBU-CR: posts big blind $0.02
*** HOLE CARDS ***
Dealt to lawlex_2 [Ah As]
MartinBrann: folds 
MartinBrann leaves the table
Wawa79669: calls $0.02
délichoc joins the table at seat #4 
nneegri: calls $0.02
lawlex_2: raises $0.03 to $0.05
Gor4477: folds 
KAMBU-CR: folds 
Wawa79669: calls $0.03
nneegri: calls $0.03
*** FLOP *** [Qh 8h Ad]
Wawa79669: checks 
nneegri: checks 
lawlex_2: bets $0.11
Wawa79669: folds 
nneegri: folds 
Uncalled bet ($0.11) returned to lawlex_2
lawlex_2 collected $0.17 from pot
lawlex_2: doesn't show hand 
*** SUMMARY ***
Total pot $0.18 | Rake $0.01 
Board [Qh 8h Ad]
Seat 1: lawlex_2 (button) collected ($0.17)
Seat 2: Gor4477 (small blind) folded before Flop
Seat 3: KAMBU-CR (big blind) folded before Flop
Seat 4: MartinBrann folded before Flop (didn't bet)
Seat 5: Wawa79669 folded on the Flop
Seat 6: nneegri folded on the Flop



PokerStars Hand #213862551276:  Hold'em No Limit ($0.01/$0.02 USD) - 2020/05/14 21:32:55 MSK [2020/05/14 14:32:55 ET]
Table 'Euforbo IV' 6-max Seat #2 is the button
Seat 1: lawlex_2 ($2.01 in chips) 
Seat 2: Gor4477 ($3.75 in chips) 
Seat 3: KAMBU-CR ($4.46 in chips) 
Seat 4: délichoc ($2 in chips) 
Seat 5: Wawa79669 ($0.30 in chips) 
Seat 6: nneegri ($2.49 in chips) 
KAMBU-CR: posts small blind $0.01
délichoc: posts big blind $0.02
*** HOLE CARDS ***
Dealt to lawlex_2 [Qs 5c]
Wawa79669: raises $0.02 to $0.04
nneegri: calls $0.04
lawlex_2: folds 
Gor4477: raises $0.15 to $0.19
KAMBU-CR: folds 
délichoc: folds 
Wawa79669: raises $0.11 to $0.30 and is all-in
nneegri: folds 
Gor4477: calls $0.11
*** FLOP *** [4s 3h 2c]
*** TURN *** [4s 3h 2c] [6d]
*** RIVER *** [4s 3h 2c 6d] [2h]
*** SHOW DOWN ***
Wawa79669: shows [Jc Ac] (a pair of Deuces)
Gor4477: shows [Ad Kd] (a pair of Deuces - Ace+King kicker)
Gor4477 collected $0.65 from pot
*** SUMMARY ***
Total pot $0.67 | Rake $0.02 
Board [4s 3h 2c 6d 2h]
Seat 1: lawlex_2 folded before Flop (didn't bet)
Seat 2: Gor4477 (button) showed [Ad Kd] and won ($0.65) with a pair of Deuces
Seat 3: KAMBU-CR (small blind) folded before Flop
Seat 4: délichoc (big blind) folded before Flop
Seat 5: Wawa79669 showed [Jc Ac] and lost with a pair of Deuces
Seat 6: nneegri folded before Flop



PokerStars Hand #213862584694:  Hold'em No Limit ($0.01/$0.02 USD) - 2020/05/14 21:33:29 MSK [2020/05/14 14:33:29 ET]
Table 'Euforbo IV' 6-max Seat #3 is the button
Seat 1: lawlex_2 ($2.01 in chips) 
Seat 2: Gor4477 ($4.10 in chips) 
Seat 3: KAMBU-CR ($4.45 in chips) 
Seat 4: délichoc ($2 in chips) 
Seat 6: nneegri ($2.45 in chips) 
délichoc: posts small blind $0.01
nneegri: posts big blind $0.02
*** HOLE CARDS ***
Dealt to lawlex_2 [Ks Kc]
lawlex_2: raises $0.03 to $0.05
Gor4477: folds 
KAMBU-CR: folds 
délichoc: folds 
nneegri: folds 
Uncalled bet ($0.03) returned to lawlex_2
lawlex_2 collected $0.05 from pot
lawlex_2: doesn't show hand 
*** SUMMARY ***
Total pot $0.05 | Rake $0 
Seat 1: lawlex_2 collected ($0.05)
Seat 2: Gor4477 folded before Flop (didn't bet)
Seat 3: KAMBU-CR (button) folded before Flop (didn't bet)
Seat 4: délichoc (small blind) folded before Flop
Seat 6: nneegri (big blind) folded before Flop



PokerStars Hand #213862611016:  Hold'em No Limit ($0.01/$0.02 USD) - 2020/05/14 21:33:56 MSK [2020/05/14 14:33:56 ET]
Table 'Euforbo IV' 6-max Seat #4 is the button
Seat 1: lawlex_2 ($2.04 in chips) 
Seat 2: Gor4477 ($4.10 in chips) 
Seat 3: KAMBU-CR ($4.45 in chips) 
Seat 4: délichoc ($2 in chips) 
lawlex_2: posts small blind $0.01
Gor4477: posts big blind $0.02
*** HOLE CARDS ***
Dealt to lawlex_2 [Ts 4s]
KAMBU-CR: folds 
délichoc: folds 
lawlex_2: folds 
Uncalled bet ($0.01) returned to Gor4477
Gor4477 collected $0.02 from pot
Gor4477: doesn't show hand 
*** SUMMARY ***
Total pot $0.02 | Rake $0 
Seat 1: lawlex_2 (small blind) folded before Flop
Seat 2: Gor4477 (big blind) collected ($0.02)
Seat 3: KAMBU-CR folded before Flop (didn't bet)
Seat 4: délichoc (button) folded before Flop (didn't bet)



PokerStars Hand #213862627076:  Hold'em No Limit ($0.01/$0.02 USD) - 2020/05/14 21:34:13 MSK [2020/05/14 14:34:13 ET]
Table 'Euforbo IV' 6-max Seat #1 is the button
Seat 1: lawlex_2 ($2.03 in chips) 
Seat 2: Gor4477 ($4.11 in chips) 
Seat 3: KAMBU-CR ($4.45 in chips) 
Seat 4: délichoc ($2 in chips) 
Gor4477: posts small blind $0.01
KAMBU-CR: posts big blind $0.02
*** HOLE CARDS ***
Dealt to lawlex_2 [7h Jc]
délichoc: raises $0.04 to $0.06
lawlex_2: folds 
Gor4477: calls $0.05
KAMBU-CR: raises $0.04 to $0.10
délichoc: folds 
Gor4477: calls $0.04
*** FLOP *** [Tc 4d Js]
Gor4477: checks 
KAMBU-CR: bets $0.13
Gor4477: folds 
Uncalled bet ($0.13) returned to KAMBU-CR
KAMBU-CR collected $0.25 from pot
KAMBU-CR: doesn't show hand 
*** SUMMARY ***
Total pot $0.26 | Rake $0.01 
Board [Tc 4d Js]
Seat 1: lawlex_2 (button) folded before Flop (didn't bet)
Seat 2: Gor4477 (small blind) folded on the Flop
Seat 3: KAMBU-CR (big blind) collected ($0.25)
Seat 4: délichoc folded before Flop



PokerStars Hand #213862667864:  Hold'em No Limit ($0.01/$0.02 USD) - 2020/05/14 21:34:54 MSK [2020/05/14 14:34:54 ET]
Table 'Euforbo IV' 6-max Seat #2 is the button
Seat 1: lawlex_2 ($2.03 in chips) 
Seat 2: Gor4477 ($4.01 in chips) 
Seat 3: KAMBU-CR ($4.60 in chips) 
Seat 4: délichoc ($2 in chips) 
KAMBU-CR: posts small blind $0.01
délichoc: posts big blind $0.02
*** HOLE CARDS ***
Dealt to lawlex_2 [7c 9c]
lawlex_2: raises $0.03 to $0.05
Gor4477: folds 
KAMBU-CR: calls $0.04
délichoc: folds 
*** FLOP *** [2d 2c 8c]
KAMBU-CR: checks 
lawlex_2: bets $0.08
KAMBU-CR: calls $0.08
*** TURN *** [2d 2c 8c] [4s]
KAMBU-CR: checks 
lawlex_2: bets $0.18
KAMBU-CR: calls $0.18
*** RIVER *** [2d 2c 8c 4s] [3c]
KAMBU-CR: bets $0.80
lawlex_2: calls $0.80
*** SHOW DOWN ***
KAMBU-CR: shows [8s 8d] (a full house, Eights full of Deuces)
lawlex_2: mucks hand 
KAMBU-CR collected $2.16 from pot
*** SUMMARY ***
Total pot $2.24 | Rake $0.08 
Board [2d 2c 8c 4s 3c]
Seat 1: lawlex_2 mucked [7c 9c]
Seat 2: Gor4477 (button) folded before Flop (didn't bet)
Seat 3: KAMBU-CR (small blind) showed [8s 8d] and won ($2.16) with a full house, Eights full of Deuces
Seat 4: délichoc (big blind) folded before Flop



PokerStars Hand #213862732075:  Hold'em No Limit ($0.01/$0.02 USD) - 2020/05/14 21:35:59 MSK [2020/05/14 14:35:59 ET]
Table 'Euforbo IV' 6-max Seat #3 is the button
Seat 1: lawlex_2 ($0.92 in chips) 
Seat 2: Gor4477 ($4.01 in chips) 
Seat 3: KAMBU-CR ($5.65 in chips) 
Seat 4: délichoc ($2 in chips) 
Seat 5: Wawa79669 ($2 in chips) 
Seat 6: nneegri ($2.43 in chips) 
délichoc: posts small blind $0.01
Wawa79669: posts big blind $0.02
nneegri: posts small blind $0.01
*** HOLE CARDS ***
Dealt to lawlex_2 [Ah Jc]
nneegri: calls $0.02
lawlex_2: raises $0.03 to $0.05
Gor4477: folds 
KAMBU-CR: folds 
délichoc: calls $0.04
Wawa79669: calls $0.03
nneegri: calls $0.03
*** FLOP *** [Jh 9c Td]
délichoc: checks 
Wawa79669: bets $0.10
nneegri: folds 
lawlex_2: raises $0.40 to $0.50
délichoc: folds 
Wawa79669: calls $0.40
*** TURN *** [Jh 9c Td] [Qs]
Wawa79669: checks 
lawlex_2: bets $0.37 and is all-in
Wawa79669: calls $0.37
*** RIVER *** [Jh 9c Td Qs] [4d]
*** SHOW DOWN ***
Wawa79669: shows [Ts 6c] (a pair of Tens)
lawlex_2: shows [Ah Jc] (a pair of Jacks)
lawlex_2 collected $1.88 from pot
*** SUMMARY ***
Total pot $1.95 | Rake $0.07 
Board [Jh 9c Td Qs 4d]
Seat 1: lawlex_2 showed [Ah Jc] and won ($1.88) with a pair of Jacks
Seat 2: Gor4477 folded before Flop (didn't bet)
Seat 3: KAMBU-CR (button) folded before Flop (didn't bet)
Seat 4: délichoc (small blind) folded on the Flop
Seat 5: Wawa79669 (big blind) showed [Ts 6c] and lost with a pair of Tens
Seat 6: nneegri folded on the Flop



PokerStars Hand #213862791466:  Hold'em No Limit ($0.01/$0.02 USD) - 2020/05/14 21:37:00 MSK [2020/05/14 14:37:00 ET]
Table 'Euforbo IV' 6-max Seat #4 is the button
Seat 1: lawlex_2 ($1.88 in chips) 
Seat 2: Gor4477 ($4.01 in chips) 
Seat 3: KAMBU-CR ($5.65 in chips) 
Seat 4: délichoc ($2 in chips) 
Seat 5: Wawa79669 ($1.08 in chips) 
Seat 6: nneegri ($2.37 in chips) 
Wawa79669: posts small blind $0.01
nneegri: posts big blind $0.02
*** HOLE CARDS ***
Dealt to lawlex_2 [Ac As]
lawlex_2: raises $0.03 to $0.05
Gor4477: folds 
KAMBU-CR: folds 
délichoc: calls $0.05
Wawa79669: folds 
nneegri: calls $0.03
*** FLOP *** [3d Qh 6s]
nneegri: checks 
lawlex_2: bets $0.10
délichoc: folds 
nneegri: folds 
Uncalled bet ($0.10) returned to lawlex_2
lawlex_2 collected $0.15 from pot
lawlex_2: doesn't show hand 
*** SUMMARY ***
Total pot $0.16 | Rake $0.01 
Board [3d Qh 6s]
Seat 1: lawlex_2 collected ($0.15)
Seat 2: Gor4477 folded before Flop (didn't bet)
Seat 3: KAMBU-CR folded before Flop (didn't bet)
Seat 4: délichoc (button) folded on the Flop
Seat 5: Wawa79669 (small blind) folded before Flop
Seat 6: nneegri (big blind) folded on the Flop



PokerStars Hand #213862821830:  Hold'em No Limit ($0.01/$0.02 USD) - 2020/05/14 21:37:30 MSK [2020/05/14 14:37:30 ET]
Table 'Euforbo IV' 6-max Seat #5 is the button
Seat 1: lawlex_2 ($1.98 in chips) 
Seat 2: Gor4477 ($4.01 in chips) 
Seat 3: KAMBU-CR ($5.65 in chips) 
Seat 4: délichoc ($2 in chips) 
Seat 5: Wawa79669 ($1.07 in chips) 
Seat 6: nneegri ($2.32 in chips) 
nneegri: posts small blind $0.01
lawlex_2: posts big blind $0.02
*** HOLE CARDS ***
Dealt to lawlex_2 [4d 8h]
Gor4477: raises $0.04 to $0.06
KAMBU-CR: folds 
délichoc: folds 
Wawa79669: calls $0.06
nneegri: folds 
lawlex_2: folds 
*** FLOP *** [Qs 5d Js]
Gor4477: checks 
Wawa79669: checks 
*** TURN *** [Qs 5d Js] [4c]
Gor4477: checks 
Wawa79669: checks 
*** RIVER *** [Qs 5d Js 4c] [7s]
Gor4477: checks 
Wawa79669: checks 
*** SHOW DOWN ***
Gor4477: shows [As Jh] (a pair of Jacks)
Wawa79669: mucks hand 
Gor4477 collected $0.14 from pot
*** SUMMARY ***
Total pot $0.15 | Rake $0.01 
Board [Qs 5d Js 4c 7s]
Seat 1: lawlex_2 (big blind) folded before Flop
Seat 2: Gor4477 showed [As Jh] and won ($0.14) with a pair of Jacks
Seat 3: KAMBU-CR folded before Flop (didn't bet)
Seat 4: délichoc folded before Flop (didn't bet)
Seat 5: Wawa79669 (button) mucked [9s Jc]
Seat 6: nneegri (small blind) folded before Flop



PokerStars Hand #213862846325:  Hold'em No Limit ($0.01/$0.02 USD) - 2020/05/14 21:37:55 MSK [2020/05/14 14:37:55 ET]
Table 'Euforbo IV' 6-max Seat #6 is the button
Seat 1: lawlex_2 ($1.96 in chips) 
Seat 2: Gor4477 ($4.09 in chips) 
Seat 3: KAMBU-CR ($5.65 in chips) 
Seat 4: délichoc ($2 in chips) 
Seat 5: Wawa79669 ($1.01 in chips) 
Seat 6: nneegri ($2.31 in chips) 
lawlex_2: posts small blind $0.01
Gor4477: posts big blind $0.02
*** HOLE CARDS ***
Dealt to lawlex_2 [2c 3h]
KAMBU-CR: folds 
délichoc: raises $0.04 to $0.06
Wawa79669: calls $0.06
nneegri: folds 
lawlex_2: folds 
Gor4477: folds 
*** FLOP *** [Ah 7d 5h]
délichoc: checks 
Wawa79669: bets $0.02
délichoc: folds 
Uncalled bet ($0.02) returned to Wawa79669
Wawa79669 collected $0.14 from pot
Wawa79669: doesn't show hand 
*** SUMMARY ***
Total pot $0.15 | Rake $0.01 
Board [Ah 7d 5h]
Seat 1: lawlex_2 (small blind) folded before Flop
Seat 2: Gor4477 (big blind) folded before Flop
Seat 3: KAMBU-CR folded before Flop (didn't bet)
Seat 4: délichoc folded on the Flop
Seat 5: Wawa79669 collected ($0.14)
Seat 6: nneegri (button) folded before Flop (didn't bet)



PokerStars Hand #213862891504:  Hold'em No Limit ($0.01/$0.02 USD) - 2020/05/14 21:38:34 MSK [2020/05/14 14:38:34 ET]
Table 'Euforbo IV' 6-max Seat #1 is the button
Seat 1: lawlex_2 ($1.95 in chips) 
Seat 2: Gor4477 ($4.07 in chips) 
Seat 3: KAMBU-CR ($5.65 in chips) 
Seat 4: délichoc ($2 in chips) 
Seat 5: Wawa79669 ($1.09 in chips) 
Seat 6: nneegri ($2.31 in chips) 
Gor4477: posts small blind $0.01
KAMBU-CR: posts big blind $0.02
*** HOLE CARDS ***
Dealt to lawlex_2 [Ts 5h]
délichoc: folds 
Wawa79669: raises $0.02 to $0.04
nneegri: folds 
lawlex_2: folds 
Gor4477: folds 
KAMBU-CR: folds 
Uncalled bet ($0.02) returned to Wawa79669
Wawa79669 collected $0.05 from pot
Wawa79669: doesn't show hand 
*** SUMMARY ***
Total pot $0.05 | Rake $0 
Seat 1: lawlex_2 (button) folded before Flop (didn't bet)
Seat 2: Gor4477 (small blind) folded before Flop
Seat 3: KAMBU-CR (big blind) folded before Flop
Seat 4: délichoc folded before Flop (didn't bet)
Seat 5: Wawa79669 collected ($0.05)
Seat 6: nneegri folded before Flop (didn't bet)



PokerStars Hand #213862929499:  Hold'em No Limit ($0.01/$0.02 USD) - 2020/05/14 21:39:13 MSK [2020/05/14 14:39:13 ET]
Table 'Euforbo IV' 6-max Seat #2 is the button
Seat 1: lawlex_2 ($1.95 in chips) 
Seat 2: Gor4477 ($4.06 in chips) 
Seat 3: KAMBU-CR ($5.63 in chips) 
Seat 4: délichoc ($2 in chips) 
Seat 5: Wawa79669 ($1.12 in chips) 
Seat 6: nneegri ($2.31 in chips) 
KAMBU-CR: posts small blind $0.01
délichoc: posts big blind $0.02
*** HOLE CARDS ***
Dealt to lawlex_2 [9c 8d]
Wawa79669: calls $0.02
nneegri: calls $0.02
lawlex_2: folds 
Gor4477: folds 
KAMBU-CR: raises $0.04 to $0.06
délichoc: folds 
Wawa79669: calls $0.04
nneegri: calls $0.04
*** FLOP *** [7d Js Qd]
KAMBU-CR: checks 
Wawa79669: checks 
nneegri: bets $0.12
KAMBU-CR: folds 
Wawa79669: folds 
Uncalled bet ($0.12) returned to nneegri
nneegri collected $0.19 from pot
nneegri: doesn't show hand 
*** SUMMARY ***
Total pot $0.20 | Rake $0.01 
Board [7d Js Qd]
Seat 1: lawlex_2 folded before Flop (didn't bet)
Seat 2: Gor4477 (button) folded before Flop (didn't bet)
Seat 3: KAMBU-CR (small blind) folded on the Flop
Seat 4: délichoc (big blind) folded before Flop
Seat 5: Wawa79669 folded on the Flop
Seat 6: nneegri collected ($0.19)



PokerStars Hand #213862987937:  Hold'em No Limit ($0.01/$0.02 USD) - 2020/05/14 21:40:12 MSK [2020/05/14 14:40:12 ET]
Table 'Euforbo IV' 6-max Seat #3 is the button
Seat 1: lawlex_2 ($1.95 in chips) 
Seat 2: Gor4477 ($4.06 in chips) 
Seat 3: KAMBU-CR ($5.57 in chips) 
Seat 4: délichoc ($2 in chips) 
Seat 5: Wawa79669 ($1.06 in chips) 
Seat 6: nneegri ($2.44 in chips) 
délichoc: posts small blind $0.01
Wawa79669: posts big blind $0.02
*** HOLE CARDS ***
Dealt to lawlex_2 [Ah 6c]
nneegri: folds 
lawlex_2: raises $0.03 to $0.05
Gor4477: folds 
KAMBU-CR: folds 
délichoc: folds 
Wawa79669: folds 
Uncalled bet ($0.03) returned to lawlex_2
lawlex_2 collected $0.05 from pot
lawlex_2: doesn't show hand 
*** SUMMARY ***
Total pot $0.05 | Rake $0 
Seat 1: lawlex_2 collected ($0.05)
Seat 2: Gor4477 folded before Flop (didn't bet)
Seat 3: KAMBU-CR (button) folded before Flop (didn't bet)
Seat 4: délichoc (small blind) folded before Flop
Seat 5: Wawa79669 (big blind) folded before Flop
Seat 6: nneegri folded before Flop (didn't bet)



PokerStars Hand #213863005650:  Hold'em No Limit ($0.01/$0.02 USD) - 2020/05/14 21:40:30 MSK [2020/05/14 14:40:30 ET]
Table 'Euforbo IV' 6-max Seat #4 is the button
Seat 1: lawlex_2 ($1.98 in chips) 
Seat 2: Gor4477 ($4.06 in chips) 
Seat 4: délichoc ($2 in chips) 
Seat 5: Wawa79669 ($1.04 in chips) 
Seat 6: nneegri ($2.44 in chips) 
Wawa79669: posts small blind $0.01
nneegri: posts big blind $0.02
*** HOLE CARDS ***
Dealt to lawlex_2 [7h Qh]
KAMBU-CR leaves the table
lawlex_2: folds 
Gor4477: raises $0.04 to $0.06
délichoc: raises $0.04 to $0.10
Wawa79669: folds 
nneegri: calls $0.08
Gor4477: calls $0.04
*** FLOP *** [9d 7d 2c]
AVV_72008 joins the table at seat #3 
nneegri: checks 
Gor4477: checks 
délichoc: checks 
*** TURN *** [9d 7d 2c] [6d]
nneegri: bets $0.18
Gor4477: folds 
délichoc: folds 
Uncalled bet ($0.18) returned to nneegri
nneegri collected $0.30 from pot
nneegri: doesn't show hand 
*** SUMMARY ***
Total pot $0.31 | Rake $0.01 
Board [9d 7d 2c 6d]
Seat 1: lawlex_2 folded before Flop (didn't bet)
Seat 2: Gor4477 folded on the Turn
Seat 4: délichoc (button) folded on the Turn
Seat 5: Wawa79669 (small blind) folded before Flop
Seat 6: nneegri (big blind) collected ($0.30)



PokerStars Hand #213863047357:  Hold'em No Limit ($0.01/$0.02 USD) - 2020/05/14 21:41:12 MSK [2020/05/14 14:41:12 ET]
Table 'Euforbo IV' 6-max Seat #5 is the button
Seat 1: lawlex_2 ($1.98 in chips) 
Seat 2: Gor4477 ($3.96 in chips) 
Seat 4: délichoc ($2 in chips) 
Seat 5: Wawa79669 ($1.03 in chips) 
Seat 6: nneegri ($2.64 in chips) 
nneegri: posts small blind $0.01
lawlex_2: posts big blind $0.02
AVV_72008: sits out 
*** HOLE CARDS ***
Dealt to lawlex_2 [2d 2c]
Gor4477: folds 
délichoc: raises $0.04 to $0.06
Wawa79669: folds 
nneegri: folds 
lawlex_2: calls $0.04
*** FLOP *** [Ah 6d 5c]
lawlex_2: checks 
délichoc: checks 
*** TURN *** [Ah 6d 5c] [9c]
lawlex_2: bets $0.09
délichoc: folds 
Uncalled bet ($0.09) returned to lawlex_2
lawlex_2 collected $0.13 from pot
lawlex_2: doesn't show hand 
*** SUMMARY ***
Total pot $0.13 | Rake $0 
Board [Ah 6d 5c 9c]
Seat 1: lawlex_2 (big blind) collected ($0.13)
Seat 2: Gor4477 folded before Flop (didn't bet)
Seat 4: délichoc folded on the Turn
Seat 5: Wawa79669 (button) folded before Flop (didn't bet)
Seat 6: nneegri (small blind) folded before Flop



PokerStars Hand #213863074440:  Hold'em No Limit ($0.01/$0.02 USD) - 2020/05/14 21:41:40 MSK [2020/05/14 14:41:40 ET]
Table 'Euforbo IV' 6-max Seat #6 is the button
Seat 1: lawlex_2 ($2.05 in chips) 
Seat 2: Gor4477 ($3.96 in chips) 
Seat 4: délichoc ($2 in chips) 
Seat 5: Wawa79669 ($1.03 in chips) 
Seat 6: nneegri ($2.63 in chips) 
lawlex_2: posts small blind $0.01
Gor4477: posts big blind $0.02
AVV_72008: sits out 
*** HOLE CARDS ***
Dealt to lawlex_2 [9c 7d]
délichoc: folds 
Wawa79669: calls $0.02
nneegri: folds 
lawlex_2: folds 
Gor4477: checks 
*** FLOP *** [3c 8h Qs]
Gor4477: checks 
Wawa79669: checks 
*** TURN *** [3c 8h Qs] [9h]
Gor4477: checks 
Wawa79669: checks 
*** RIVER *** [3c 8h Qs 9h] [Kc]
Gor4477: checks 
Wawa79669: checks 
*** SHOW DOWN ***
Gor4477: shows [5h 4c] (high card King)
Wawa79669: shows [8s Js] (a pair of Eights)
Wawa79669 collected $0.05 from pot
*** SUMMARY ***
Total pot $0.05 | Rake $0 
Board [3c 8h Qs 9h Kc]
Seat 1: lawlex_2 (small blind) folded before Flop
Seat 2: Gor4477 (big blind) showed [5h 4c] and lost with high card King
Seat 4: délichoc folded before Flop (didn't bet)
Seat 5: Wawa79669 showed [8s Js] and won ($0.05) with a pair of Eights
Seat 6: nneegri (button) folded before Flop (didn't bet)



PokerStars Hand #213863106959:  Hold'em No Limit ($0.01/$0.02 USD) - 2020/05/14 21:42:12 MSK [2020/05/14 14:42:12 ET]
Table 'Euforbo IV' 6-max Seat #1 is the button
Seat 1: lawlex_2 ($2.04 in chips) 
Seat 2: Gor4477 ($3.94 in chips) 
Seat 3: AVV_72008 ($0.80 in chips) 
Seat 4: délichoc ($2 in chips) 
Seat 5: Wawa79669 ($1.06 in chips) 
Seat 6: nneegri ($2.63 in chips) 
Gor4477: posts small blind $0.01
AVV_72008: posts big blind $0.02
*** HOLE CARDS ***
Dealt to lawlex_2 [Jd 8h]
délichoc: folds 
Wawa79669: folds 
nneegri: raises $0.02 to $0.04
lawlex_2: folds 
Gor4477: folds 
AVV_72008: calls $0.02
*** FLOP *** [6d 2s Ah]
AVV_72008: bets $0.06
nneegri: calls $0.06
*** TURN *** [6d 2s Ah] [3s]
AVV_72008: bets $0.10
nneegri: calls $0.10
*** RIVER *** [6d 2s Ah 3s] [Td]
AVV_72008: bets $0.16
nneegri: folds 
Uncalled bet ($0.16) returned to AVV_72008
AVV_72008 collected $0.40 from pot
AVV_72008: doesn't show hand 
*** SUMMARY ***
Total pot $0.41 | Rake $0.01 
Board [6d 2s Ah 3s Td]
Seat 1: lawlex_2 (button) folded before Flop (didn't bet)
Seat 2: Gor4477 (small blind) folded before Flop
Seat 3: AVV_72008 (big blind) collected ($0.40)
Seat 4: délichoc folded before Flop (didn't bet)
Seat 5: Wawa79669 folded before Flop (didn't bet)
Seat 6: nneegri folded on the River



PokerStars Hand #213863165694:  Hold'em No Limit ($0.01/$0.02 USD) - 2020/05/14 21:43:12 MSK [2020/05/14 14:43:12 ET]
Table 'Euforbo IV' 6-max Seat #2 is the button
Seat 1: lawlex_2 ($2.04 in chips) 
Seat 2: Gor4477 ($3.93 in chips) 
Seat 3: AVV_72008 ($1 in chips) 
Seat 4: délichoc ($2 in chips) 
Seat 5: Wawa79669 ($1.06 in chips) 
Seat 6: nneegri ($2.43 in chips) 
AVV_72008: posts small blind $0.01
délichoc: posts big blind $0.02
*** HOLE CARDS ***
Dealt to lawlex_2 [Ts Jc]
Wawa79669: folds 
nneegri: folds 
lawlex_2: raises $0.03 to $0.05
Gor4477: folds 
AVV_72008: folds 
délichoc: folds 
Uncalled bet ($0.03) returned to lawlex_2
lawlex_2 collected $0.05 from pot
lawlex_2: doesn't show hand 
*** SUMMARY ***
Total pot $0.05 | Rake $0 
Seat 1: lawlex_2 collected ($0.05)
Seat 2: Gor4477 (button) folded before Flop (didn't bet)
Seat 3: AVV_72008 (small blind) folded before Flop
Seat 4: délichoc (big blind) folded before Flop
Seat 5: Wawa79669 folded before Flop (didn't bet)
Seat 6: nneegri folded before Flop (didn't bet)



PokerStars Hand #213863181210:  Hold'em No Limit ($0.01/$0.02 USD) - 2020/05/14 21:43:27 MSK [2020/05/14 14:43:27 ET]
Table 'Euforbo IV' 6-max Seat #3 is the button
Seat 1: lawlex_2 ($2.07 in chips) 
Seat 2: Gor4477 ($3.93 in chips) 
Seat 3: AVV_72008 ($0.99 in chips) 
Seat 4: délichoc ($2 in chips) 
Seat 5: Wawa79669 ($1.06 in chips) 
Seat 6: nneegri ($2.43 in chips) 
délichoc: posts small blind $0.01
Wawa79669: posts big blind $0.02
*** HOLE CARDS ***
Dealt to lawlex_2 [Jc As]
nneegri: folds 
lawlex_2 has timed out
lawlex_2: folds 
Gor4477: folds 
AVV_72008: folds 
délichoc: raises $0.02 to $0.04
Wawa79669: calls $0.02
*** FLOP *** [3c 3h 3d]
délichoc: checks 
Wawa79669: bets $0.08
délichoc: calls $0.08
*** TURN *** [3c 3h 3d] [4d]
délichoc: checks 
Wawa79669: bets $0.23
délichoc: calls $0.23
*** RIVER *** [3c 3h 3d 4d] [2h]
délichoc: checks 
Wawa79669: checks 
*** SHOW DOWN ***
délichoc: shows [Ah 8h] (three of a kind, Threes)
Wawa79669: shows [7d 7s] (a full house, Threes full of Sevens)
Wawa79669 collected $0.68 from pot
*** SUMMARY ***
Total pot $0.70 | Rake $0.02 
Board [3c 3h 3d 4d 2h]
Seat 1: lawlex_2 folded before Flop (didn't bet)
Seat 2: Gor4477 folded before Flop (didn't bet)
Seat 3: AVV_72008 (button) folded before Flop (didn't bet)
Seat 4: délichoc (small blind) showed [Ah 8h] and lost with three of a kind, Threes
Seat 5: Wawa79669 (big blind) showed [7d 7s] and won ($0.68) with a full house, Threes full of Sevens
Seat 6: nneegri folded before Flop (didn't bet)



PokerStars Hand #213863311307:  Hold'em No Limit ($0.01/$0.02 USD) - 2020/05/14 21:45:37 MSK [2020/05/14 14:45:37 ET]
Table 'Euforbo IV' 6-max Seat #2 is the button
Seat 1: lawlex_2 ($2.07 in chips) 
Seat 2: Gor4477 ($4.10 in chips) 
Seat 3: AVV_72008 ($0.97 in chips) 
Seat 4: délichoc ($2 in chips) 
Seat 5: Wawa79669 ($1.30 in chips) 
Seat 6: nneegri ($2.42 in chips) 
AVV_72008: posts small blind $0.01
délichoc: posts big blind $0.02
lawlex_2: posts small & big blinds $0.03
*** HOLE CARDS ***
Dealt to lawlex_2 [7c Kc]
Wawa79669: calls $0.02
nneegri: calls $0.02
lawlex_2: checks 
Gor4477: folds 
AVV_72008: calls $0.01
délichoc: raises $0.14 to $0.16
Wawa79669: calls $0.14
nneegri: folds 
lawlex_2: folds 
AVV_72008: folds 
*** FLOP *** [Jc 2d Qh]
délichoc: bets $0.22
Wawa79669: folds 
Uncalled bet ($0.22) returned to délichoc
délichoc collected $0.38 from pot
délichoc: doesn't show hand 
*** SUMMARY ***
Total pot $0.39 | Rake $0.01 
Board [Jc 2d Qh]
Seat 1: lawlex_2 folded before Flop (didn't bet)
Seat 2: Gor4477 (button) folded before Flop (didn't bet)
Seat 3: AVV_72008 (small blind) folded before Flop
Seat 4: délichoc (big blind) collected ($0.38)
Seat 5: Wawa79669 folded on the Flop
Seat 6: nneegri folded before Flop



PokerStars Hand #213863355661:  Hold'em No Limit ($0.01/$0.02 USD) - 2020/05/14 21:46:22 MSK [2020/05/14 14:46:22 ET]
Table 'Euforbo IV' 6-max Seat #3 is the button
Seat 1: lawlex_2 ($2.04 in chips) 
Seat 2: Gor4477 ($4.10 in chips) 
Seat 3: AVV_72008 ($0.95 in chips) 
Seat 4: délichoc ($2.22 in chips) 
Seat 5: Wawa79669 ($1.14 in chips) 
Seat 6: nneegri ($2.40 in chips) 
délichoc: posts small blind $0.01
Wawa79669: posts big blind $0.02
*** HOLE CARDS ***
Dealt to lawlex_2 [6d 2s]
nneegri: folds 
lawlex_2: folds 
Gor4477: raises $0.04 to $0.06
AVV_72008: folds 
délichoc: folds 
nneegri leaves the table
Wawa79669: calls $0.04
*** FLOP *** [Jd 7d Qs]
Wawa79669: checks 
Gor4477: checks 
*** TURN *** [Jd 7d Qs] [9d]
Wawa79669: checks 
Gor4477: checks 
*** RIVER *** [Jd 7d Qs 9d] [Td]
Wawa79669: checks 
Gor4477: checks 
*** SHOW DOWN ***
Wawa79669: shows [Jc 8h] (a straight, Eight to Queen)
Gor4477: shows [Js Ks] (a straight, Nine to King)
Gor4477 collected $0.13 from pot
*** SUMMARY ***
Total pot $0.13 | Rake $0 
Board [Jd 7d Qs 9d Td]
Seat 1: lawlex_2 folded before Flop (didn't bet)
Seat 2: Gor4477 showed [Js Ks] and won ($0.13) with a straight, Nine to King
Seat 3: AVV_72008 (button) folded before Flop (didn't bet)
Seat 4: délichoc (small blind) folded before Flop
Seat 5: Wawa79669 (big blind) showed [Jc 8h] and lost with a straight, Eight to Queen
Seat 6: nneegri folded before Flop (didn't bet)



PokerStars Hand #213863387864:  Hold'em No Limit ($0.01/$0.02 USD) - 2020/05/14 21:46:54 MSK [2020/05/14 14:46:54 ET]
Table 'Euforbo IV' 6-max Seat #4 is the button
Seat 1: lawlex_2 ($2.04 in chips) 
Seat 2: Gor4477 ($4.17 in chips) 
Seat 3: AVV_72008 ($0.95 in chips) 
Seat 4: délichoc ($2.21 in chips) 
Seat 5: Wawa79669 ($1.08 in chips) 
Wawa79669: posts small blind $0.01
lawlex_2: posts big blind $0.02
*** HOLE CARDS ***
Dealt to lawlex_2 [Ah As]
rublevkad50 joins the table at seat #6 
Gor4477: raises $0.04 to $0.06
AVV_72008: folds 
délichoc: folds 
Wawa79669: raises $0.04 to $0.10
lawlex_2: raises $0.26 to $0.36
Gor4477: folds 
Wawa79669: calls $0.26
*** FLOP *** [7d 6d 3s]
Wawa79669: checks 
lawlex_2: bets $0.50
Wawa79669: calls $0.50
*** TURN *** [7d 6d 3s] [5h]
Wawa79669: bets $0.22 and is all-in
lawlex_2: calls $0.22
*** RIVER *** [7d 6d 3s 5h] [8s]
*** SHOW DOWN ***
Wawa79669: shows [4d Ts] (a straight, Four to Eight)
lawlex_2: shows [Ah As] (a pair of Aces)
Wawa79669 collected $2.14 from pot
*** SUMMARY ***
Total pot $2.22 | Rake $0.08 
Board [7d 6d 3s 5h 8s]
Seat 1: lawlex_2 (big blind) showed [Ah As] and lost with a pair of Aces
Seat 2: Gor4477 folded before Flop
Seat 3: AVV_72008 folded before Flop (didn't bet)
Seat 4: délichoc (button) folded before Flop (didn't bet)
Seat 5: Wawa79669 (small blind) showed [4d Ts] and won ($2.14) with a straight, Four to Eight



PokerStars Hand #213863439877:  Hold'em No Limit ($0.01/$0.02 USD) - 2020/05/14 21:47:45 MSK [2020/05/14 14:47:45 ET]
Table 'Euforbo IV' 6-max Seat #5 is the button
Seat 1: lawlex_2 ($0.96 in chips) 
Seat 2: Gor4477 ($4.11 in chips) 
Seat 3: AVV_72008 ($0.95 in chips) 
Seat 4: délichoc ($2.21 in chips) 
Seat 5: Wawa79669 ($2.14 in chips) 
lawlex_2: posts small blind $0.01
Gor4477: posts big blind $0.02
*** HOLE CARDS ***
Dealt to lawlex_2 [Th Jh]
AVV_72008: folds 
délichoc: raises $0.06 to $0.08
Wawa79669: folds 
lawlex_2: folds 
Gor4477: folds 
Uncalled bet ($0.06) returned to délichoc
délichoc collected $0.05 from pot
délichoc: doesn't show hand 
*** SUMMARY ***
Total pot $0.05 | Rake $0 
Seat 1: lawlex_2 (small blind) folded before Flop
Seat 2: Gor4477 (big blind) folded before Flop
Seat 3: AVV_72008 folded before Flop (didn't bet)
Seat 4: délichoc collected ($0.05)
Seat 5: Wawa79669 (button) folded before Flop (didn't bet)



PokerStars Hand #213863462073:  Hold'em No Limit ($0.01/$0.02 USD) - 2020/05/14 21:48:07 MSK [2020/05/14 14:48:07 ET]
Table 'Euforbo IV' 6-max Seat #1 is the button
Seat 1: lawlex_2 ($0.95 in chips) 
Seat 2: Gor4477 ($4.09 in chips) 
Seat 3: AVV_72008 ($0.95 in chips) 
Seat 4: délichoc ($2.24 in chips) 
Seat 5: Wawa79669 ($2.14 in chips) 
Seat 6: rublevkad50 ($0.80 in chips) 
Gor4477: posts small blind $0.01
AVV_72008: posts big blind $0.02
rublevkad50: posts big blind $0.02
*** HOLE CARDS ***
Dealt to lawlex_2 [7h 4d]
délichoc: raises $0.04 to $0.06
Wawa79669: folds 
rublevkad50: folds 
lawlex_2: folds 
Gor4477: folds 
AVV_72008: folds 
Uncalled bet ($0.04) returned to délichoc
délichoc collected $0.07 from pot
délichoc: doesn't show hand 
*** SUMMARY ***
Total pot $0.07 | Rake $0 
Seat 1: lawlex_2 (button) folded before Flop (didn't bet)
Seat 2: Gor4477 (small blind) folded before Flop
Seat 3: AVV_72008 (big blind) folded before Flop
Seat 4: délichoc collected ($0.07)
Seat 5: Wawa79669 folded before Flop (didn't bet)
Seat 6: rublevkad50 folded before Flop (didn't bet)



PokerStars Hand #213863483846:  Hold'em No Limit ($0.01/$0.02 USD) - 2020/05/14 21:48:29 MSK [2020/05/14 14:48:29 ET]
Table 'Euforbo IV' 6-max Seat #2 is the button
Seat 1: lawlex_2 ($0.95 in chips) 
Seat 2: Gor4477 ($4.08 in chips) 
Seat 3: AVV_72008 ($0.93 in chips) 
Seat 4: délichoc ($2.29 in chips) 
Seat 5: Wawa79669 ($2.14 in chips) 
Seat 6: rublevkad50 ($0.78 in chips) 
AVV_72008: posts small blind $0.01
délichoc: posts big blind $0.02
*** HOLE CARDS ***
Dealt to lawlex_2 [8d 6c]
Wawa79669: calls $0.02
rublevkad50: folds 
lawlex_2: folds 
Gor4477: folds 
AVV_72008: calls $0.01
délichoc: checks 
*** FLOP *** [9c Td 2h]
AVV_72008: checks 
délichoc: checks 
Wawa79669: checks 
*** TURN *** [9c Td 2h] [Jd]
AVV_72008: checks 
délichoc: bets $0.06
Wawa79669: folds 
AVV_72008: folds 
Uncalled bet ($0.06) returned to délichoc
délichoc collected $0.06 from pot
délichoc: doesn't show hand 
*** SUMMARY ***
Total pot $0.06 | Rake $0 
Board [9c Td 2h Jd]
Seat 1: lawlex_2 folded before Flop (didn't bet)
Seat 2: Gor4477 (button) folded before Flop (didn't bet)
Seat 3: AVV_72008 (small blind) folded on the Turn
Seat 4: délichoc (big blind) collected ($0.06)
Seat 5: Wawa79669 folded on the Turn
Seat 6: rublevkad50 folded before Flop (didn't bet)



PokerStars Hand #213863527227:  Hold'em No Limit ($0.01/$0.02 USD) - 2020/05/14 21:49:09 MSK [2020/05/14 14:49:09 ET]
Table 'Euforbo IV' 6-max Seat #3 is the button
Seat 1: lawlex_2 ($0.95 in chips) 
Seat 2: Gor4477 ($4.08 in chips) 
Seat 3: AVV_72008 ($0.91 in chips) 
Seat 4: délichoc ($2.33 in chips) 
Seat 5: Wawa79669 ($2.12 in chips) 
Seat 6: rublevkad50 ($0.78 in chips) 
délichoc: posts small blind $0.01
Wawa79669: posts big blind $0.02
*** HOLE CARDS ***
Dealt to lawlex_2 [Ks 9c]
rublevkad50: folds 
lawlex_2: raises $0.03 to $0.05
Gor4477: folds 
AVV_72008: folds 
délichoc: folds 
Wawa79669: calls $0.03
*** FLOP *** [5c 3c 8s]
Wawa79669: bets $0.11
lawlex_2: folds 
Uncalled bet ($0.11) returned to Wawa79669
Wawa79669 collected $0.11 from pot
Wawa79669: doesn't show hand 
*** SUMMARY ***
Total pot $0.11 | Rake $0 
Board [5c 3c 8s]
Seat 1: lawlex_2 folded on the Flop
Seat 2: Gor4477 folded before Flop (didn't bet)
Seat 3: AVV_72008 (button) folded before Flop (didn't bet)
Seat 4: délichoc (small blind) folded before Flop
Seat 5: Wawa79669 (big blind) collected ($0.11)
Seat 6: rublevkad50 folded before Flop (didn't bet)



PokerStars Hand #213863546937:  Hold'em No Limit ($0.01/$0.02 USD) - 2020/05/14 21:49:29 MSK [2020/05/14 14:49:29 ET]
Table 'Euforbo IV' 6-max Seat #4 is the button
Seat 1: lawlex_2 ($0.90 in chips) 
Seat 2: Gor4477 ($4.08 in chips) 
Seat 3: AVV_72008 ($0.91 in chips) 
Seat 4: délichoc ($2.32 in chips) 
Seat 5: Wawa79669 ($2.18 in chips) 
Seat 6: rublevkad50 ($0.78 in chips) 
Wawa79669: posts small blind $0.01
rublevkad50: posts big blind $0.02
*** HOLE CARDS ***
Dealt to lawlex_2 [Kc 7h]
lawlex_2: folds 
Gor4477: folds 
AVV_72008: calls $0.02
délichoc: folds 
Wawa79669: folds 
rublevkad50: checks 
*** FLOP *** [8s 4s 6d]
Wawa79669 leaves the table
rublevkad50: bets $0.04
Song91 joins the table at seat #5 
AVV_72008: calls $0.04
*** TURN *** [8s 4s 6d] [Ts]
rublevkad50: bets $0.12
AVV_72008: calls $0.12
*** RIVER *** [8s 4s 6d Ts] [9h]
rublevkad50: bets $0.60 and is all-in
AVV_72008: calls $0.60
*** SHOW DOWN ***
rublevkad50: shows [Ah 7d] (a straight, Six to Ten)
AVV_72008: shows [Qs Ks] (a flush, King high)
AVV_72008 collected $1.52 from pot
*** SUMMARY ***
Total pot $1.57 | Rake $0.05 
Board [8s 4s 6d Ts 9h]
Seat 1: lawlex_2 folded before Flop (didn't bet)
Seat 2: Gor4477 folded before Flop (didn't bet)
Seat 3: AVV_72008 showed [Qs Ks] and won ($1.52) with a flush, King high
Seat 4: délichoc (button) folded before Flop (didn't bet)
Seat 5: Wawa79669 (small blind) folded before Flop
Seat 6: rublevkad50 (big blind) showed [Ah 7d] and lost with a straight, Six to Ten



PokerStars Hand #213863594705:  Hold'em No Limit ($0.01/$0.02 USD) - 2020/05/14 21:50:18 MSK [2020/05/14 14:50:18 ET]
Table 'Euforbo IV' 6-max Seat #1 is the button
Seat 1: lawlex_2 ($0.90 in chips) 
Seat 2: Gor4477 ($4.08 in chips) 
Seat 3: AVV_72008 ($1.65 in chips) 
Seat 4: délichoc ($2.32 in chips) 
Gor4477: posts small blind $0.01
AVV_72008: posts big blind $0.02
Song91: sits out 
*** HOLE CARDS ***
Dealt to lawlex_2 [4h 2c]
délichoc: folds 
lawlex_2: folds 
Gor4477: raises $0.04 to $0.06
rublevkad50 leaves the table
AVV_72008: folds 
Uncalled bet ($0.04) returned to Gor4477
Gor4477 collected $0.04 from pot
Gor4477: doesn't show hand 
*** SUMMARY ***
Total pot $0.04 | Rake $0 
Seat 1: lawlex_2 (button) folded before Flop (didn't bet)
Seat 2: Gor4477 (small blind) collected ($0.04)
Seat 3: AVV_72008 (big blind) folded before Flop
Seat 4: délichoc folded before Flop (didn't bet)



PokerStars Hand #213863607952:  Hold'em No Limit ($0.01/$0.02 USD) - 2020/05/14 21:50:31 MSK [2020/05/14 14:50:31 ET]
Table 'Euforbo IV' 6-max Seat #2 is the button
Seat 1: lawlex_2 ($0.90 in chips) 
Seat 2: Gor4477 ($4.10 in chips) 
Seat 3: AVV_72008 ($1.63 in chips) 
Seat 4: délichoc ($2.32 in chips) 
AVV_72008: posts small blind $0.01
délichoc: posts big blind $0.02
Song91: sits out 
*** HOLE CARDS ***
Dealt to lawlex_2 [9s Tc]
lawlex_2: folds 
BuuzBalamut joins the table at seat #6 
Gor4477: raises $0.04 to $0.06
AVV_72008: folds 
délichoc: folds 
Uncalled bet ($0.04) returned to Gor4477
Gor4477 collected $0.05 from pot
Gor4477: doesn't show hand 
*** SUMMARY ***
Total pot $0.05 | Rake $0 
Seat 1: lawlex_2 folded before Flop (didn't bet)
Seat 2: Gor4477 (button) collected ($0.05)
Seat 3: AVV_72008 (small blind) folded before Flop
Seat 4: délichoc (big blind) folded before Flop



PokerStars Hand #213863620288:  Hold'em No Limit ($0.01/$0.02 USD) - 2020/05/14 21:50:43 MSK [2020/05/14 14:50:43 ET]
Table 'Euforbo IV' 6-max Seat #3 is the button
Seat 1: lawlex_2 ($0.90 in chips) 
Seat 2: Gor4477 ($4.13 in chips) 
Seat 3: AVV_72008 ($1.62 in chips) 
Seat 4: délichoc ($2.30 in chips) 
Seat 5: Song91 ($2 in chips) 
délichoc: posts small blind $0.01
Song91: posts big blind $0.02
BuuzBalamut: sits out 
*** HOLE CARDS ***
Dealt to lawlex_2 [Td Jc]
lawlex_2: raises $0.03 to $0.05
Gor4477: calls $0.05
AVV_72008: folds 
délichoc: folds 
Song91: calls $0.03
*** FLOP *** [Ad 5s Kh]
Song91: checks 
lawlex_2: bets $0.10
Gor4477: folds 
Song91: calls $0.10
*** TURN *** [Ad 5s Kh] [4d]
Song91: checks 
lawlex_2: bets $0.23
Song91: calls $0.23
*** RIVER *** [Ad 5s Kh 4d] [3s]
Gor4477 leaves the table
Song91: checks 
lawlex_2: checks 
*** SHOW DOWN ***
Song91: shows [Ah Th] (a pair of Aces)
lawlex_2: mucks hand 
Song91 collected $0.79 from pot
*** SUMMARY ***
Total pot $0.82 | Rake $0.03 
Board [Ad 5s Kh 4d 3s]
Seat 1: lawlex_2 mucked [Td Jc]
Seat 2: Gor4477 folded on the Flop
Seat 3: AVV_72008 (button) folded before Flop (didn't bet)
Seat 4: délichoc (small blind) folded before Flop
Seat 5: Song91 (big blind) showed [Ah Th] and won ($0.79) with a pair of Aces



PokerStars Hand #213863673121:  Hold'em No Limit ($0.01/$0.02 USD) - 2020/05/14 21:51:36 MSK [2020/05/14 14:51:36 ET]
Table 'Euforbo IV' 6-max Seat #4 is the button
Seat 1: lawlex_2 ($0.52 in chips) 
Seat 3: AVV_72008 ($1.62 in chips) 
Seat 4: délichoc ($2.29 in chips) 
Seat 5: Song91 ($2.41 in chips) 
Seat 6: BuuzBalamut ($2 in chips) 
Song91: posts small blind $0.01
BuuzBalamut: posts big blind $0.02
*** HOLE CARDS ***
Dealt to lawlex_2 [5h Jh]
lawlex_2: folds 
perupoquer joins the table at seat #2 
AVV_72008: folds 
délichoc: folds 
Song91: raises $0.04 to $0.06
AVV_72008 leaves the table
STRONGLEA joins the table at seat #3 
BuuzBalamut: folds 
Uncalled bet ($0.04) returned to Song91
Song91 collected $0.04 from pot
Song91: doesn't show hand 
*** SUMMARY ***
Total pot $0.04 | Rake $0 
Seat 1: lawlex_2 folded before Flop (didn't bet)
Seat 3: AVV_72008 folded before Flop (didn't bet)
Seat 4: délichoc (button) folded before Flop (didn't bet)
Seat 5: Song91 (small blind) collected ($0.04)
Seat 6: BuuzBalamut (big blind) folded before Flop



PokerStars Hand #213863705020:  Hold'em No Limit ($0.01/$0.02 USD) - 2020/05/14 21:52:08 MSK [2020/05/14 14:52:08 ET]
Table 'Euforbo IV' 6-max Seat #5 is the button
Seat 1: lawlex_2 ($0.52 in chips) 
Seat 3: STRONGLEA ($1 in chips) 
Seat 4: délichoc ($2.29 in chips) 
Seat 5: Song91 ($2.43 in chips) 
Seat 6: BuuzBalamut ($2 in chips) 
BuuzBalamut: posts small blind $0.01
lawlex_2: posts big blind $0.02
perupoquer: sits out 
STRONGLEA: posts big blind $0.02
*** HOLE CARDS ***
Dealt to lawlex_2 [3c 4h]
STRONGLEA: checks 
délichoc: folds 
Song91: folds 
BuuzBalamut: folds 
lawlex_2: checks 
*** FLOP *** [7d 5d 5c]
lawlex_2: bets $0.03
STRONGLEA: folds 
Uncalled bet ($0.03) returned to lawlex_2
lawlex_2 collected $0.05 from pot
lawlex_2: doesn't show hand 
*** SUMMARY ***
Total pot $0.05 | Rake $0 
Board [7d 5d 5c]
Seat 1: lawlex_2 (big blind) collected ($0.05)
Seat 3: STRONGLEA folded on the Flop (didn't bet)
Seat 4: délichoc folded before Flop (didn't bet)
Seat 5: Song91 (button) folded before Flop (didn't bet)
Seat 6: BuuzBalamut (small blind) folded before Flop



PokerStars Hand #213863722924:  Hold'em No Limit ($0.01/$0.02 USD) - 2020/05/14 21:52:26 MSK [2020/05/14 14:52:26 ET]
Table 'Euforbo IV' 6-max Seat #6 is the button
Seat 1: lawlex_2 ($0.55 in chips) 
Seat 2: perupoquer ($1 in chips) 
Seat 3: STRONGLEA ($0.98 in chips) 
Seat 4: délichoc ($2.29 in chips) 
Seat 5: Song91 ($2.43 in chips) 
Seat 6: BuuzBalamut ($2 in chips) 
lawlex_2: posts small blind $0.01
perupoquer: posts big blind $0.02
*** HOLE CARDS ***
Dealt to lawlex_2 [Ac 6d]
STRONGLEA: calls $0.02
délichoc: folds 
Song91: folds 
BuuzBalamut: raises $0.06 to $0.08
lawlex_2: folds 
perupoquer: folds 
STRONGLEA: calls $0.06
*** FLOP *** [5d As Qh]
STRONGLEA: checks 
BuuzBalamut: bets $0.06
STRONGLEA: folds 
Uncalled bet ($0.06) returned to BuuzBalamut
BuuzBalamut collected $0.18 from pot
*** SUMMARY ***
Total pot $0.19 | Rake $0.01 
Board [5d As Qh]
Seat 1: lawlex_2 (small blind) folded before Flop
Seat 2: perupoquer (big blind) folded before Flop
Seat 3: STRONGLEA folded on the Flop
Seat 4: délichoc folded before Flop (didn't bet)
Seat 5: Song91 folded before Flop (didn't bet)
Seat 6: BuuzBalamut (button) collected ($0.18)



PokerStars Hand #213863785855:  Hold'em No Limit ($0.01/$0.02 USD) - 2020/05/14 21:53:29 MSK [2020/05/14 14:53:29 ET]
Table 'Euforbo IV' 6-max Seat #1 is the button
Seat 1: lawlex_2 ($0.54 in chips) 
Seat 2: perupoquer ($0.98 in chips) 
Seat 3: STRONGLEA ($0.90 in chips) 
Seat 4: délichoc ($2.29 in chips) 
Seat 5: Song91 ($2.43 in chips) 
Seat 6: BuuzBalamut ($2.10 in chips) 
perupoquer: posts small blind $0.01
STRONGLEA: posts big blind $0.02
*** HOLE CARDS ***
Dealt to lawlex_2 [Js Qs]
délichoc: folds 
Song91: folds 
BuuzBalamut: folds 
lawlex_2: raises $0.03 to $0.05
perupoquer: folds 
STRONGLEA: folds 
Uncalled bet ($0.03) returned to lawlex_2
lawlex_2 collected $0.05 from pot
lawlex_2: doesn't show hand 
*** SUMMARY ***
Total pot $0.05 | Rake $0 
Seat 1: lawlex_2 (button) collected ($0.05)
Seat 2: perupoquer (small blind) folded before Flop
Seat 3: STRONGLEA (big blind) folded before Flop
Seat 4: délichoc folded before Flop (didn't bet)
Seat 5: Song91 folded before Flop (didn't bet)
Seat 6: BuuzBalamut folded before Flop (didn't bet)



PokerStars Hand #213863819845:  Hold'em No Limit ($0.01/$0.02 USD) - 2020/05/14 21:54:03 MSK [2020/05/14 14:54:03 ET]
Table 'Euforbo IV' 6-max Seat #2 is the button
Seat 1: lawlex_2 ($0.57 in chips) 
Seat 2: perupoquer ($0.97 in chips) 
Seat 3: STRONGLEA ($0.88 in chips) 
Seat 4: délichoc ($2.29 in chips) 
Seat 5: Song91 ($2.43 in chips) 
Seat 6: BuuzBalamut ($2.10 in chips) 
STRONGLEA: posts small blind $0.01
délichoc: posts big blind $0.02
*** HOLE CARDS ***
Dealt to lawlex_2 [Qs 7c]
Song91: folds 
BuuzBalamut: folds 
lawlex_2: folds 
perupoquer: folds 
STRONGLEA: calls $0.01
délichoc: checks 
*** FLOP *** [Ac 9c 3h]
STRONGLEA: checks 
délichoc: bets $0.04
STRONGLEA: folds 
Uncalled bet ($0.04) returned to délichoc
délichoc collected $0.04 from pot
délichoc: doesn't show hand 
*** SUMMARY ***
Total pot $0.04 | Rake $0 
Board [Ac 9c 3h]
Seat 1: lawlex_2 folded before Flop (didn't bet)
Seat 2: perupoquer (button) folded before Flop (didn't bet)
Seat 3: STRONGLEA (small blind) folded on the Flop
Seat 4: délichoc (big blind) collected ($0.04)
Seat 5: Song91 folded before Flop (didn't bet)
Seat 6: BuuzBalamut folded before Flop (didn't bet)



PokerStars Hand #213863847744:  Hold'em No Limit ($0.01/$0.02 USD) - 2020/05/14 21:54:30 MSK [2020/05/14 14:54:30 ET]
Table 'Euforbo IV' 6-max Seat #3 is the button
Seat 1: lawlex_2 ($0.57 in chips) 
Seat 2: perupoquer ($0.97 in chips) 
Seat 3: STRONGLEA ($0.86 in chips) 
Seat 4: délichoc ($2.31 in chips) 
Seat 5: Song91 ($2.43 in chips) 
Seat 6: BuuzBalamut ($2.10 in chips) 
délichoc: posts small blind $0.01
Song91: posts big blind $0.02
*** HOLE CARDS ***
Dealt to lawlex_2 [8c 2h]
BuuzBalamut: folds 
lawlex_2: folds 
perupoquer: raises $0.02 to $0.04
STRONGLEA: folds 
délichoc: folds 
Song91: calls $0.02
*** FLOP *** [3h Ah Th]
Song91: checks 
perupoquer: bets $0.03
BuuzBalamut leaves the table
Song91: folds 
Uncalled bet ($0.03) returned to perupoquer
perupoquer collected $0.09 from pot
nigel161 joins the table at seat #6 
perupoquer: doesn't show hand 
*** SUMMARY ***
Total pot $0.09 | Rake $0 
Board [3h Ah Th]
Seat 1: lawlex_2 folded before Flop (didn't bet)
Seat 2: perupoquer collected ($0.09)
Seat 3: STRONGLEA (button) folded before Flop (didn't bet)
Seat 4: délichoc (small blind) folded before Flop
Seat 5: Song91 (big blind) folded on the Flop
Seat 6: BuuzBalamut folded before Flop (didn't bet)



PokerStars Hand #213863881738:  Hold'em No Limit ($0.01/$0.02 USD) - 2020/05/14 21:55:05 MSK [2020/05/14 14:55:05 ET]
Table 'Euforbo IV' 6-max Seat #4 is the button
Seat 1: lawlex_2 ($0.57 in chips) 
Seat 2: perupoquer ($1.02 in chips) 
Seat 3: STRONGLEA ($0.86 in chips) 
Seat 4: délichoc ($2.30 in chips) 
Seat 5: Song91 ($2.39 in chips) 
Seat 6: nigel161 ($2 in chips) 
Song91: posts small blind $0.01
nigel161: posts big blind $0.02
*** HOLE CARDS ***
Dealt to lawlex_2 [2c Ac]
lawlex_2: raises $0.03 to $0.05
perupoquer: calls $0.05
STRONGLEA: calls $0.05
délichoc: folds 
Song91: folds 
nigel161: calls $0.03
*** FLOP *** [7d 4s Ts]
nigel161: checks 
lawlex_2: checks 
perupoquer: checks 
STRONGLEA: checks 
*** TURN *** [7d 4s Ts] [9c]
nigel161: checks 
lawlex_2: checks 
perupoquer: checks 
STRONGLEA: checks 
*** RIVER *** [7d 4s Ts 9c] [6d]
nigel161: checks 
lawlex_2: bets $0.13
perupoquer: raises $0.25 to $0.38
STRONGLEA: folds 
nigel161: folds 
lawlex_2: folds 
Uncalled bet ($0.25) returned to perupoquer
perupoquer collected $0.45 from pot
perupoquer: doesn't show hand 
*** SUMMARY ***
Total pot $0.47 | Rake $0.02 
Board [7d 4s Ts 9c 6d]
Seat 1: lawlex_2 folded on the River
Seat 2: perupoquer collected ($0.45)
Seat 3: STRONGLEA folded on the River
Seat 4: délichoc (button) folded before Flop (didn't bet)
Seat 5: Song91 (small blind) folded before Flop
Seat 6: nigel161 (big blind) folded on the River



PokerStars Hand #213863933838:  Hold'em No Limit ($0.01/$0.02 USD) - 2020/05/14 21:56:19 MSK [2020/05/14 14:56:19 ET]
Table 'Euforbo IV' 6-max Seat #5 is the button
Seat 1: lawlex_2 ($0.39 in chips) 
Seat 2: perupoquer ($1.29 in chips) 
Seat 3: STRONGLEA ($0.81 in chips) 
Seat 4: délichoc ($2.30 in chips) 
Seat 5: Song91 ($2.38 in chips) 
Seat 6: nigel161 ($1.95 in chips) 
nigel161: posts small blind $0.01
lawlex_2: posts big blind $0.02
*** HOLE CARDS ***
Dealt to lawlex_2 [8s 2c]
perupoquer: folds 
STRONGLEA: calls $0.02
délichoc: folds 
Song91: calls $0.02
nigel161: raises $0.04 to $0.06
lawlex_2: folds 
STRONGLEA: calls $0.04
Song91: calls $0.04
*** FLOP *** [6c 4c 3c]
nigel161: bets $0.02
STRONGLEA: raises $0.02 to $0.04
Song91: folds 
nigel161: calls $0.02
*** TURN *** [6c 4c 3c] [7s]
nigel161: bets $0.14
STRONGLEA: raises $0.14 to $0.28
nigel161: calls $0.14
*** RIVER *** [6c 4c 3c 7s] [Qs]
nigel161: bets $0.02
STRONGLEA: raises $0.41 to $0.43 and is all-in
nigel161: calls $0.41
*** SHOW DOWN ***
STRONGLEA: shows [Ac 8c] (a flush, Ace high)
nigel161: shows [Jc Js] (a pair of Jacks)
STRONGLEA collected $1.64 from pot
*** SUMMARY ***
Total pot $1.70 | Rake $0.06 
Board [6c 4c 3c 7s Qs]
Seat 1: lawlex_2 (big blind) folded before Flop
Seat 2: perupoquer folded before Flop (didn't bet)
Seat 3: STRONGLEA showed [Ac 8c] and won ($1.64) with a flush, Ace high
Seat 4: délichoc folded before Flop (didn't bet)
Seat 5: Song91 (button) folded on the Flop
Seat 6: nigel161 (small blind) showed [Jc Js] and lost with a pair of Jacks



PokerStars Hand #213863985254:  Hold'em No Limit ($0.01/$0.02 USD) - 2020/05/14 21:57:26 MSK [2020/05/14 14:57:26 ET]
Table 'Euforbo IV' 6-max Seat #6 is the button
Seat 1: lawlex_2 ($0.37 in chips) 
Seat 2: perupoquer ($1.29 in chips) 
Seat 3: STRONGLEA ($1.64 in chips) 
Seat 4: délichoc ($2.30 in chips) 
Seat 5: Song91 ($2.32 in chips) 
Seat 6: nigel161 ($1.14 in chips) 
lawlex_2: posts small blind $0.01
perupoquer: posts big blind $0.02
*** HOLE CARDS ***
Dealt to lawlex_2 [9h 5h]
STRONGLEA: calls $0.02
délichoc: folds 
Song91: folds 
nigel161: calls $0.02
lawlex_2: folds 
perupoquer: checks 
*** FLOP *** [Th 5c 3d]
perupoquer: bets $0.04
STRONGLEA: folds 
nigel161: folds 
Uncalled bet ($0.04) returned to perupoquer
perupoquer collected $0.07 from pot
perupoquer: doesn't show hand 
*** SUMMARY ***
Total pot $0.07 | Rake $0 
Board [Th 5c 3d]
Seat 1: lawlex_2 (small blind) folded before Flop
Seat 2: perupoquer (big blind) collected ($0.07)
Seat 3: STRONGLEA folded on the Flop
Seat 4: délichoc folded before Flop (didn't bet)
Seat 5: Song91 folded before Flop (didn't bet)
Seat 6: nigel161 (button) folded on the Flop



PokerStars Hand #213864009440:  Hold'em No Limit ($0.01/$0.02 USD) - 2020/05/14 21:58:00 MSK [2020/05/14 14:58:00 ET]
Table 'Euforbo IV' 6-max Seat #1 is the button
Seat 1: lawlex_2 ($0.36 in chips) 
Seat 2: perupoquer ($1.34 in chips) 
Seat 3: STRONGLEA ($1.62 in chips) 
Seat 4: délichoc ($2.30 in chips) 
Seat 5: Song91 ($2.32 in chips) 
Seat 6: nigel161 ($1.92 in chips) 
perupoquer: posts small blind $0.01
STRONGLEA: posts big blind $0.02
*** HOLE CARDS ***
Dealt to lawlex_2 [Kc Tc]
délichoc: folds 
Song91: folds 
nigel161: calls $0.02
lawlex_2: raises $0.03 to $0.05
perupoquer: folds 
STRONGLEA: folds 
nigel161: calls $0.03
*** FLOP *** [8d 5s 7d]
STRONGLEA leaves the table
nigel161: checks 
lawlex_2: bets $0.09
nigel161: folds [2s 2h]
Uncalled bet ($0.09) returned to lawlex_2
lawlex_2 collected $0.13 from pot
lawlex_2: doesn't show hand 
*** SUMMARY ***
Total pot $0.13 | Rake $0 
Board [8d 5s 7d]
Seat 1: lawlex_2 (button) collected ($0.13)
Seat 2: perupoquer (small blind) folded before Flop
Seat 3: STRONGLEA (big blind) folded before Flop
Seat 4: délichoc folded before Flop (didn't bet)
Seat 5: Song91 folded before Flop (didn't bet)
Seat 6: nigel161 folded on the Flop



PokerStars Hand #213864034445:  Hold'em No Limit ($0.01/$0.02 USD) - 2020/05/14 21:58:35 MSK [2020/05/14 14:58:35 ET]
Table 'Euforbo IV' 6-max Seat #2 is the button
Seat 1: lawlex_2 ($0.44 in chips) 
Seat 2: perupoquer ($1.33 in chips) 
Seat 4: délichoc ($2.30 in chips) 
Seat 5: Song91 ($2.32 in chips) 
Seat 6: nigel161 ($1.87 in chips) 
délichoc: posts small blind $0.01
Song91: posts big blind $0.02
*** HOLE CARDS ***
Dealt to lawlex_2 [7c 9d]
nigel161: folds 
lawlex_2: folds 
perupoquer: raises $0.02 to $0.04
délichoc: folds 
Song91: calls $0.02
*** FLOP *** [Kd 4d 3d]
Song91: checks 
GEONICY joins the table at seat #3 
perupoquer: bets $0.05
Song91: folds 
Uncalled bet ($0.05) returned to perupoquer
perupoquer collected $0.09 from pot
perupoquer: doesn't show hand 
*** SUMMARY ***
Total pot $0.09 | Rake $0 
Board [Kd 4d 3d]
Seat 1: lawlex_2 folded before Flop (didn't bet)
Seat 2: perupoquer (button) collected ($0.09)
Seat 4: délichoc (small blind) folded before Flop
Seat 5: Song91 (big blind) folded on the Flop
Seat 6: nigel161 folded before Flop (didn't bet)



PokerStars Hand #213864059132:  Hold'em No Limit ($0.01/$0.02 USD) - 2020/05/14 21:59:10 MSK [2020/05/14 14:59:10 ET]
Table 'Euforbo IV' 6-max Seat #4 is the button
Seat 1: lawlex_2 ($0.44 in chips) 
Seat 2: perupoquer ($1.38 in chips) 
Seat 4: délichoc ($2.29 in chips) 
Seat 5: Song91 ($2.28 in chips) 
Seat 6: nigel161 ($1.87 in chips) 
Song91: posts small blind $0.01
nigel161: posts big blind $0.02
GEONICY: sits out 
*** HOLE CARDS ***
Dealt to lawlex_2 [4s Jc]
lawlex_2: folds 
perupoquer: folds 
délichoc: folds 
Song91: folds 
Uncalled bet ($0.01) returned to nigel161
nigel161 collected $0.02 from pot
nigel161: doesn't show hand 
*** SUMMARY ***
Total pot $0.02 | Rake $0 
Seat 1: lawlex_2 folded before Flop (didn't bet)
Seat 2: perupoquer folded before Flop (didn't bet)
Seat 4: délichoc (button) folded before Flop (didn't bet)
Seat 5: Song91 (small blind) folded before Flop
Seat 6: nigel161 (big blind) collected ($0.02)



PokerStars Hand #213864066994:  Hold'em No Limit ($0.01/$0.02 USD) - 2020/05/14 21:59:21 MSK [2020/05/14 14:59:21 ET]
Table 'Euforbo IV' 6-max Seat #5 is the button
Seat 1: lawlex_2 ($0.44 in chips) 
Seat 2: perupoquer ($1.38 in chips) 
Seat 4: délichoc ($2.29 in chips) 
Seat 5: Song91 ($2.27 in chips) 
Seat 6: nigel161 ($1.88 in chips) 
nigel161: posts small blind $0.01
lawlex_2: posts big blind $0.02
GEONICY: sits out 
*** HOLE CARDS ***
Dealt to lawlex_2 [2c Kd]
perupoquer: folds 
délichoc: folds 
Song91: raises $0.04 to $0.06
nigel161: folds 
lawlex_2: folds 
Uncalled bet ($0.04) returned to Song91
Song91 collected $0.05 from pot
Song91: doesn't show hand 
*** SUMMARY ***
Total pot $0.05 | Rake $0 
Seat 1: lawlex_2 (big blind) folded before Flop
Seat 2: perupoquer folded before Flop (didn't bet)
Seat 4: délichoc folded before Flop (didn't bet)
Seat 5: Song91 (button) collected ($0.05)
Seat 6: nigel161 (small blind) folded before Flop



PokerStars Hand #213864079324:  Hold'em No Limit ($0.01/$0.02 USD) - 2020/05/14 21:59:38 MSK [2020/05/14 14:59:38 ET]
Table 'Euforbo IV' 6-max Seat #6 is the button
Seat 1: lawlex_2 ($0.42 in chips) 
Seat 2: perupoquer ($1.38 in chips) 
Seat 4: délichoc ($2.29 in chips) 
Seat 5: Song91 ($2.30 in chips) 
Seat 6: nigel161 ($1.87 in chips) 
lawlex_2: posts small blind $0.01
perupoquer: posts big blind $0.02
GEONICY: sits out 
*** HOLE CARDS ***
Dealt to lawlex_2 [Th Jh]
délichoc: folds 
Song91: folds 
nigel161 has timed out
nigel161: folds 
lawlex_2: raises $0.03 to $0.05
perupoquer: calls $0.03
*** FLOP *** [5s 3s 7d]
lawlex_2: checks 
perupoquer: checks 
*** TURN *** [5s 3s 7d] [9h]
lawlex_2: checks 
perupoquer: checks 
*** RIVER *** [5s 3s 7d 9h] [Ks]
lawlex_2: bets $0.07
perupoquer: folds 
Uncalled bet ($0.07) returned to lawlex_2
lawlex_2 collected $0.10 from pot
lawlex_2: doesn't show hand 
*** SUMMARY ***
Total pot $0.10 | Rake $0 
Board [5s 3s 7d 9h Ks]
Seat 1: lawlex_2 (small blind) collected ($0.10)
Seat 2: perupoquer (big blind) folded on the River
Seat 4: délichoc folded before Flop (didn't bet)
Seat 5: Song91 folded before Flop (didn't bet)
Seat 6: nigel161 (button) folded before Flop (didn't bet)



PokerStars Hand #213864117223:  Hold'em No Limit ($0.01/$0.02 USD) - 2020/05/14 22:00:27 MSK [2020/05/14 15:00:27 ET]
Table 'Euforbo IV' 6-max Seat #1 is the button
Seat 1: lawlex_2 ($0.47 in chips) 
Seat 2: perupoquer ($1.33 in chips) 
Seat 3: GEONICY ($0.80 in chips) 
Seat 4: délichoc ($2.29 in chips) 
Seat 5: Song91 ($2.30 in chips) 
perupoquer: posts small blind $0.01
GEONICY: posts big blind $0.02
*** HOLE CARDS ***
Dealt to lawlex_2 [2h 3s]
délichoc: folds 
Song91: folds 
lawlex_2: folds 
perupoquer: folds 
Uncalled bet ($0.01) returned to GEONICY
GEONICY collected $0.02 from pot
GEONICY: doesn't show hand 
*** SUMMARY ***
Total pot $0.02 | Rake $0 
Seat 1: lawlex_2 (button) folded before Flop (didn't bet)
Seat 2: perupoquer (small blind) folded before Flop
Seat 3: GEONICY (big blind) collected ($0.02)
Seat 4: délichoc folded before Flop (didn't bet)
Seat 5: Song91 folded before Flop (didn't bet)



PokerStars Hand #213864127051:  Hold'em No Limit ($0.01/$0.02 USD) - 2020/05/14 22:00:40 MSK [2020/05/14 15:00:40 ET]
Table 'Euforbo IV' 6-max Seat #2 is the button
Seat 1: lawlex_2 ($0.47 in chips) 
Seat 2: perupoquer ($1.32 in chips) 
Seat 3: GEONICY ($0.81 in chips) 
Seat 4: délichoc ($2.29 in chips) 
Seat 5: Song91 ($2.30 in chips) 
GEONICY: posts small blind $0.01
délichoc: posts big blind $0.02
*** HOLE CARDS ***
Dealt to lawlex_2 [Tc 6h]
Song91: folds 
lawlex_2: folds 
perupoquer: folds 
GEONICY: folds 
Uncalled bet ($0.01) returned to délichoc
délichoc collected $0.02 from pot
délichoc: doesn't show hand 
*** SUMMARY ***
Total pot $0.02 | Rake $0 
Seat 1: lawlex_2 folded before Flop (didn't bet)
Seat 2: perupoquer (button) folded before Flop (didn't bet)
Seat 3: GEONICY (small blind) folded before Flop
Seat 4: délichoc (big blind) collected ($0.02)
Seat 5: Song91 folded before Flop (didn't bet)



PokerStars Hand #213864139046:  Hold'em No Limit ($0.01/$0.02 USD) - 2020/05/14 22:00:54 MSK [2020/05/14 15:00:54 ET]
Table 'Euforbo IV' 6-max Seat #3 is the button
Seat 1: lawlex_2 ($0.47 in chips) 
Seat 2: perupoquer ($1.32 in chips) 
Seat 3: GEONICY ($0.80 in chips) 
Seat 4: délichoc ($2.30 in chips) 
Seat 5: Song91 ($2.30 in chips) 
délichoc: posts small blind $0.01
Song91: posts big blind $0.02
*** HOLE CARDS ***
Dealt to lawlex_2 [Kh 8c]
lawlex_2: folds 
perupoquer: folds 
GEONICY: folds 
délichoc: raises $0.02 to $0.04
Song91: raises $0.12 to $0.16
délichoc: calls $0.12
*** FLOP *** [Th 9h 5h]
délichoc: checks 
Song91: bets $0.20
délichoc: folds 
Uncalled bet ($0.20) returned to Song91
Song91 collected $0.31 from pot
Song91: doesn't show hand 
*** SUMMARY ***
Total pot $0.32 | Rake $0.01 
Board [Th 9h 5h]
Seat 1: lawlex_2 folded before Flop (didn't bet)
Seat 2: perupoquer folded before Flop (didn't bet)
Seat 3: GEONICY (button) folded before Flop (didn't bet)
Seat 4: délichoc (small blind) folded on the Flop
Seat 5: Song91 (big blind) collected ($0.31)



PokerStars Hand #213864187632:  Hold'em No Limit ($0.01/$0.02 USD) - 2020/05/14 22:01:49 MSK [2020/05/14 15:01:49 ET]
Table 'Euforbo IV' 6-max Seat #4 is the button
Seat 1: lawlex_2 ($0.47 in chips) 
Seat 2: perupoquer ($1.32 in chips) 
Seat 3: GEONICY ($0.80 in chips) 
Seat 4: délichoc ($2.14 in chips) 
Seat 5: Song91 ($2.45 in chips) 
Song91: posts small blind $0.01
lawlex_2: posts big blind $0.02
*** HOLE CARDS ***
Dealt to lawlex_2 [6c 7c]
perupoquer: folds 
GEONICY: folds 
délichoc: folds 
Song91: raises $0.04 to $0.06
lawlex_2: folds 
Uncalled bet ($0.04) returned to Song91
Song91 collected $0.04 from pot
Song91: doesn't show hand 
*** SUMMARY ***
Total pot $0.04 | Rake $0 
Seat 1: lawlex_2 (big blind) folded before Flop
Seat 2: perupoquer folded before Flop (didn't bet)
Seat 3: GEONICY folded before Flop (didn't bet)
Seat 4: délichoc (button) folded before Flop (didn't bet)
Seat 5: Song91 (small blind) collected ($0.04)



PokerStars Hand #213864204143:  Hold'em No Limit ($0.01/$0.02 USD) - 2020/05/14 22:02:06 MSK [2020/05/14 15:02:06 ET]
Table 'Euforbo IV' 6-max Seat #5 is the button
Seat 1: lawlex_2 ($0.45 in chips) 
Seat 2: perupoquer ($1.32 in chips) 
Seat 3: GEONICY ($0.80 in chips) 
Seat 4: délichoc ($2.14 in chips) 
Seat 5: Song91 ($2.47 in chips) 
lawlex_2: posts small blind $0.01
perupoquer: posts big blind $0.02
*** HOLE CARDS ***
Dealt to lawlex_2 [7d 4h]
GEONICY: folds 
délichoc: raises $0.04 to $0.06
Song91: folds 
lawlex_2: folds 
perupoquer: folds 
Uncalled bet ($0.04) returned to délichoc
délichoc collected $0.05 from pot
délichoc: doesn't show hand 
*** SUMMARY ***
Total pot $0.05 | Rake $0 
Seat 1: lawlex_2 (small blind) folded before Flop
Seat 2: perupoquer (big blind) folded before Flop
Seat 3: GEONICY folded before Flop (didn't bet)
Seat 4: délichoc collected ($0.05)
Seat 5: Song91 (button) folded before Flop (didn't bet)



PokerStars Hand #213864219578:  Hold'em No Limit ($0.01/$0.02 USD) - 2020/05/14 22:02:21 MSK [2020/05/14 15:02:21 ET]
Table 'Euforbo IV' 6-max Seat #1 is the button
Seat 1: lawlex_2 ($0.44 in chips) 
Seat 2: perupoquer ($1.30 in chips) 
Seat 3: GEONICY ($0.80 in chips) 
Seat 4: délichoc ($2.17 in chips) 
Seat 5: Song91 ($2.47 in chips) 
perupoquer: posts small blind $0.01
GEONICY: posts big blind $0.02
*** HOLE CARDS ***
Dealt to lawlex_2 [Qc Jc]
délichoc: folds 
Song91: folds 
lawlex_2: raises $0.03 to $0.05
perupoquer: folds 
GEONICY: raises $0.15 to $0.20
lawlex_2: folds 
Uncalled bet ($0.15) returned to GEONICY
GEONICY collected $0.11 from pot
*** SUMMARY ***
Total pot $0.11 | Rake $0 
Seat 1: lawlex_2 (button) folded before Flop
Seat 2: perupoquer (small blind) folded before Flop
Seat 3: GEONICY (big blind) collected ($0.11)
Seat 4: délichoc folded before Flop (didn't bet)
Seat 5: Song91 folded before Flop (didn't bet)



PokerStars Hand #213864240637:  Hold'em No Limit ($0.01/$0.02 USD) - 2020/05/14 22:02:42 MSK [2020/05/14 15:02:42 ET]
Table 'Euforbo IV' 6-max Seat #2 is the button
Seat 1: lawlex_2 ($0.39 in chips) 
Seat 2: perupoquer ($1.29 in chips) 
Seat 3: GEONICY ($0.86 in chips) 
Seat 4: délichoc ($2.17 in chips) 
Seat 5: Song91 ($2.47 in chips) 
GEONICY: posts small blind $0.01
délichoc: posts big blind $0.02
*** HOLE CARDS ***
Dealt to lawlex_2 [Ah As]
Song91: folds 
lawlex_2: raises $0.03 to $0.05
perupoquer: calls $0.05
GEONICY: folds 
délichoc: folds 
*** FLOP *** [Qd 7c Ad]
lawlex_2: bets $0.09
perupoquer: calls $0.09
*** TURN *** [Qd 7c Ad] [Td]
lawlex_2: bets $0.20
perupoquer: folds 
Uncalled bet ($0.20) returned to lawlex_2
lawlex_2 collected $0.30 from pot
lawlex_2: doesn't show hand 
*** SUMMARY ***
Total pot $0.31 | Rake $0.01 
Board [Qd 7c Ad Td]
Seat 1: lawlex_2 collected ($0.30)
Seat 2: perupoquer (button) folded on the Turn
Seat 3: GEONICY (small blind) folded before Flop
Seat 4: délichoc (big blind) folded before Flop
Seat 5: Song91 folded before Flop (didn't bet)



PokerStars Hand #213864275606:  Hold'em No Limit ($0.01/$0.02 USD) - 2020/05/14 22:03:16 MSK [2020/05/14 15:03:16 ET]
Table 'Euforbo IV' 6-max Seat #3 is the button
Seat 1: lawlex_2 ($0.55 in chips) 
Seat 2: perupoquer ($1.15 in chips) 
Seat 3: GEONICY ($0.85 in chips) 
Seat 4: délichoc ($2.15 in chips) 
Seat 5: Song91 ($2.47 in chips) 
délichoc: posts small blind $0.01
Song91: posts big blind $0.02
nigel161: sits out 
*** HOLE CARDS ***
Dealt to lawlex_2 [Jd Kc]
lawlex_2: raises $0.03 to $0.05
perupoquer: folds 
GEONICY: folds 
délichoc: folds 
Song91: folds 
Uncalled bet ($0.03) returned to lawlex_2
lawlex_2 collected $0.05 from pot
lawlex_2: doesn't show hand 
*** SUMMARY ***
Total pot $0.05 | Rake $0 
Seat 1: lawlex_2 collected ($0.05)
Seat 2: perupoquer folded before Flop (didn't bet)
Seat 3: GEONICY (button) folded before Flop (didn't bet)
Seat 4: délichoc (small blind) folded before Flop
Seat 5: Song91 (big blind) folded before Flop



PokerStars Hand #213864301527:  Hold'em No Limit ($0.01/$0.02 USD) - 2020/05/14 22:03:40 MSK [2020/05/14 15:03:40 ET]
Table 'Euforbo IV' 6-max Seat #4 is the button
Seat 1: lawlex_2 ($0.58 in chips) 
Seat 2: perupoquer ($1.15 in chips) 
Seat 3: GEONICY ($0.85 in chips) 
Seat 4: délichoc ($2.14 in chips) 
Seat 5: Song91 ($2.45 in chips) 
Seat 6: nigel161 ($1.87 in chips) 
Song91: posts small blind $0.01
nigel161: posts big blind $0.02
*** HOLE CARDS ***
Dealt to lawlex_2 [8h Kc]
lawlex_2: folds 
perupoquer: folds 
GEONICY: folds 
délichoc: folds 
Song91: raises $0.04 to $0.06
nigel161: calls $0.04
*** FLOP *** [Kh 7d Qc]
Song91: bets $0.08
nigel161: folds 
Uncalled bet ($0.08) returned to Song91
Song91 collected $0.12 from pot
Song91: doesn't show hand 
*** SUMMARY ***
Total pot $0.12 | Rake $0 
Board [Kh 7d Qc]
Seat 1: lawlex_2 folded before Flop (didn't bet)
Seat 2: perupoquer folded before Flop (didn't bet)
Seat 3: GEONICY folded before Flop (didn't bet)
Seat 4: délichoc (button) folded before Flop (didn't bet)
Seat 5: Song91 (small blind) collected ($0.12)
Seat 6: nigel161 (big blind) folded on the Flop



PokerStars Hand #213864342356:  Hold'em No Limit ($0.01/$0.02 USD) - 2020/05/14 22:04:20 MSK [2020/05/14 15:04:20 ET]
Table 'Euforbo IV' 6-max Seat #5 is the button
Seat 1: lawlex_2 ($0.58 in chips) 
Seat 2: perupoquer ($1.15 in chips) 
Seat 3: GEONICY ($0.85 in chips) 
Seat 4: délichoc ($2.14 in chips) 
Seat 5: Song91 ($2.51 in chips) 
Seat 6: nigel161 ($1.81 in chips) 
nigel161: posts small blind $0.01
lawlex_2: posts big blind $0.02
*** HOLE CARDS ***
Dealt to lawlex_2 [7s Kc]
perupoquer: raises $0.02 to $0.04
GEONICY: calls $0.04
délichoc: raises $0.14 to $0.18
Song91: folds 
nigel161: folds 
lawlex_2: folds 
perupoquer: folds 
GEONICY: calls $0.14
*** FLOP *** [Jh 3d 9c]
GEONICY: bets $0.67 and is all-in
délichoc: calls $0.67
*** TURN *** [Jh 3d 9c] [Ks]
*** RIVER *** [Jh 3d 9c Ks] [8d]
*** SHOW DOWN ***
GEONICY: shows [8c Tc] (a pair of Eights)
délichoc: shows [As Ah] (a pair of Aces)
délichoc cashed out the hand for $1.06 | Cash Out Fee $0.01
*** SUMMARY ***
Total pot $1.77 | Rake $0.06 
Board [Jh 3d 9c Ks 8d]
Seat 1: lawlex_2 (big blind) folded before Flop
Seat 2: perupoquer folded before Flop
Seat 3: GEONICY showed [8c Tc] and lost with a pair of Eights
Seat 4: délichoc showed [As Ah] and won ($1.71) with a pair of Aces (pot not awarded as player cashed out)
Seat 5: Song91 (button) folded before Flop (didn't bet)
Seat 6: nigel161 (small blind) folded before Flop



PokerStars Hand #213864390381:  Hold'em No Limit ($0.01/$0.02 USD) - 2020/05/14 22:05:05 MSK [2020/05/14 15:05:05 ET]
Table 'Euforbo IV' 6-max Seat #6 is the button
Seat 1: lawlex_2 ($0.56 in chips) 
Seat 2: perupoquer ($1.11 in chips) 
Seat 4: délichoc ($2.35 in chips) 
Seat 5: Song91 ($2.51 in chips) 
Seat 6: nigel161 ($1.80 in chips) 
lawlex_2: posts small blind $0.01
perupoquer: posts big blind $0.02
*** HOLE CARDS ***
Dealt to lawlex_2 [6s Qs]
délichoc: folds 
Song91: folds 
nigel161: calls $0.02
lawlex_2: folds 
GEONICY leaves the table
perupoquer: raises $0.05 to $0.07
gent168 joins the table at seat #3 
nigel161: calls $0.05
*** FLOP *** [3s Qd 6d]
perupoquer: bets $0.04
nigel161: calls $0.04
*** TURN *** [3s Qd 6d] [Jd]
perupoquer: bets $0.04
nigel161: raises $0.04 to $0.08
perupoquer: calls $0.04
*** RIVER *** [3s Qd 6d Jd] [As]
perupoquer: checks 
nigel161: bets $0.08
perupoquer: folds 
Uncalled bet ($0.08) returned to nigel161
nigel161 collected $0.38 from pot
nigel161: doesn't show hand 
*** SUMMARY ***
Total pot $0.39 | Rake $0.01 
Board [3s Qd 6d Jd As]
Seat 1: lawlex_2 (small blind) folded before Flop
Seat 2: perupoquer (big blind) folded on the River
Seat 4: délichoc folded before Flop (didn't bet)
Seat 5: Song91 folded before Flop (didn't bet)
Seat 6: nigel161 (button) collected ($0.38)



PokerStars Hand #213864450898:  Hold'em No Limit ($0.01/$0.02 USD) - 2020/05/14 22:06:01 MSK [2020/05/14 15:06:01 ET]
Table 'Euforbo IV' 6-max Seat #1 is the button
Seat 1: lawlex_2 ($0.55 in chips) 
Seat 2: perupoquer ($0.92 in chips) 
Seat 3: gent168 ($1.60 in chips) 
Seat 4: délichoc ($2.35 in chips) 
Seat 5: Song91 ($2.51 in chips) 
Seat 6: nigel161 ($1.99 in chips) 
perupoquer: posts small blind $0.01
gent168: posts big blind $0.02
*** HOLE CARDS ***
Dealt to lawlex_2 [5c 4d]
délichoc: raises $0.04 to $0.06
Song91: folds 
nigel161: calls $0.06
lawlex_2: folds 
perupoquer: folds 
gent168: calls $0.04
*** FLOP *** [Th 6s Kh]
gent168: checks 
délichoc: bets $0.12
nigel161: calls $0.12
gent168: folds 
*** TURN *** [Th 6s Kh] [Ah]
délichoc: bets $0.26
nigel161: calls $0.26
*** RIVER *** [Th 6s Kh Ah] [8s]
délichoc: bets $0.52
nigel161: calls $0.52
*** SHOW DOWN ***
délichoc: shows [Js Ad] (a pair of Aces)
nigel161: shows [6d Ks] (two pair, Kings and Sixes)
nigel161 collected $1.92 from pot
*** SUMMARY ***
Total pot $1.99 | Rake $0.07 
Board [Th 6s Kh Ah 8s]
Seat 1: lawlex_2 (button) folded before Flop (didn't bet)
Seat 2: perupoquer (small blind) folded before Flop
Seat 3: gent168 (big blind) folded on the Flop
Seat 4: délichoc showed [Js Ad] and lost with a pair of Aces
Seat 5: Song91 folded before Flop (didn't bet)
Seat 6: nigel161 showed [6d Ks] and won ($1.92) with two pair, Kings and Sixes



PokerStars Hand #213864514831:  Hold'em No Limit ($0.01/$0.02 USD) - 2020/05/14 22:06:54 MSK [2020/05/14 15:06:54 ET]
Table 'Euforbo IV' 6-max Seat #2 is the button
Seat 1: lawlex_2 ($0.55 in chips) 
Seat 2: perupoquer ($0.91 in chips) 
Seat 3: gent168 ($1.54 in chips) 
Seat 4: délichoc ($2 in chips) 
Seat 5: Song91 ($2.51 in chips) 
Seat 6: nigel161 ($2.95 in chips) 
gent168: posts small blind $0.01
délichoc: posts big blind $0.02
*** HOLE CARDS ***
Dealt to lawlex_2 [6c 3d]
Song91: folds 
nigel161: raises $0.02 to $0.04
lawlex_2: folds 
perupoquer: folds 
gent168: folds 
délichoc: folds 
Uncalled bet ($0.02) returned to nigel161
nigel161 collected $0.05 from pot
nigel161: doesn't show hand 
*** SUMMARY ***
Total pot $0.05 | Rake $0 
Seat 1: lawlex_2 folded before Flop (didn't bet)
Seat 2: perupoquer (button) folded before Flop (didn't bet)
Seat 3: gent168 (small blind) folded before Flop
Seat 4: délichoc (big blind) folded before Flop
Seat 5: Song91 folded before Flop (didn't bet)
Seat 6: nigel161 collected ($0.05)



PokerStars Hand #213864533085:  Hold'em No Limit ($0.01/$0.02 USD) - 2020/05/14 22:07:11 MSK [2020/05/14 15:07:11 ET]
Table 'Euforbo IV' 6-max Seat #3 is the button
Seat 1: lawlex_2 ($0.55 in chips) 
Seat 2: perupoquer ($0.91 in chips) 
Seat 3: gent168 ($1.53 in chips) 
Seat 4: délichoc ($2 in chips) 
Seat 5: Song91 ($2.51 in chips) 
Seat 6: nigel161 ($2.98 in chips) 
délichoc: posts small blind $0.01
Song91: posts big blind $0.02
*** HOLE CARDS ***
Dealt to lawlex_2 [5d 2h]
nigel161: raises $0.02 to $0.04
lawlex_2: folds 
perupoquer: folds 
gent168: calls $0.04
délichoc: folds 
Song91: calls $0.02
*** FLOP *** [Ad 9h 6d]
Song91: bets $0.08
nigel161: calls $0.08
gent168: folds 
*** TURN *** [Ad 9h 6d] [3h]
Song91: bets $0.22
nigel161: calls $0.22
*** RIVER *** [Ad 9h 6d 3h] [8c]
Song91: checks 
nigel161: bets $0.35
Song91: calls $0.35
*** SHOW DOWN ***
nigel161: shows [Ac Ah] (three of a kind, Aces)
Song91: mucks hand 
nigel161 collected $1.38 from pot
*** SUMMARY ***
Total pot $1.43 | Rake $0.05 
Board [Ad 9h 6d 3h 8c]
Seat 1: lawlex_2 folded before Flop (didn't bet)
Seat 2: perupoquer folded before Flop (didn't bet)
Seat 3: gent168 (button) folded on the Flop
Seat 4: délichoc (small blind) folded before Flop
Seat 5: Song91 (big blind) mucked [Td Kd]
Seat 6: nigel161 showed [Ac Ah] and won ($1.38) with three of a kind, Aces



PokerStars Hand #213864607589:  Hold'em No Limit ($0.01/$0.02 USD) - 2020/05/14 22:08:13 MSK [2020/05/14 15:08:13 ET]
Table 'Euforbo IV' 6-max Seat #4 is the button
Seat 1: lawlex_2 ($0.55 in chips) 
Seat 2: perupoquer ($0.91 in chips) 
Seat 3: gent168 ($1.49 in chips) 
Seat 4: délichoc ($2 in chips) 
Seat 5: Song91 ($1.82 in chips) 
Seat 6: nigel161 ($3.67 in chips) 
Song91: posts small blind $0.01
nigel161: posts big blind $0.02
*** HOLE CARDS ***
Dealt to lawlex_2 [As Ts]
lawlex_2: raises $0.03 to $0.05
perupoquer: folds 
gent168: folds 
délichoc: folds 
Song91: folds 
nigel161: calls $0.03
*** FLOP *** [Tc Th 8c]
gent168 leaves the table
nigel161: bets $0.02
lawlex_2: raises $0.10 to $0.12
nigel161: folds 
Uncalled bet ($0.10) returned to lawlex_2
lawlex_2 collected $0.14 from pot
lawlex_2: doesn't show hand 
*** SUMMARY ***
Total pot $0.15 | Rake $0.01 
Board [Tc Th 8c]
Seat 1: lawlex_2 collected ($0.14)
Seat 2: perupoquer folded before Flop (didn't bet)
Seat 3: gent168 folded before Flop (didn't bet)
Seat 4: délichoc (button) folded before Flop (didn't bet)
Seat 5: Song91 (small blind) folded before Flop
Seat 6: nigel161 (big blind) folded on the Flop



PokerStars Hand #213864637377:  Hold'em No Limit ($0.01/$0.02 USD) - 2020/05/14 22:08:40 MSK [2020/05/14 15:08:40 ET]
Table 'Euforbo IV' 6-max Seat #5 is the button
Seat 1: lawlex_2 ($0.62 in chips) 
Seat 2: perupoquer ($0.91 in chips) 
Seat 4: délichoc ($2 in chips) 
Seat 5: Song91 ($1.81 in chips) 
Seat 6: nigel161 ($3.60 in chips) 
nigel161: posts small blind $0.01
lawlex_2: posts big blind $0.02
*** HOLE CARDS ***
Dealt to lawlex_2 [9s Ks]
perupoquer: folds 
délichoc: raises $0.04 to $0.06
Song91: folds 
nigel161: calls $0.05
lawlex_2: folds 
*** FLOP *** [5h Kd 3s]
jpamb joins the table at seat #3 
nigel161: checks 
délichoc: bets $0.10
nigel161: calls $0.10
*** TURN *** [5h Kd 3s] [4d]
nigel161: bets $0.10
délichoc: calls $0.10
*** RIVER *** [5h Kd 3s 4d] [Th]
nigel161: bets $0.06
délichoc: folds 
Uncalled bet ($0.06) returned to nigel161
nigel161 collected $0.52 from pot
nigel161: doesn't show hand 
*** SUMMARY ***
Total pot $0.54 | Rake $0.02 
Board [5h Kd 3s 4d Th]
Seat 1: lawlex_2 (big blind) folded before Flop
Seat 2: perupoquer folded before Flop (didn't bet)
Seat 4: délichoc folded on the River
Seat 5: Song91 (button) folded before Flop (didn't bet)
Seat 6: nigel161 (small blind) collected ($0.52)



PokerStars Hand #213864695372:  Hold'em No Limit ($0.01/$0.02 USD) - 2020/05/14 22:09:34 MSK [2020/05/14 15:09:34 ET]
Table 'Euforbo IV' 6-max Seat #6 is the button
Seat 1: lawlex_2 ($0.60 in chips) 
Seat 2: perupoquer ($0.91 in chips) 
Seat 4: délichoc ($2 in chips) 
Seat 5: Song91 ($1.81 in chips) 
Seat 6: nigel161 ($3.86 in chips) 
lawlex_2: posts small blind $0.01
perupoquer: posts big blind $0.02
jpamb: sits out 
*** HOLE CARDS ***
Dealt to lawlex_2 [8d Ah]
délichoc: folds 
Song91: raises $0.04 to $0.06
nigel161: calls $0.06
lawlex_2: folds 
perupoquer: calls $0.04
*** FLOP *** [7d 5s 6h]
perupoquer: checks 
Song91: checks 
nigel161: checks 
*** TURN *** [7d 5s 6h] [Kc]
perupoquer: checks 
Song91: checks 
nigel161: checks 
*** RIVER *** [7d 5s 6h Kc] [3s]
perupoquer: bets $0.10
Song91: folds 
nigel161: calls $0.10
*** SHOW DOWN ***
perupoquer: shows [2s 4s] (a straight, Three to Seven)
nigel161: mucks hand 
perupoquer collected $0.38 from pot
*** SUMMARY ***
Total pot $0.39 | Rake $0.01 
Board [7d 5s 6h Kc 3s]
Seat 1: lawlex_2 (small blind) folded before Flop
Seat 2: perupoquer (big blind) showed [2s 4s] and won ($0.38) with a straight, Three to Seven
Seat 4: délichoc folded before Flop (didn't bet)
Seat 5: Song91 folded on the River
Seat 6: nigel161 (button) mucked [Qd Qc]



PokerStars Hand #213864743165:  Hold'em No Limit ($0.01/$0.02 USD) - 2020/05/14 22:10:17 MSK [2020/05/14 15:10:17 ET]
Table 'Euforbo IV' 6-max Seat #1 is the button
Seat 1: lawlex_2 ($0.59 in chips) 
Seat 2: perupoquer ($1.13 in chips) 
Seat 3: jpamb ($2 in chips) 
Seat 4: délichoc ($2 in chips) 
Seat 5: Song91 ($1.75 in chips) 
Seat 6: nigel161 ($3.70 in chips) 
perupoquer: posts small blind $0.01
jpamb: posts big blind $0.02
*** HOLE CARDS ***
Dealt to lawlex_2 [3h 4h]
délichoc: folds 
Song91: folds 
nigel161: calls $0.02
lawlex_2: folds 
perupoquer: folds 
jpamb: checks 
*** FLOP *** [2h 9h As]
jpamb: checks 
nigel161: bets $0.02
jpamb: calls $0.02
*** TURN *** [2h 9h As] [Js]
jpamb: checks 
nigel161: bets $0.02
jpamb: calls $0.02
*** RIVER *** [2h 9h As Js] [9s]
jpamb: checks 
nigel161: bets $0.02
jpamb: folds 
Uncalled bet ($0.02) returned to nigel161
nigel161 collected $0.13 from pot
nigel161: doesn't show hand 
*** SUMMARY ***
Total pot $0.13 | Rake $0 
Board [2h 9h As Js 9s]
Seat 1: lawlex_2 (button) folded before Flop (didn't bet)
Seat 2: perupoquer (small blind) folded before Flop
Seat 3: jpamb (big blind) folded on the River
Seat 4: délichoc folded before Flop (didn't bet)
Seat 5: Song91 folded before Flop (didn't bet)
Seat 6: nigel161 collected ($0.13)



PokerStars Hand #213864795593:  Hold'em No Limit ($0.01/$0.02 USD) - 2020/05/14 22:11:06 MSK [2020/05/14 15:11:06 ET]
Table 'Euforbo IV' 6-max Seat #2 is the button
Seat 1: lawlex_2 ($0.59 in chips) 
Seat 2: perupoquer ($1.12 in chips) 
Seat 3: jpamb ($2 in chips) 
Seat 5: Song91 ($1.75 in chips) 
Seat 6: nigel161 ($3.77 in chips) 
jpamb: posts small blind $0.01
délichoc: is sitting out 
Song91: posts big blind $0.02
*** HOLE CARDS ***
Dealt to lawlex_2 [Jc 7c]
nigel161: calls $0.02
lawlex_2: folds 
perupoquer: raises $0.07 to $0.09
jpamb: folds 
Song91: folds 
nigel161: calls $0.07
*** FLOP *** [Ah 7s 5h]
délichoc leaves the table
nigel161: checks 
perupoquer: checks 
*** TURN *** [Ah 7s 5h] [2s]
nigel161: checks 
perupoquer: checks 
*** RIVER *** [Ah 7s 5h 2s] [5d]
nigel161: checks 
_Anagor_AA joins the table at seat #4 
perupoquer: checks 
*** SHOW DOWN ***
nigel161: shows [Qd 3h] (a pair of Fives)
perupoquer: shows [Qs Qh] (two pair, Queens and Fives)
perupoquer collected $0.20 from pot
*** SUMMARY ***
Total pot $0.21 | Rake $0.01 
Board [Ah 7s 5h 2s 5d]
Seat 1: lawlex_2 folded before Flop (didn't bet)
Seat 2: perupoquer (button) showed [Qs Qh] and won ($0.20) with two pair, Queens and Fives
Seat 3: jpamb (small blind) folded before Flop
Seat 5: Song91 (big blind) folded before Flop
Seat 6: nigel161 showed [Qd 3h] and lost with a pair of Fives



PokerStars Hand #213864845976:  Hold'em No Limit ($0.01/$0.02 USD) - 2020/05/14 22:11:52 MSK [2020/05/14 15:11:52 ET]
Table 'Euforbo IV' 6-max Seat #3 is the button
Seat 1: lawlex_2 ($0.59 in chips) 
Seat 2: perupoquer ($1.23 in chips) 
Seat 3: jpamb ($2 in chips) 
Seat 5: Song91 ($1.73 in chips) 
Seat 6: nigel161 ($3.68 in chips) 
Song91: posts small blind $0.01
nigel161: posts big blind $0.02
*** HOLE CARDS ***
Dealt to lawlex_2 [Ks 6c]
lawlex_2: folds 
perupoquer: folds 
jpamb: raises $0.04 to $0.06
Song91: folds 
nigel161: calls $0.04
*** FLOP *** [Qc Qs Ah]
nigel161: bets $0.04
jpamb: folds 
Uncalled bet ($0.04) returned to nigel161
nigel161 collected $0.13 from pot
nigel161: doesn't show hand 
*** SUMMARY ***
Total pot $0.13 | Rake $0 
Board [Qc Qs Ah]
Seat 1: lawlex_2 folded before Flop (didn't bet)
Seat 2: perupoquer folded before Flop (didn't bet)
Seat 3: jpamb (button) folded on the Flop
Seat 5: Song91 (small blind) folded before Flop
Seat 6: nigel161 (big blind) collected ($0.13)



PokerStars Hand #213864881489:  Hold'em No Limit ($0.01/$0.02 USD) - 2020/05/14 22:12:25 MSK [2020/05/14 15:12:25 ET]
Table 'Euforbo IV' 6-max Seat #5 is the button
Seat 1: lawlex_2 ($0.59 in chips) 
Seat 2: perupoquer ($1.23 in chips) 
Seat 3: jpamb ($2 in chips) 
Seat 5: Song91 ($1.72 in chips) 
Seat 6: nigel161 ($3.75 in chips) 
nigel161: posts small blind $0.01
lawlex_2: posts big blind $0.02
_Anagor_AA: sits out 
*** HOLE CARDS ***
Dealt to lawlex_2 [8s 4c]
perupoquer: raises $0.02 to $0.04
jpamb: folds 
Song91: folds 
nigel161: calls $0.03
lawlex_2: folds 
*** FLOP *** [7h 6c 6d]
nigel161: checks 
perupoquer has timed out
perupoquer: checks 
*** TURN *** [7h 6c 6d] [Jc]
nigel161: bets $0.02
perupoquer has timed out
perupoquer: folds 
Uncalled bet ($0.02) returned to nigel161
nigel161 collected $0.10 from pot
nigel161: doesn't show hand 
*** SUMMARY ***
Total pot $0.10 | Rake $0 
Board [7h 6c 6d Jc]
Seat 1: lawlex_2 (big blind) folded before Flop
Seat 2: perupoquer folded on the Turn
Seat 3: jpamb folded before Flop (didn't bet)
Seat 5: Song91 (button) folded before Flop (didn't bet)
Seat 6: nigel161 (small blind) collected ($0.10)



PokerStars Hand #213864979360:  Hold'em No Limit ($0.01/$0.02 USD) - 2020/05/14 22:13:56 MSK [2020/05/14 15:13:56 ET]
Table 'Euforbo IV' 6-max Seat #6 is the button
Seat 1: lawlex_2 ($0.57 in chips) 
Seat 3: jpamb ($2 in chips) 
Seat 5: Song91 ($1.72 in chips) 
Seat 6: nigel161 ($3.81 in chips) 
lawlex_2: posts small blind $0.01
jpamb: posts big blind $0.02
_Anagor_AA: sits out 
*** HOLE CARDS ***
Dealt to lawlex_2 [5d 6h]
Song91: raises $0.04 to $0.06
nigel161: folds 
lawlex_2: folds 
jpamb: folds 
Uncalled bet ($0.04) returned to Song91
Song91 collected $0.05 from pot
Song91: doesn't show hand 
*** SUMMARY ***
Total pot $0.05 | Rake $0 
Seat 1: lawlex_2 (small blind) folded before Flop
Seat 3: jpamb (big blind) folded before Flop
Seat 5: Song91 collected ($0.05)
Seat 6: nigel161 (button) folded before Flop (didn't bet)



PokerStars Hand #213864990757:  Hold'em No Limit ($0.01/$0.02 USD) - 2020/05/14 22:14:06 MSK [2020/05/14 15:14:06 ET]
Table 'Euforbo IV' 6-max Seat #1 is the button
Seat 1: lawlex_2 ($0.56 in chips) 
Seat 3: jpamb ($2 in chips) 
Seat 4: _Anagor_AA ($2 in chips) 
Seat 5: Song91 ($1.75 in chips) 
Seat 6: nigel161 ($3.81 in chips) 
jpamb: posts small blind $0.01
_Anagor_AA: posts big blind $0.02
*** HOLE CARDS ***
Dealt to lawlex_2 [9c 3h]
Song91: folds 
nigel161: calls $0.02
lawlex_2: folds 
jpamb: raises $0.08 to $0.10
_Anagor_AA: folds 
Song91 leaves the table
nigel161: calls $0.08
*** FLOP *** [4c 2h 7c]
chiefbogo joins the table at seat #5 
jpamb: bets $0.08
nigel161: calls $0.08
*** TURN *** [4c 2h 7c] [3c]
jpamb: checks 
nigel161: checks 
*** RIVER *** [4c 2h 7c 3c] [8s]
jpamb: checks 
nigel161: checks 
*** SHOW DOWN ***
jpamb: shows [Ad Qs] (high card Ace)
nigel161: shows [8d 6c] (a pair of Eights)
nigel161 collected $0.37 from pot
*** SUMMARY ***
Total pot $0.38 | Rake $0.01 
Board [4c 2h 7c 3c 8s]
Seat 1: lawlex_2 (button) folded before Flop (didn't bet)
Seat 3: jpamb (small blind) showed [Ad Qs] and lost with high card Ace
Seat 4: _Anagor_AA (big blind) folded before Flop
Seat 5: Song91 folded before Flop (didn't bet)
Seat 6: nigel161 showed [8d 6c] and won ($0.37) with a pair of Eights



PokerStars Hand #213865050681:  Hold'em No Limit ($0.01/$0.02 USD) - 2020/05/14 22:15:01 MSK [2020/05/14 15:15:01 ET]
Table 'Euforbo IV' 6-max Seat #3 is the button
Seat 1: lawlex_2 ($0.56 in chips) 
Seat 2: perupoquer ($1.19 in chips) 
Seat 3: jpamb ($2 in chips) 
Seat 4: _Anagor_AA ($1.98 in chips) 
Seat 5: chiefbogo ($2 in chips) 
Seat 6: nigel161 ($4 in chips) 
_Anagor_AA: posts small blind $0.01
chiefbogo: posts big blind $0.02
perupoquer: posts small & big blinds $0.03
*** HOLE CARDS ***
Dealt to lawlex_2 [4c 8d]
nigel161: calls $0.02
lawlex_2: folds 
perupoquer: checks 
jpamb: folds 
_Anagor_AA: calls $0.01
chiefbogo: checks 
*** FLOP *** [Qd 5d Kd]
_Anagor_AA: checks 
chiefbogo: checks 
nigel161: checks 
perupoquer: checks 
*** TURN *** [Qd 5d Kd] [2s]
_Anagor_AA: checks 
chiefbogo: checks 
nigel161: checks 
perupoquer: checks 
*** RIVER *** [Qd 5d Kd 2s] [7h]
_Anagor_AA: checks 
chiefbogo: bets $0.02
nigel161: raises $0.06 to $0.08
perupoquer: folds 
_Anagor_AA: folds 
chiefbogo: folds 
Uncalled bet ($0.06) returned to nigel161
nigel161 collected $0.13 from pot
nigel161: doesn't show hand 
*** SUMMARY ***
Total pot $0.13 | Rake $0 
Board [Qd 5d Kd 2s 7h]
Seat 1: lawlex_2 folded before Flop (didn't bet)
Seat 2: perupoquer folded on the River (didn't bet)
Seat 3: jpamb (button) folded before Flop (didn't bet)
Seat 4: _Anagor_AA (small blind) folded on the River
Seat 5: chiefbogo (big blind) folded on the River
Seat 6: nigel161 collected ($0.13)



PokerStars Hand #213865119418:  Hold'em No Limit ($0.01/$0.02 USD) - 2020/05/14 22:16:04 MSK [2020/05/14 15:16:04 ET]
Table 'Euforbo IV' 6-max Seat #4 is the button
Seat 1: lawlex_2 ($0.56 in chips) 
Seat 2: perupoquer ($1.16 in chips) 
Seat 3: jpamb ($2 in chips) 
Seat 4: _Anagor_AA ($1.96 in chips) 
Seat 5: chiefbogo ($2 in chips) 
Seat 6: nigel161 ($4.09 in chips) 
chiefbogo: posts small blind $0.01
nigel161: posts big blind $0.02
*** HOLE CARDS ***
Dealt to lawlex_2 [6h 8s]
lawlex_2: folds 
perupoquer: folds 
jpamb: raises $0.04 to $0.06
_Anagor_AA: folds 
chiefbogo: folds 
nigel161: calls $0.04
*** FLOP *** [3h 4d 5d]
nigel161: checks 
jpamb: checks 
*** TURN *** [3h 4d 5d] [4h]
nigel161: bets $0.02
jpamb: folds 
Uncalled bet ($0.02) returned to nigel161
nigel161 collected $0.13 from pot
nigel161: doesn't show hand 
*** SUMMARY ***
Total pot $0.13 | Rake $0 
Board [3h 4d 5d 4h]
Seat 1: lawlex_2 folded before Flop (didn't bet)
Seat 2: perupoquer folded before Flop (didn't bet)
Seat 3: jpamb folded on the Turn
Seat 4: _Anagor_AA (button) folded before Flop (didn't bet)
Seat 5: chiefbogo (small blind) folded before Flop
Seat 6: nigel161 (big blind) collected ($0.13)



PokerStars Hand #213865168139:  Hold'em No Limit ($0.01/$0.02 USD) - 2020/05/14 22:16:48 MSK [2020/05/14 15:16:48 ET]
Table 'Euforbo IV' 6-max Seat #5 is the button
Seat 1: lawlex_2 ($0.56 in chips) 
Seat 2: perupoquer ($1.16 in chips) 
Seat 3: jpamb ($2 in chips) 
Seat 4: _Anagor_AA ($1.96 in chips) 
Seat 5: chiefbogo ($2 in chips) 
Seat 6: nigel161 ($4.16 in chips) 
nigel161: posts small blind $0.01
lawlex_2: posts big blind $0.02
*** HOLE CARDS ***
Dealt to lawlex_2 [9c Jc]
perupoquer: raises $0.02 to $0.04
jpamb: calls $0.04
_Anagor_AA: folds 
chiefbogo: folds 
nigel161: calls $0.03
lawlex_2: folds 
*** FLOP *** [5c Qs 6s]
nigel161: checks 
perupoquer: checks 
jpamb: bets $0.10
nigel161: folds 
perupoquer: folds 
Uncalled bet ($0.10) returned to jpamb
jpamb collected $0.14 from pot
jpamb: doesn't show hand 
*** SUMMARY ***
Total pot $0.14 | Rake $0 
Board [5c Qs 6s]
Seat 1: lawlex_2 (big blind) folded before Flop
Seat 2: perupoquer folded on the Flop
Seat 3: jpamb collected ($0.14)
Seat 4: _Anagor_AA folded before Flop (didn't bet)
Seat 5: chiefbogo (button) folded before Flop (didn't bet)
Seat 6: nigel161 (small blind) folded on the Flop



PokerStars Hand #213865210235:  Hold'em No Limit ($0.01/$0.02 USD) - 2020/05/14 22:17:27 MSK [2020/05/14 15:17:27 ET]
Table 'Euforbo IV' 6-max Seat #6 is the button
Seat 1: lawlex_2 ($0.54 in chips) 
Seat 2: perupoquer ($1.12 in chips) 
Seat 3: jpamb ($2.10 in chips) 
Seat 4: _Anagor_AA ($1.96 in chips) 
Seat 5: chiefbogo ($2 in chips) 
Seat 6: nigel161 ($4.12 in chips) 
lawlex_2: posts small blind $0.01
perupoquer: posts big blind $0.02
*** HOLE CARDS ***
Dealt to lawlex_2 [5s 5d]
jpamb: folds 
_Anagor_AA: raises $0.04 to $0.06
chiefbogo: folds 
nigel161: calls $0.06
lawlex_2: calls $0.05
perupoquer: folds 
*** FLOP *** [9c 7s Kh]
lawlex_2: checks 
_Anagor_AA: bets $0.10
nigel161: folds 
lawlex_2: folds 
Uncalled bet ($0.10) returned to _Anagor_AA
_Anagor_AA collected $0.19 from pot
_Anagor_AA: doesn't show hand 
*** SUMMARY ***
Total pot $0.20 | Rake $0.01 
Board [9c 7s Kh]
Seat 1: lawlex_2 (small blind) folded on the Flop
Seat 2: perupoquer (big blind) folded before Flop
Seat 3: jpamb folded before Flop (didn't bet)
Seat 4: _Anagor_AA collected ($0.19)
Seat 5: chiefbogo folded before Flop (didn't bet)
Seat 6: nigel161 (button) folded on the Flop



PokerStars Hand #213865239040:  Hold'em No Limit ($0.01/$0.02 USD) - 2020/05/14 22:17:53 MSK [2020/05/14 15:17:53 ET]
Table 'Euforbo IV' 6-max Seat #1 is the button
Seat 1: lawlex_2 ($0.48 in chips) 
Seat 2: perupoquer ($1.10 in chips) 
Seat 3: jpamb ($2.10 in chips) 
Seat 4: _Anagor_AA ($2.09 in chips) 
Seat 5: chiefbogo ($2 in chips) 
Seat 6: nigel161 ($4.06 in chips) 
perupoquer: posts small blind $0.01
jpamb: posts big blind $0.02
*** HOLE CARDS ***
Dealt to lawlex_2 [2s 9d]
_Anagor_AA: raises $0.04 to $0.06
chiefbogo: folds 
nigel161: calls $0.06
lawlex_2: folds 
perupoquer: folds 
jpamb: folds 
*** FLOP *** [Ah 3c 9c]
_Anagor_AA: bets $0.10
nigel161: calls $0.10
*** TURN *** [Ah 3c 9c] [Kd]
_Anagor_AA: bets $0.20
nigel161: calls $0.20
*** RIVER *** [Ah 3c 9c Kd] [6d]
_Anagor_AA: bets $0.40
nigel161: folds [9s]
Uncalled bet ($0.40) returned to _Anagor_AA
_Anagor_AA collected $0.72 from pot
_Anagor_AA: doesn't show hand 
*** SUMMARY ***
Total pot $0.75 | Rake $0.03 
Board [Ah 3c 9c Kd 6d]
Seat 1: lawlex_2 (button) folded before Flop (didn't bet)
Seat 2: perupoquer (small blind) folded before Flop
Seat 3: jpamb (big blind) folded before Flop
Seat 4: _Anagor_AA collected ($0.72)
Seat 5: chiefbogo folded before Flop (didn't bet)
Seat 6: nigel161 folded on the River



PokerStars Hand #213865300841:  Hold'em No Limit ($0.01/$0.02 USD) - 2020/05/14 22:18:44 MSK [2020/05/14 15:18:44 ET]
Table 'Euforbo IV' 6-max Seat #2 is the button
Seat 1: lawlex_2 ($0.48 in chips) 
Seat 2: perupoquer ($1.09 in chips) 
Seat 3: jpamb ($2.08 in chips) 
Seat 4: _Anagor_AA ($2.45 in chips) 
Seat 5: chiefbogo ($2 in chips) 
Seat 6: nigel161 ($3.70 in chips) 
jpamb: posts small blind $0.01
_Anagor_AA: posts big blind $0.02
*** HOLE CARDS ***
Dealt to lawlex_2 [8s 8h]
chiefbogo: folds 
nigel161: calls $0.02
lawlex_2: raises $0.03 to $0.05
perupoquer: folds 
jpamb: calls $0.04
_Anagor_AA: folds 
nigel161: calls $0.03
*** FLOP *** [3c Kc 8d]
jpamb: checks 
nigel161: bets $0.02
lawlex_2: raises $0.13 to $0.15
jpamb: folds 
nigel161: folds 
Uncalled bet ($0.13) returned to lawlex_2
lawlex_2 collected $0.20 from pot
lawlex_2: doesn't show hand 
*** SUMMARY ***
Total pot $0.21 | Rake $0.01 
Board [3c Kc 8d]
Seat 1: lawlex_2 collected ($0.20)
Seat 2: perupoquer (button) folded before Flop (didn't bet)
Seat 3: jpamb (small blind) folded on the Flop
Seat 4: _Anagor_AA (big blind) folded before Flop
Seat 5: chiefbogo folded before Flop (didn't bet)
Seat 6: nigel161 folded on the Flop



PokerStars Hand #213865329046:  Hold'em No Limit ($0.01/$0.02 USD) - 2020/05/14 22:19:10 MSK [2020/05/14 15:19:10 ET]
Table 'Euforbo IV' 6-max Seat #3 is the button
Seat 1: lawlex_2 ($0.61 in chips) 
Seat 2: perupoquer ($1.09 in chips) 
Seat 3: jpamb ($2.03 in chips) 
Seat 4: _Anagor_AA ($2.43 in chips) 
Seat 5: chiefbogo ($2 in chips) 
Seat 6: nigel161 ($3.63 in chips) 
_Anagor_AA: posts small blind $0.01
chiefbogo: posts big blind $0.02
*** HOLE CARDS ***
Dealt to lawlex_2 [Kc 7d]
nigel161: calls $0.02
lawlex_2: folds 
perupoquer: folds 
jpamb: folds 
_Anagor_AA: calls $0.01
chiefbogo: raises $0.06 to $0.08
nigel161: calls $0.06
_Anagor_AA: folds 
*** FLOP *** [5c 9c 2d]
chiefbogo: checks 
nigel161: bets $0.06
chiefbogo: calls $0.06
*** TURN *** [5c 9c 2d] [Tc]
chiefbogo: checks 
nigel161: bets $0.10
chiefbogo: calls $0.10
*** RIVER *** [5c 9c 2d Tc] [6h]
chiefbogo: checks 
nigel161: checks 
*** SHOW DOWN ***
chiefbogo: shows [Kh Ac] (high card Ace)
nigel161: shows [7h 7c] (a pair of Sevens)
nigel161 collected $0.48 from pot
*** SUMMARY ***
Total pot $0.50 | Rake $0.02 
Board [5c 9c 2d Tc 6h]
Seat 1: lawlex_2 folded before Flop (didn't bet)
Seat 2: perupoquer folded before Flop (didn't bet)
Seat 3: jpamb (button) folded before Flop (didn't bet)
Seat 4: _Anagor_AA (small blind) folded before Flop
Seat 5: chiefbogo (big blind) showed [Kh Ac] and lost with high card Ace
Seat 6: nigel161 showed [7h 7c] and won ($0.48) with a pair of Sevens



PokerStars Hand #213865402558:  Hold'em No Limit ($0.01/$0.02 USD) - 2020/05/14 22:20:17 MSK [2020/05/14 15:20:17 ET]
Table 'Euforbo IV' 6-max Seat #4 is the button
Seat 1: lawlex_2 ($0.61 in chips) 
Seat 2: perupoquer ($1.09 in chips) 
Seat 3: jpamb ($2.03 in chips) 
Seat 4: _Anagor_AA ($2.41 in chips) 
Seat 5: chiefbogo ($2 in chips) 
Seat 6: nigel161 ($3.87 in chips) 
chiefbogo: posts small blind $0.01
nigel161: posts big blind $0.02
*** HOLE CARDS ***
Dealt to lawlex_2 [7c Tc]
lawlex_2: folds 
perupoquer: raises $0.02 to $0.04
jpamb: folds 
_Anagor_AA: folds 
chiefbogo: folds 
nigel161: calls $0.02
*** FLOP *** [4s Qd 5d]
nigel161: checks 
perupoquer: bets $0.03
nigel161: calls $0.03
*** TURN *** [4s Qd 5d] [5s]
nigel161: checks 
perupoquer: bets $0.06
nigel161: folds 
Uncalled bet ($0.06) returned to perupoquer
perupoquer collected $0.14 from pot
perupoquer: doesn't show hand 
*** SUMMARY ***
Total pot $0.15 | Rake $0.01 
Board [4s Qd 5d 5s]
Seat 1: lawlex_2 folded before Flop (didn't bet)
Seat 2: perupoquer collected ($0.14)
Seat 3: jpamb folded before Flop (didn't bet)
Seat 4: _Anagor_AA (button) folded before Flop (didn't bet)
Seat 5: chiefbogo (small blind) folded before Flop
Seat 6: nigel161 (big blind) folded on the Turn



PokerStars Hand #213865441317:  Hold'em No Limit ($0.01/$0.02 USD) - 2020/05/14 22:20:52 MSK [2020/05/14 15:20:52 ET]
Table 'Euforbo IV' 6-max Seat #5 is the button
Seat 1: lawlex_2 ($0.61 in chips) 
Seat 2: perupoquer ($1.16 in chips) 
Seat 3: jpamb ($2.03 in chips) 
Seat 4: _Anagor_AA ($2.41 in chips) 
Seat 5: chiefbogo ($2 in chips) 
Seat 6: nigel161 ($3.80 in chips) 
nigel161: posts small blind $0.01
lawlex_2: posts big blind $0.02
*** HOLE CARDS ***
Dealt to lawlex_2 [Kh 3c]
perupoquer: raises $0.02 to $0.04
jpamb: folds 
_Anagor_AA: folds 
chiefbogo: folds 
nigel161: calls $0.03
lawlex_2: folds 
*** FLOP *** [Th 9c 7h]
nigel161: checks 
perupoquer: checks 
*** TURN *** [Th 9c 7h] [8s]
nigel161: checks 
perupoquer: bets $0.06
nigel161: folds 
Uncalled bet ($0.06) returned to perupoquer
perupoquer collected $0.10 from pot
perupoquer: doesn't show hand 
*** SUMMARY ***
Total pot $0.10 | Rake $0 
Board [Th 9c 7h 8s]
Seat 1: lawlex_2 (big blind) folded before Flop
Seat 2: perupoquer collected ($0.10)
Seat 3: jpamb folded before Flop (didn't bet)
Seat 4: _Anagor_AA folded before Flop (didn't bet)
Seat 5: chiefbogo (button) folded before Flop (didn't bet)
Seat 6: nigel161 (small blind) folded on the Turn



PokerStars Hand #213865490192:  Hold'em No Limit ($0.01/$0.02 USD) - 2020/05/14 22:21:37 MSK [2020/05/14 15:21:37 ET]
Table 'Euforbo IV' 6-max Seat #6 is the button
Seat 1: lawlex_2 ($0.59 in chips) 
Seat 2: perupoquer ($1.22 in chips) 
Seat 3: jpamb ($2.03 in chips) 
Seat 4: _Anagor_AA ($2.41 in chips) 
Seat 5: chiefbogo ($2 in chips) 
Seat 6: nigel161 ($3.76 in chips) 
lawlex_2: posts small blind $0.01
perupoquer: posts big blind $0.02
*** HOLE CARDS ***
Dealt to lawlex_2 [Jc Kh]
jpamb: folds 
_Anagor_AA: folds 
chiefbogo: folds 
nigel161: folds 
lawlex_2: raises $0.03 to $0.05
perupoquer: calls $0.03
*** FLOP *** [9c Qd 5h]
lawlex_2: bets $0.07
perupoquer: folds 
Uncalled bet ($0.07) returned to lawlex_2
lawlex_2 collected $0.10 from pot
lawlex_2: doesn't show hand 
*** SUMMARY ***
Total pot $0.10 | Rake $0 
Board [9c Qd 5h]
Seat 1: lawlex_2 (small blind) collected ($0.10)
Seat 2: perupoquer (big blind) folded on the Flop
Seat 3: jpamb folded before Flop (didn't bet)
Seat 4: _Anagor_AA folded before Flop (didn't bet)
Seat 5: chiefbogo folded before Flop (didn't bet)
Seat 6: nigel161 (button) folded before Flop (didn't bet)



PokerStars Hand #213865518455:  Hold'em No Limit ($0.01/$0.02 USD) - 2020/05/14 22:22:03 MSK [2020/05/14 15:22:03 ET]
Table 'Euforbo IV' 6-max Seat #1 is the button
Seat 1: lawlex_2 ($0.64 in chips) 
Seat 2: perupoquer ($1.17 in chips) 
Seat 3: jpamb ($2.03 in chips) 
Seat 4: _Anagor_AA ($2.41 in chips) 
Seat 5: chiefbogo ($2 in chips) 
Seat 6: nigel161 ($3.76 in chips) 
perupoquer: posts small blind $0.01
jpamb: posts big blind $0.02
*** HOLE CARDS ***
Dealt to lawlex_2 [7c 4d]
_Anagor_AA: folds 
chiefbogo: folds 
nigel161: folds 
lawlex_2: folds 
perupoquer: calls $0.01
jpamb: checks 
*** FLOP *** [7s 8c 8s]
perupoquer: checks 
jpamb: checks 
*** TURN *** [7s 8c 8s] [7h]
perupoquer: checks 
jpamb: checks 
*** RIVER *** [7s 8c 8s 7h] [Qs]
perupoquer: checks 
jpamb: checks 
*** SHOW DOWN ***
perupoquer: shows [3h 9h] (two pair, Eights and Sevens)
jpamb: shows [9s Kd] (two pair, Eights and Sevens - King kicker)
jpamb collected $0.04 from pot
*** SUMMARY ***
Total pot $0.04 | Rake $0 
Board [7s 8c 8s 7h Qs]
Seat 1: lawlex_2 (button) folded before Flop (didn't bet)
Seat 2: perupoquer (small blind) showed [3h 9h] and lost with two pair, Eights and Sevens
Seat 3: jpamb (big blind) showed [9s Kd] and won ($0.04) with two pair, Eights and Sevens
Seat 4: _Anagor_AA folded before Flop (didn't bet)
Seat 5: chiefbogo folded before Flop (didn't bet)
Seat 6: nigel161 folded before Flop (didn't bet)



PokerStars Hand #213865575146:  Hold'em No Limit ($0.01/$0.02 USD) - 2020/05/14 22:22:55 MSK [2020/05/14 15:22:55 ET]
Table 'Euforbo IV' 6-max Seat #2 is the button
Seat 1: lawlex_2 ($0.64 in chips) 
Seat 2: perupoquer ($1.15 in chips) 
Seat 3: jpamb ($2.05 in chips) 
Seat 4: _Anagor_AA ($2.41 in chips) 
Seat 5: chiefbogo ($2 in chips) 
Seat 6: nigel161 ($3.76 in chips) 
jpamb: posts small blind $0.01
_Anagor_AA: posts big blind $0.02
*** HOLE CARDS ***
Dealt to lawlex_2 [5d 3s]
chiefbogo: folds 
nigel161: calls $0.02
lawlex_2: folds 
perupoquer: raises $0.07 to $0.09
jpamb: folds 
_Anagor_AA: folds 
nigel161: calls $0.07
*** FLOP *** [Kh 2s Ah]
nigel161: checks 
perupoquer: bets $0.06
nigel161: calls $0.06
*** TURN *** [Kh 2s Ah] [2h]
nigel161: bets $0.10
perupoquer: calls $0.10
*** RIVER *** [Kh 2s Ah 2h] [5h]
nigel161: bets $0.26
perupoquer: folds 
Uncalled bet ($0.26) returned to nigel161
nigel161 collected $0.51 from pot
nigel161: doesn't show hand 
*** SUMMARY ***
Total pot $0.53 | Rake $0.02 
Board [Kh 2s Ah 2h 5h]
Seat 1: lawlex_2 folded before Flop (didn't bet)
Seat 2: perupoquer (button) folded on the River
Seat 3: jpamb (small blind) folded before Flop
Seat 4: _Anagor_AA (big blind) folded before Flop
Seat 5: chiefbogo folded before Flop (didn't bet)
Seat 6: nigel161 collected ($0.51)



PokerStars Hand #213865629038:  Hold'em No Limit ($0.01/$0.02 USD) - 2020/05/14 22:23:45 MSK [2020/05/14 15:23:45 ET]
Table 'Euforbo IV' 6-max Seat #3 is the button
Seat 1: lawlex_2 ($0.64 in chips) 
Seat 2: perupoquer ($0.90 in chips) 
Seat 3: jpamb ($2.04 in chips) 
Seat 4: _Anagor_AA ($2.39 in chips) 
Seat 5: chiefbogo ($2 in chips) 
Seat 6: nigel161 ($4.02 in chips) 
_Anagor_AA: posts small blind $0.01
chiefbogo: posts big blind $0.02
*** HOLE CARDS ***
Dealt to lawlex_2 [Kh 9c]
nigel161: folds 
lawlex_2: raises $0.03 to $0.05
perupoquer: calls $0.05
jpamb: folds 
_Anagor_AA: folds 
chiefbogo: folds 
*** FLOP *** [5d Ah 7d]
lawlex_2: checks 
perupoquer: checks 
*** TURN *** [5d Ah 7d] [2h]
lawlex_2: checks 
perupoquer: checks 
*** RIVER *** [5d Ah 7d 2h] [5c]
lawlex_2: checks 
perupoquer: checks 
*** SHOW DOWN ***
lawlex_2: shows [Kh 9c] (a pair of Fives)
perupoquer: shows [Jc Kc] (a pair of Fives - Ace+King+Jack kicker)
perupoquer collected $0.13 from pot
*** SUMMARY ***
Total pot $0.13 | Rake $0 
Board [5d Ah 7d 2h 5c]
Seat 1: lawlex_2 showed [Kh 9c] and lost with a pair of Fives
Seat 2: perupoquer showed [Jc Kc] and won ($0.13) with a pair of Fives
Seat 3: jpamb (button) folded before Flop (didn't bet)
Seat 4: _Anagor_AA (small blind) folded before Flop
Seat 5: chiefbogo (big blind) folded before Flop
Seat 6: nigel161 folded before Flop (didn't bet)



PokerStars Hand #213865690831:  Hold'em No Limit ($0.01/$0.02 USD) - 2020/05/14 22:24:42 MSK [2020/05/14 15:24:42 ET]
Table 'Euforbo IV' 6-max Seat #4 is the button
Seat 1: lawlex_2 ($0.59 in chips) 
Seat 2: perupoquer ($0.98 in chips) 
Seat 3: jpamb ($2.04 in chips) 
Seat 4: _Anagor_AA ($2.38 in chips) 
Seat 5: chiefbogo ($2 in chips) 
Seat 6: nigel161 ($4.02 in chips) 
chiefbogo: posts small blind $0.01
nigel161: posts big blind $0.02
*** HOLE CARDS ***
Dealt to lawlex_2 [Jc 8c]
lawlex_2: folds 
perupoquer: folds 
jpamb: folds 
_Anagor_AA: folds 
chiefbogo: folds 
Uncalled bet ($0.01) returned to nigel161
nigel161 collected $0.02 from pot
nigel161: doesn't show hand 
*** SUMMARY ***
Total pot $0.02 | Rake $0 
Seat 1: lawlex_2 folded before Flop (didn't bet)
Seat 2: perupoquer folded before Flop (didn't bet)
Seat 3: jpamb folded before Flop (didn't bet)
Seat 4: _Anagor_AA (button) folded before Flop (didn't bet)
Seat 5: chiefbogo (small blind) folded before Flop
Seat 6: nigel161 (big blind) collected ($0.02)



PokerStars Hand #213865701284:  Hold'em No Limit ($0.01/$0.02 USD) - 2020/05/14 22:24:51 MSK [2020/05/14 15:24:51 ET]
Table 'Euforbo IV' 6-max Seat #5 is the button
Seat 1: lawlex_2 ($0.59 in chips) 
Seat 2: perupoquer ($0.98 in chips) 
Seat 3: jpamb ($2.04 in chips) 
Seat 4: _Anagor_AA ($2.38 in chips) 
Seat 5: chiefbogo ($2 in chips) 
Seat 6: nigel161 ($4.03 in chips) 
nigel161: posts small blind $0.01
lawlex_2: posts big blind $0.02
*** HOLE CARDS ***
Dealt to lawlex_2 [9d Ks]
perupoquer: raises $0.02 to $0.04
jpamb: folds 
_Anagor_AA: folds 
chiefbogo: folds 
nigel161: calls $0.03
lawlex_2: folds 
*** FLOP *** [Jh 7c 8h]
nigel161: bets $0.02
perupoquer: calls $0.02
*** TURN *** [Jh 7c 8h] [2s]
nigel161: bets $0.02
perupoquer: calls $0.02
*** RIVER *** [Jh 7c 8h 2s] [Jc]
nigel161: bets $0.02
perupoquer: raises $0.07 to $0.09
nigel161: calls $0.07
*** SHOW DOWN ***
perupoquer: shows [Td Kd] (a pair of Jacks)
nigel161: shows [8s 3s] (two pair, Jacks and Eights)
nigel161 collected $0.35 from pot
*** SUMMARY ***
Total pot $0.36 | Rake $0.01 
Board [Jh 7c 8h 2s Jc]
Seat 1: lawlex_2 (big blind) folded before Flop
Seat 2: perupoquer showed [Td Kd] and lost with a pair of Jacks
Seat 3: jpamb folded before Flop (didn't bet)
Seat 4: _Anagor_AA folded before Flop (didn't bet)
Seat 5: chiefbogo (button) folded before Flop (didn't bet)
Seat 6: nigel161 (small blind) showed [8s 3s] and won ($0.35) with two pair, Jacks and Eights



PokerStars Hand #213865737467:  Hold'em No Limit ($0.01/$0.02 USD) - 2020/05/14 22:25:25 MSK [2020/05/14 15:25:25 ET]
Table 'Euforbo IV' 6-max Seat #6 is the button
Seat 1: lawlex_2 ($0.57 in chips) 
Seat 2: perupoquer ($0.81 in chips) 
Seat 3: jpamb ($2.04 in chips) 
Seat 4: _Anagor_AA ($2.38 in chips) 
Seat 5: chiefbogo ($2 in chips) 
Seat 6: nigel161 ($4.21 in chips) 
lawlex_2: posts small blind $0.01
perupoquer: posts big blind $0.02
*** HOLE CARDS ***
Dealt to lawlex_2 [Tc 9d]
jpamb: folds 
_Anagor_AA: folds 
chiefbogo: folds 
nigel161: calls $0.02
lawlex_2: folds 
perupoquer: checks 
*** FLOP *** [Qd 2d 2s]
perupoquer: checks 
nigel161: checks 
*** TURN *** [Qd 2d 2s] [6c]
perupoquer: bets $0.10
nigel161: folds 
Uncalled bet ($0.10) returned to perupoquer
perupoquer collected $0.05 from pot
perupoquer: doesn't show hand 
*** SUMMARY ***
Total pot $0.05 | Rake $0 
Board [Qd 2d 2s 6c]
Seat 1: lawlex_2 (small blind) folded before Flop
Seat 2: perupoquer (big blind) collected ($0.05)
Seat 3: jpamb folded before Flop (didn't bet)
Seat 4: _Anagor_AA folded before Flop (didn't bet)
Seat 5: chiefbogo folded before Flop (didn't bet)
Seat 6: nigel161 (button) folded on the Turn



PokerStars Hand #213865762847:  Hold'em No Limit ($0.01/$0.02 USD) - 2020/05/14 22:25:48 MSK [2020/05/14 15:25:48 ET]
Table 'Euforbo IV' 6-max Seat #1 is the button
Seat 1: lawlex_2 ($0.56 in chips) 
Seat 2: perupoquer ($0.84 in chips) 
Seat 3: jpamb ($2.04 in chips) 
Seat 4: _Anagor_AA ($2.38 in chips) 
Seat 5: chiefbogo ($2 in chips) 
Seat 6: nigel161 ($4.19 in chips) 
perupoquer: posts small blind $0.01
jpamb: posts big blind $0.02
*** HOLE CARDS ***
Dealt to lawlex_2 [6s 9h]
_Anagor_AA: folds 
chiefbogo: folds 
nigel161: calls $0.02
lawlex_2: folds 
perupoquer: calls $0.01
jpamb: checks 
*** FLOP *** [8h 2h Jd]
perupoquer: checks 
jpamb: checks 
nigel161: checks 
*** TURN *** [8h 2h Jd] [7c]
perupoquer: checks 
jpamb: bets $0.04
nigel161: calls $0.04
perupoquer: calls $0.04
*** RIVER *** [8h 2h Jd 7c] [Jc]
perupoquer: checks 
jpamb: checks 
nigel161: checks 
*** SHOW DOWN ***
perupoquer: shows [Qc 8c] (two pair, Jacks and Eights)
jpamb: mucks hand 
nigel161: mucks hand 
perupoquer collected $0.17 from pot
*** SUMMARY ***
Total pot $0.18 | Rake $0.01 
Board [8h 2h Jd 7c Jc]
Seat 1: lawlex_2 (button) folded before Flop (didn't bet)
Seat 2: perupoquer (small blind) showed [Qc 8c] and won ($0.17) with two pair, Jacks and Eights
Seat 3: jpamb (big blind) mucked [Tc 8s]
Seat 4: _Anagor_AA folded before Flop (didn't bet)
Seat 5: chiefbogo folded before Flop (didn't bet)
Seat 6: nigel161 mucked [Kh As]



PokerStars Hand #213865815638:  Hold'em No Limit ($0.01/$0.02 USD) - 2020/05/14 22:26:36 MSK [2020/05/14 15:26:36 ET]
Table 'Euforbo IV' 6-max Seat #2 is the button
Seat 1: lawlex_2 ($0.56 in chips) 
Seat 2: perupoquer ($0.95 in chips) 
Seat 3: jpamb ($2 in chips) 
Seat 4: _Anagor_AA ($2.38 in chips) 
Seat 5: chiefbogo ($2 in chips) 
Seat 6: nigel161 ($4.13 in chips) 
jpamb: posts small blind $0.01
_Anagor_AA: posts big blind $0.02
*** HOLE CARDS ***
Dealt to lawlex_2 [Jd Qh]
chiefbogo: folds 
nigel161: calls $0.02
lawlex_2: raises $0.03 to $0.05
perupoquer: calls $0.05
jpamb: folds 
_Anagor_AA: folds 
nigel161: calls $0.03
*** FLOP *** [6d 3h Kd]
nigel161: checks 
lawlex_2: bets $0.11
perupoquer: folds 
nigel161: folds 
Uncalled bet ($0.11) returned to lawlex_2
lawlex_2 collected $0.17 from pot
lawlex_2: doesn't show hand 
*** SUMMARY ***
Total pot $0.18 | Rake $0.01 
Board [6d 3h Kd]
Seat 1: lawlex_2 collected ($0.17)
Seat 2: perupoquer (button) folded on the Flop
Seat 3: jpamb (small blind) folded before Flop
Seat 4: _Anagor_AA (big blind) folded before Flop
Seat 5: chiefbogo folded before Flop (didn't bet)
Seat 6: nigel161 folded on the Flop



PokerStars Hand #213865854211:  Hold'em No Limit ($0.01/$0.02 USD) - 2020/05/14 22:27:12 MSK [2020/05/14 15:27:12 ET]
Table 'Euforbo IV' 6-max Seat #3 is the button
Seat 1: lawlex_2 ($0.68 in chips) 
Seat 2: perupoquer ($0.90 in chips) 
Seat 3: jpamb ($2 in chips) 
Seat 4: _Anagor_AA ($2.36 in chips) 
Seat 5: chiefbogo ($2 in chips) 
Seat 6: nigel161 ($4.08 in chips) 
_Anagor_AA: posts small blind $0.01
chiefbogo: posts big blind $0.02
*** HOLE CARDS ***
Dealt to lawlex_2 [5c Ah]
nigel161: calls $0.02
lawlex_2: raises $0.03 to $0.05
perupoquer: folds 
jpamb: calls $0.05
_Anagor_AA: folds 
chiefbogo: folds 
nigel161: calls $0.03
*** FLOP *** [3c 5h Kd]
nigel161: checks 
lawlex_2: bets $0.11
jpamb: folds 
nigel161: folds 
Uncalled bet ($0.11) returned to lawlex_2
lawlex_2 collected $0.17 from pot
lawlex_2: doesn't show hand 
*** SUMMARY ***
Total pot $0.18 | Rake $0.01 
Board [3c 5h Kd]
Seat 1: lawlex_2 collected ($0.17)
Seat 2: perupoquer folded before Flop (didn't bet)
Seat 3: jpamb (button) folded on the Flop
Seat 4: _Anagor_AA (small blind) folded before Flop
Seat 5: chiefbogo (big blind) folded before Flop
Seat 6: nigel161 folded on the Flop



PokerStars Hand #213865888732:  Hold'em No Limit ($0.01/$0.02 USD) - 2020/05/14 22:27:44 MSK [2020/05/14 15:27:44 ET]
Table 'Euforbo IV' 6-max Seat #4 is the button
Seat 1: lawlex_2 ($0.80 in chips) 
Seat 2: perupoquer ($0.90 in chips) 
Seat 3: jpamb ($2 in chips) 
Seat 4: _Anagor_AA ($2.35 in chips) 
Seat 5: chiefbogo ($2 in chips) 
Seat 6: nigel161 ($4.03 in chips) 
chiefbogo: posts small blind $0.01
nigel161: posts big blind $0.02
*** HOLE CARDS ***
Dealt to lawlex_2 [6h 7c]
lawlex_2: folds 
perupoquer has timed out
perupoquer: folds 
jpamb: folds 
_Anagor_AA: folds 
chiefbogo: raises $0.04 to $0.06
nigel161: calls $0.04
*** FLOP *** [Ts 7s 9s]
chiefbogo: checks 
nigel161: bets $0.02
chiefbogo: calls $0.02
*** TURN *** [Ts 7s 9s] [5d]
chiefbogo: checks 
nigel161: bets $0.02
chiefbogo: calls $0.02
*** RIVER *** [Ts 7s 9s 5d] [Jc]
chiefbogo: checks 
nigel161: bets $0.10
chiefbogo: folds 
Uncalled bet ($0.10) returned to nigel161
nigel161 collected $0.19 from pot
nigel161: doesn't show hand 
*** SUMMARY ***
Total pot $0.20 | Rake $0.01 
Board [Ts 7s 9s 5d Jc]
Seat 1: lawlex_2 folded before Flop (didn't bet)
Seat 2: perupoquer folded before Flop (didn't bet)
Seat 3: jpamb folded before Flop (didn't bet)
Seat 4: _Anagor_AA (button) folded before Flop (didn't bet)
Seat 5: chiefbogo (small blind) folded on the River
Seat 6: nigel161 (big blind) collected ($0.19)



PokerStars Hand #213865951775:  Hold'em No Limit ($0.01/$0.02 USD) - 2020/05/14 22:28:42 MSK [2020/05/14 15:28:42 ET]
Table 'Euforbo IV' 6-max Seat #5 is the button
Seat 1: lawlex_2 ($0.80 in chips) 
Seat 3: jpamb ($2 in chips) 
Seat 4: _Anagor_AA ($2.35 in chips) 
Seat 5: chiefbogo ($2 in chips) 
Seat 6: nigel161 ($4.12 in chips) 
nigel161: posts small blind $0.01
lawlex_2: posts big blind $0.02
*** HOLE CARDS ***
Dealt to lawlex_2 [Ac Ks]
jpamb: folds 
_Anagor_AA: raises $0.04 to $0.06
chiefbogo: folds 
nigel161: calls $0.05
lawlex_2: raises $0.74 to $0.80 and is all-in
_Anagor_AA: folds 
nigel161: folds 
Uncalled bet ($0.74) returned to lawlex_2
lawlex_2 collected $0.18 from pot
lawlex_2: doesn't show hand 
*** SUMMARY ***
Total pot $0.18 | Rake $0 
Seat 1: lawlex_2 (big blind) collected ($0.18)
Seat 3: jpamb folded before Flop (didn't bet)
Seat 4: _Anagor_AA folded before Flop
Seat 5: chiefbogo (button) folded before Flop (didn't bet)
Seat 6: nigel161 (small blind) folded before Flop



PokerStars Hand #213865974307:  Hold'em No Limit ($0.01/$0.02 USD) - 2020/05/14 22:29:03 MSK [2020/05/14 15:29:03 ET]
Table 'Euforbo IV' 6-max Seat #6 is the button
Seat 1: lawlex_2 ($0.92 in chips) 
Seat 3: jpamb ($2 in chips) 
Seat 4: _Anagor_AA ($2.29 in chips) 
Seat 5: chiefbogo ($2 in chips) 
Seat 6: nigel161 ($4.06 in chips) 
lawlex_2: posts small blind $0.01
jpamb: posts big blind $0.02
*** HOLE CARDS ***
Dealt to lawlex_2 [7s 2d]
_Anagor_AA: folds 
chiefbogo: folds 
nigel161: calls $0.02
lawlex_2: folds 
jpamb: checks 
*** FLOP *** [9c 8d 9d]
jpamb: checks 
nigel161: checks 
*** TURN *** [9c 8d 9d] [Jd]
jpamb: checks 
nigel161: checks 
*** RIVER *** [9c 8d 9d Jd] [8s]
jpamb: checks 
nigel161: checks 
*** SHOW DOWN ***
jpamb: shows [2s 3d] (two pair, Nines and Eights)
nigel161: shows [5s Kc] (two pair, Nines and Eights - King kicker)
nigel161 collected $0.05 from pot
*** SUMMARY ***
Total pot $0.05 | Rake $0 
Board [9c 8d 9d Jd 8s]
Seat 1: lawlex_2 (small blind) folded before Flop
Seat 3: jpamb (big blind) showed [2s 3d] and lost with two pair, Nines and Eights
Seat 4: _Anagor_AA folded before Flop (didn't bet)
Seat 5: chiefbogo folded before Flop (didn't bet)
Seat 6: nigel161 (button) showed [5s Kc] and won ($0.05) with two pair, Nines and Eights



PokerStars Hand #213866003405:  Hold'em No Limit ($0.01/$0.02 USD) - 2020/05/14 22:29:30 MSK [2020/05/14 15:29:30 ET]
Table 'Euforbo IV' 6-max Seat #1 is the button
Seat 1: lawlex_2 ($0.91 in chips) 
Seat 3: jpamb ($2 in chips) 
Seat 4: _Anagor_AA ($2.29 in chips) 
Seat 5: chiefbogo ($2 in chips) 
Seat 6: nigel161 ($4.09 in chips) 
jpamb: posts small blind $0.01
_Anagor_AA: posts big blind $0.02
*** HOLE CARDS ***
Dealt to lawlex_2 [8c Ts]
chiefbogo: folds 
nigel161: calls $0.02
lawlex_2: folds 
jpamb: calls $0.01
_Anagor_AA: checks 
*** FLOP *** [8s 4s Ac]
jpamb: checks 
_Anagor_AA: bets $0.02
nigel161: folds 
jpamb: folds 
Uncalled bet ($0.02) returned to _Anagor_AA
_Anagor_AA collected $0.06 from pot
_Anagor_AA: doesn't show hand 
*** SUMMARY ***
Total pot $0.06 | Rake $0 
Board [8s 4s Ac]
Seat 1: lawlex_2 (button) folded before Flop (didn't bet)
Seat 3: jpamb (small blind) folded on the Flop
Seat 4: _Anagor_AA (big blind) collected ($0.06)
Seat 5: chiefbogo folded before Flop (didn't bet)
Seat 6: nigel161 folded on the Flop



PokerStars Hand #213866036001:  Hold'em No Limit ($0.01/$0.02 USD) - 2020/05/14 22:30:00 MSK [2020/05/14 15:30:00 ET]
Table 'Euforbo IV' 6-max Seat #3 is the button
Seat 1: lawlex_2 ($0.91 in chips) 
Seat 3: jpamb ($2 in chips) 
Seat 4: _Anagor_AA ($2.33 in chips) 
Seat 5: chiefbogo ($2 in chips) 
Seat 6: nigel161 ($4.07 in chips) 
_Anagor_AA: posts small blind $0.01
chiefbogo: posts big blind $0.02
*** HOLE CARDS ***
Dealt to lawlex_2 [4d 2d]
nigel161: calls $0.02
lawlex_2: folds 
jpamb: calls $0.02
_Anagor_AA: calls $0.01
chiefbogo: checks 
*** FLOP *** [Td 6c 2h]
_Anagor_AA: checks 
chiefbogo: checks 
nigel161: bets $0.02
jpamb: folds 
_Anagor_AA: folds 
chiefbogo: folds 
Uncalled bet ($0.02) returned to nigel161
nigel161 collected $0.08 from pot
nigel161: doesn't show hand 
*** SUMMARY ***
Total pot $0.08 | Rake $0 
Board [Td 6c 2h]
Seat 1: lawlex_2 folded before Flop (didn't bet)
Seat 3: jpamb (button) folded on the Flop
Seat 4: _Anagor_AA (small blind) folded on the Flop
Seat 5: chiefbogo (big blind) folded on the Flop
Seat 6: nigel161 collected ($0.08)



PokerStars Hand #213866080599:  Hold'em No Limit ($0.01/$0.02 USD) - 2020/05/14 22:30:40 MSK [2020/05/14 15:30:40 ET]
Table 'Euforbo IV' 6-max Seat #4 is the button
Seat 1: lawlex_2 ($0.91 in chips) 
Seat 3: jpamb ($2 in chips) 
Seat 4: _Anagor_AA ($2.31 in chips) 
Seat 5: chiefbogo ($2 in chips) 
Seat 6: nigel161 ($4.13 in chips) 
chiefbogo: posts small blind $0.01
nigel161: posts big blind $0.02
*** HOLE CARDS ***
Dealt to lawlex_2 [7s 9h]
lawlex_2: folds 
jpamb: folds 
_Anagor_AA: folds 
chiefbogo: raises $0.04 to $0.06
nigel161: folds 
Uncalled bet ($0.04) returned to chiefbogo
chiefbogo collected $0.04 from pot
*** SUMMARY ***
Total pot $0.04 | Rake $0 
Seat 1: lawlex_2 folded before Flop (didn't bet)
Seat 3: jpamb folded before Flop (didn't bet)
Seat 4: _Anagor_AA (button) folded before Flop (didn't bet)
Seat 5: chiefbogo (small blind) collected ($0.04)
Seat 6: nigel161 (big blind) folded before Flop



PokerStars Hand #213866098637:  Hold'em No Limit ($0.01/$0.02 USD) - 2020/05/14 22:30:56 MSK [2020/05/14 15:30:56 ET]
Table 'Euforbo IV' 6-max Seat #5 is the button
Seat 1: lawlex_2 ($0.91 in chips) 
Seat 3: jpamb ($2 in chips) 
Seat 4: _Anagor_AA ($2.31 in chips) 
Seat 5: chiefbogo ($2.02 in chips) 
Seat 6: nigel161 ($4.11 in chips) 
nigel161: posts small blind $0.01
lawlex_2: posts big blind $0.02
*** HOLE CARDS ***
Dealt to lawlex_2 [9c Kh]
jpamb: folds 
_Anagor_AA: folds 
chiefbogo: calls $0.02
nigel161: calls $0.01
lawlex_2: checks 
*** FLOP *** [Qs Tc 8h]
nigel161: checks 
lawlex_2: bets $0.04
chiefbogo: folds 
nigel161: folds 
Uncalled bet ($0.04) returned to lawlex_2
lawlex_2 collected $0.06 from pot
lawlex_2: doesn't show hand 
*** SUMMARY ***
Total pot $0.06 | Rake $0 
Board [Qs Tc 8h]
Seat 1: lawlex_2 (big blind) collected ($0.06)
Seat 3: jpamb folded before Flop (didn't bet)
Seat 4: _Anagor_AA folded before Flop (didn't bet)
Seat 5: chiefbogo (button) folded on the Flop
Seat 6: nigel161 (small blind) folded on the Flop



PokerStars Hand #213866123286:  Hold'em No Limit ($0.01/$0.02 USD) - 2020/05/14 22:31:17 MSK [2020/05/14 15:31:17 ET]
Table 'Euforbo IV' 6-max Seat #6 is the button
Seat 1: lawlex_2 ($0.95 in chips) 
Seat 3: jpamb ($2 in chips) 
Seat 4: _Anagor_AA ($2.31 in chips) 
Seat 5: chiefbogo ($2 in chips) 
Seat 6: nigel161 ($4.09 in chips) 
lawlex_2: posts small blind $0.01
jpamb: posts big blind $0.02
*** HOLE CARDS ***
Dealt to lawlex_2 [Ad 2s]
_Anagor_AA: folds 
chiefbogo: folds 
nigel161: calls $0.02
lawlex_2: raises $0.03 to $0.05
jpamb: folds 
nigel161: calls $0.03
*** FLOP *** [6c 8d Qd]
lawlex_2: bets $0.08
nigel161: calls $0.08
*** TURN *** [6c 8d Qd] [8c]
lawlex_2: checks 
nigel161: bets $0.14
lawlex_2: folds 
Uncalled bet ($0.14) returned to nigel161
nigel161 collected $0.27 from pot
nigel161: doesn't show hand 
*** SUMMARY ***
Total pot $0.28 | Rake $0.01 
Board [6c 8d Qd 8c]
Seat 1: lawlex_2 (small blind) folded on the Turn
Seat 3: jpamb (big blind) folded before Flop
Seat 4: _Anagor_AA folded before Flop (didn't bet)
Seat 5: chiefbogo folded before Flop (didn't bet)
Seat 6: nigel161 (button) collected ($0.27)



PokerStars Hand #213866162327:  Hold'em No Limit ($0.01/$0.02 USD) - 2020/05/14 22:31:53 MSK [2020/05/14 15:31:53 ET]
Table 'Euforbo IV' 6-max Seat #1 is the button
Seat 1: lawlex_2 ($0.82 in chips) 
Seat 3: jpamb ($2 in chips) 
Seat 4: _Anagor_AA ($2.31 in chips) 
Seat 5: chiefbogo ($2 in chips) 
Seat 6: nigel161 ($4.23 in chips) 
jpamb: posts small blind $0.01
_Anagor_AA: posts big blind $0.02
*** HOLE CARDS ***
Dealt to lawlex_2 [Ah 5h]
chiefbogo: raises $0.04 to $0.06
nigel161: calls $0.06
lawlex_2: folds 
jpamb: folds 
_Anagor_AA: folds 
*** FLOP *** [7h 4h 7d]
chiefbogo: bets $0.10
nigel161: folds 
Uncalled bet ($0.10) returned to chiefbogo
chiefbogo collected $0.14 from pot
*** SUMMARY ***
Total pot $0.15 | Rake $0.01 
Board [7h 4h 7d]
Seat 1: lawlex_2 (button) folded before Flop (didn't bet)
Seat 3: jpamb (small blind) folded before Flop
Seat 4: _Anagor_AA (big blind) folded before Flop
Seat 5: chiefbogo collected ($0.14)
Seat 6: nigel161 folded on the Flop



PokerStars Hand #213866201199:  Hold'em No Limit ($0.01/$0.02 USD) - 2020/05/14 22:32:28 MSK [2020/05/14 15:32:28 ET]
Table 'Euforbo IV' 6-max Seat #3 is the button
Seat 1: lawlex_2 ($0.82 in chips) 
Seat 3: jpamb ($2 in chips) 
Seat 4: _Anagor_AA ($2.29 in chips) 
Seat 5: chiefbogo ($2.08 in chips) 
Seat 6: nigel161 ($4.17 in chips) 
_Anagor_AA: posts small blind $0.01
chiefbogo: posts big blind $0.02
*** HOLE CARDS ***
Dealt to lawlex_2 [2d 9s]
nigel161 has timed out
nigel161: folds 
lawlex_2: folds 
jpamb: folds 
_Anagor_AA: raises $0.04 to $0.06
chiefbogo: folds 
Uncalled bet ($0.04) returned to _Anagor_AA
_Anagor_AA collected $0.04 from pot
_Anagor_AA: doesn't show hand 
*** SUMMARY ***
Total pot $0.04 | Rake $0 
Seat 1: lawlex_2 folded before Flop (didn't bet)
Seat 3: jpamb (button) folded before Flop (didn't bet)
Seat 4: _Anagor_AA (small blind) collected ($0.04)
Seat 5: chiefbogo (big blind) folded before Flop
Seat 6: nigel161 folded before Flop (didn't bet)



PokerStars Hand #213866224105:  Hold'em No Limit ($0.01/$0.02 USD) - 2020/05/14 22:32:46 MSK [2020/05/14 15:32:46 ET]
Table 'Euforbo IV' 6-max Seat #4 is the button
Seat 1: lawlex_2 ($0.82 in chips) 
Seat 3: jpamb ($2 in chips) 
Seat 4: _Anagor_AA ($2.31 in chips) 
Seat 5: chiefbogo ($2.06 in chips) 
chiefbogo: posts small blind $0.01
lawlex_2: posts big blind $0.02
*** HOLE CARDS ***
Dealt to lawlex_2 [5c Ts]
jpamb: folds 
_Anagor_AA: folds 
chiefbogo: folds 
Uncalled bet ($0.01) returned to lawlex_2
lawlex_2 collected $0.02 from pot
lawlex_2: doesn't show hand 
*** SUMMARY ***
Total pot $0.02 | Rake $0 
Seat 1: lawlex_2 (big blind) collected ($0.02)
Seat 3: jpamb folded before Flop (didn't bet)
Seat 4: _Anagor_AA (button) folded before Flop (didn't bet)
Seat 5: chiefbogo (small blind) folded before Flop



PokerStars Hand #213866230983:  Hold'em No Limit ($0.01/$0.02 USD) - 2020/05/14 22:32:52 MSK [2020/05/14 15:32:52 ET]
Table 'Euforbo IV' 6-max Seat #5 is the button
Seat 1: lawlex_2 ($0.83 in chips) 
Seat 3: jpamb ($2 in chips) 
Seat 4: _Anagor_AA ($2.31 in chips) 
Seat 5: chiefbogo ($2.05 in chips) 
lawlex_2: posts small blind $0.01
jpamb: posts big blind $0.02
*** HOLE CARDS ***
Dealt to lawlex_2 [8d Ks]
_Anagor_AA: folds 
chiefbogo: folds 
lawlex_2: folds 
Uncalled bet ($0.01) returned to jpamb
jpamb collected $0.02 from pot
jpamb: doesn't show hand 
*** SUMMARY ***
Total pot $0.02 | Rake $0 
Seat 1: lawlex_2 (small blind) folded before Flop
Seat 3: jpamb (big blind) collected ($0.02)
Seat 4: _Anagor_AA folded before Flop (didn't bet)
Seat 5: chiefbogo (button) folded before Flop (didn't bet)



PokerStars Hand #213866240020:  Hold'em No Limit ($0.01/$0.02 USD) - 2020/05/14 22:33:00 MSK [2020/05/14 15:33:00 ET]
Table 'Euforbo IV' 6-max Seat #1 is the button
Seat 1: lawlex_2 ($0.82 in chips) 
Seat 3: jpamb ($2.01 in chips) 
Seat 4: _Anagor_AA ($2.31 in chips) 
Seat 5: chiefbogo ($2.05 in chips) 
Seat 6: nigel161 ($4.17 in chips) 
jpamb: posts small blind $0.01
_Anagor_AA: posts big blind $0.02
nigel161: posts small & big blinds $0.03
*** HOLE CARDS ***
Dealt to lawlex_2 [Jd 9c]
chiefbogo: folds 
nigel161: checks 
lawlex_2: raises $0.03 to $0.05
jpamb: calls $0.04
_Anagor_AA: folds 
nigel161: calls $0.03
*** FLOP *** [4h Kh 5c]
jpamb: checks 
nigel161: checks 
lawlex_2: bets $0.11
jpamb: folds 
nigel161: calls $0.11
*** TURN *** [4h Kh 5c] [Ks]
nigel161: checks 
lawlex_2: checks 
*** RIVER *** [4h Kh 5c Ks] [As]
nigel161: bets $0.12
lawlex_2: folds 
Uncalled bet ($0.12) returned to nigel161
nigel161 collected $0.39 from pot
nigel161: doesn't show hand 
*** SUMMARY ***
Total pot $0.40 | Rake $0.01 
Board [4h Kh 5c Ks As]
Seat 1: lawlex_2 (button) folded on the River
Seat 3: jpamb (small blind) folded on the Flop
Seat 4: _Anagor_AA (big blind) folded before Flop
Seat 5: chiefbogo folded before Flop (didn't bet)
Seat 6: nigel161 collected ($0.39)



PokerStars Hand #213866319236:  Hold'em No Limit ($0.01/$0.02 USD) - 2020/05/14 22:34:11 MSK [2020/05/14 15:34:11 ET]
Table 'Euforbo IV' 6-max Seat #3 is the button
Seat 1: lawlex_2 ($0.66 in chips) 
Seat 3: jpamb ($2 in chips) 
Seat 4: _Anagor_AA ($2.29 in chips) 
Seat 5: chiefbogo ($2.05 in chips) 
Seat 6: nigel161 ($4.39 in chips) 
_Anagor_AA: posts small blind $0.01
chiefbogo: posts big blind $0.02
*** HOLE CARDS ***
Dealt to lawlex_2 [Kh Kc]
nigel161: calls $0.02
lawlex_2: raises $0.03 to $0.05
jpamb: folds 
_Anagor_AA: calls $0.04
chiefbogo: calls $0.03
nigel161: calls $0.03
*** FLOP *** [Ac 8h Td]
_Anagor_AA: checks 
chiefbogo: checks 
nigel161: bets $0.02
lawlex_2: raises $0.15 to $0.17
_Anagor_AA: folds 
chiefbogo: calls $0.17
nigel161: calls $0.15
*** TURN *** [Ac 8h Td] [Tc]
chiefbogo: checks 
nigel161: checks 
lawlex_2: bets $0.44 and is all-in
chiefbogo: folds 
nigel161: calls $0.44
*** RIVER *** [Ac 8h Td Tc] [5d]
*** SHOW DOWN ***
nigel161: shows [Ah 7s] (two pair, Aces and Tens)
lawlex_2: shows [Kh Kc] (two pair, Kings and Tens)
nigel161 collected $1.53 from pot
*** SUMMARY ***
Total pot $1.59 | Rake $0.06 
Board [Ac 8h Td Tc 5d]
Seat 1: lawlex_2 showed [Kh Kc] and lost with two pair, Kings and Tens
Seat 3: jpamb (button) folded before Flop (didn't bet)
Seat 4: _Anagor_AA (small blind) folded on the Flop
Seat 5: chiefbogo (big blind) folded on the Turn
Seat 6: nigel161 showed [Ah 7s] and won ($1.53) with two pair, Aces and Tens



PokerStars Hand #213866489986:  Hold'em No Limit ($0.01/$0.02 USD) - 2020/05/14 22:36:44 MSK [2020/05/14 15:36:44 ET]
Table 'Euforbo IV' 6-max Seat #3 is the button
Seat 1: lawlex_2 ($2 in chips) 
Seat 2: perupoquer ($0.90 in chips) 
Seat 3: jpamb ($2.01 in chips) 
Seat 4: _Anagor_AA ($2.12 in chips) 
Seat 5: chiefbogo ($2 in chips) 
Seat 6: nigel161 ($5.49 in chips) 
_Anagor_AA: posts small blind $0.01
chiefbogo: posts big blind $0.02
lawlex_2: posts small & big blinds $0.03
perupoquer: posts small & big blinds $0.03
*** HOLE CARDS ***
Dealt to lawlex_2 [5d 7c]
nigel161: calls $0.02
lawlex_2: checks 
perupoquer: checks 
jpamb: folds 
_Anagor_AA: folds 
chiefbogo: checks 
*** FLOP *** [Kc 6d Jc]
chiefbogo: checks 
nigel161: bets $0.02
lawlex_2: folds 
perupoquer: calls $0.02
chiefbogo: calls $0.02
*** TURN *** [Kc 6d Jc] [7h]
chiefbogo: checks 
nigel161: bets $0.02
perupoquer: calls $0.02
chiefbogo: folds 
*** RIVER *** [Kc 6d Jc 7h] [Ts]
nigel161: bets $0.02
perupoquer: calls $0.02
*** SHOW DOWN ***
nigel161: shows [Kd 2d] (a pair of Kings)
perupoquer: mucks hand 
nigel161 collected $0.24 from pot
*** SUMMARY ***
Total pot $0.25 | Rake $0.01 
Board [Kc 6d Jc 7h Ts]
Seat 1: lawlex_2 folded on the Flop (didn't bet)
Seat 2: perupoquer mucked [6s Qd]
Seat 3: jpamb (button) folded before Flop (didn't bet)
Seat 4: _Anagor_AA (small blind) folded before Flop
Seat 5: chiefbogo (big blind) folded on the Turn
Seat 6: nigel161 showed [Kd 2d] and won ($0.24) with a pair of Kings



PokerStars Hand #213866552719:  Hold'em No Limit ($0.01/$0.02 USD) - 2020/05/14 22:37:38 MSK [2020/05/14 15:37:38 ET]
Table 'Euforbo IV' 6-max Seat #4 is the button
Seat 1: lawlex_2 ($1.97 in chips) 
Seat 2: perupoquer ($0.81 in chips) 
Seat 3: jpamb ($2.01 in chips) 
Seat 4: _Anagor_AA ($2.11 in chips) 
Seat 5: chiefbogo ($2 in chips) 
Seat 6: nigel161 ($5.65 in chips) 
chiefbogo: posts small blind $0.01
nigel161: posts big blind $0.02
*** HOLE CARDS ***
Dealt to lawlex_2 [2s 5s]
lawlex_2: folds 
perupoquer: folds 
jpamb: raises $0.04 to $0.06
_Anagor_AA: folds 
chiefbogo: folds 
nigel161: calls $0.04
*** FLOP *** [2h 8h 4c]
nigel161: checks 
jpamb: bets $0.08
nigel161: calls $0.08
*** TURN *** [2h 8h 4c] [Ad]
nigel161: bets $0.10
jpamb: calls $0.10
*** RIVER *** [2h 8h 4c Ad] [Kh]
nigel161: bets $0.04
jpamb: folds 
Uncalled bet ($0.04) returned to nigel161
nigel161 collected $0.47 from pot
nigel161: doesn't show hand 
*** SUMMARY ***
Total pot $0.49 | Rake $0.02 
Board [2h 8h 4c Ad Kh]
Seat 1: lawlex_2 folded before Flop (didn't bet)
Seat 2: perupoquer folded before Flop (didn't bet)
Seat 3: jpamb folded on the River
Seat 4: _Anagor_AA (button) folded before Flop (didn't bet)
Seat 5: chiefbogo (small blind) folded before Flop
Seat 6: nigel161 (big blind) collected ($0.47)



PokerStars Hand #213866620020:  Hold'em No Limit ($0.01/$0.02 USD) - 2020/05/14 22:38:37 MSK [2020/05/14 15:38:37 ET]
Table 'Euforbo IV' 6-max Seat #5 is the button
Seat 1: lawlex_2 ($1.97 in chips) 
Seat 2: perupoquer ($0.81 in chips) 
Seat 3: jpamb ($2 in chips) 
Seat 4: _Anagor_AA ($2.11 in chips) 
Seat 5: chiefbogo ($2 in chips) 
Seat 6: nigel161 ($5.88 in chips) 
nigel161: posts small blind $0.01
lawlex_2: posts big blind $0.02
*** HOLE CARDS ***
Dealt to lawlex_2 [As Jd]
perupoquer: folds 
jpamb: raises $0.04 to $0.06
_Anagor_AA: folds 
chiefbogo: folds 
nigel161: calls $0.05
lawlex_2: calls $0.04
*** FLOP *** [2d 7h Tc]
nigel161: checks 
lawlex_2: bets $0.11
jpamb: folds 
nigel161: folds 
Uncalled bet ($0.11) returned to lawlex_2
lawlex_2 collected $0.17 from pot
lawlex_2: doesn't show hand 
*** SUMMARY ***
Total pot $0.18 | Rake $0.01 
Board [2d 7h Tc]
Seat 1: lawlex_2 (big blind) collected ($0.17)
Seat 2: perupoquer folded before Flop (didn't bet)
Seat 3: jpamb folded on the Flop
Seat 4: _Anagor_AA folded before Flop (didn't bet)
Seat 5: chiefbogo (button) folded before Flop (didn't bet)
Seat 6: nigel161 (small blind) folded on the Flop



PokerStars Hand #213866674579:  Hold'em No Limit ($0.01/$0.02 USD) - 2020/05/14 22:39:21 MSK [2020/05/14 15:39:21 ET]
Table 'Euforbo IV' 6-max Seat #6 is the button
Seat 1: lawlex_2 ($2.08 in chips) 
Seat 2: perupoquer ($0.81 in chips) 
Seat 3: jpamb ($2 in chips) 
Seat 4: _Anagor_AA ($2.11 in chips) 
Seat 5: chiefbogo ($2 in chips) 
Seat 6: nigel161 ($5.82 in chips) 
lawlex_2: posts small blind $0.01
perupoquer: posts big blind $0.02
*** HOLE CARDS ***
Dealt to lawlex_2 [2s 9h]
jpamb: folds 
_Anagor_AA: folds 
chiefbogo: folds 
nigel161 has timed out
nigel161: folds 
lawlex_2: folds 
Uncalled bet ($0.01) returned to perupoquer
perupoquer collected $0.02 from pot
perupoquer: doesn't show hand 
*** SUMMARY ***
Total pot $0.02 | Rake $0 
Seat 1: lawlex_2 (small blind) folded before Flop
Seat 2: perupoquer (big blind) collected ($0.02)
Seat 3: jpamb folded before Flop (didn't bet)
Seat 4: _Anagor_AA folded before Flop (didn't bet)
Seat 5: chiefbogo folded before Flop (didn't bet)
Seat 6: nigel161 (button) folded before Flop (didn't bet)



PokerStars Hand #213866695202:  Hold'em No Limit ($0.01/$0.02 USD) - 2020/05/14 22:39:40 MSK [2020/05/14 15:39:40 ET]
Table 'Euforbo IV' 6-max Seat #1 is the button
Seat 1: lawlex_2 ($2.07 in chips) 
Seat 2: perupoquer ($0.82 in chips) 
Seat 3: jpamb ($2 in chips) 
Seat 4: _Anagor_AA ($2.11 in chips) 
Seat 5: chiefbogo ($2 in chips) 
Seat 6: nigel161 ($5.82 in chips) 
perupoquer: posts small blind $0.01
jpamb: posts big blind $0.02
*** HOLE CARDS ***
Dealt to lawlex_2 [Ts 2h]
_Anagor_AA: raises $0.04 to $0.06
chiefbogo: folds 
nigel161: folds 
lawlex_2: folds 
perupoquer: folds 
jpamb: folds 
Uncalled bet ($0.04) returned to _Anagor_AA
_Anagor_AA collected $0.05 from pot
_Anagor_AA: doesn't show hand 
*** SUMMARY ***
Total pot $0.05 | Rake $0 
Seat 1: lawlex_2 (button) folded before Flop (didn't bet)
Seat 2: perupoquer (small blind) folded before Flop
Seat 3: jpamb (big blind) folded before Flop
Seat 4: _Anagor_AA collected ($0.05)
Seat 5: chiefbogo folded before Flop (didn't bet)
Seat 6: nigel161 folded before Flop (didn't bet)



PokerStars Hand #213866718650:  Hold'em No Limit ($0.01/$0.02 USD) - 2020/05/14 22:40:01 MSK [2020/05/14 15:40:01 ET]
Table 'Euforbo IV' 6-max Seat #2 is the button
Seat 1: lawlex_2 ($2.07 in chips) 
Seat 2: perupoquer ($0.81 in chips) 
Seat 3: jpamb ($2 in chips) 
Seat 4: _Anagor_AA ($2.14 in chips) 
Seat 5: chiefbogo ($2 in chips) 
Seat 6: nigel161 ($5.82 in chips) 
jpamb: posts small blind $0.01
_Anagor_AA: posts big blind $0.02
*** HOLE CARDS ***
Dealt to lawlex_2 [3c 2h]
chiefbogo: folds 
nigel161: calls $0.02
lawlex_2: folds 
perupoquer: folds 
jpamb: folds 
_Anagor_AA: checks 
*** FLOP *** [Tc 6h 2s]
_Anagor_AA: checks 
nigel161: bets $0.02
_Anagor_AA: calls $0.02
*** TURN *** [Tc 6h 2s] [8d]
_Anagor_AA: checks 
nigel161: bets $0.02
_Anagor_AA: calls $0.02
*** RIVER *** [Tc 6h 2s 8d] [3h]
_Anagor_AA: checks 
nigel161: bets $0.02
_Anagor_AA: calls $0.02
*** SHOW DOWN ***
nigel161: shows [8h 9h] (a pair of Eights)
_Anagor_AA: mucks hand 
nigel161 collected $0.16 from pot
*** SUMMARY ***
Total pot $0.17 | Rake $0.01 
Board [Tc 6h 2s 8d 3h]
Seat 1: lawlex_2 folded before Flop (didn't bet)
Seat 2: perupoquer (button) folded before Flop (didn't bet)
Seat 3: jpamb (small blind) folded before Flop
Seat 4: _Anagor_AA (big blind) mucked [Kh Js]
Seat 5: chiefbogo folded before Flop (didn't bet)
Seat 6: nigel161 showed [8h 9h] and won ($0.16) with a pair of Eights



PokerStars Hand #213866786223:  Hold'em No Limit ($0.01/$0.02 USD) - 2020/05/14 22:41:01 MSK [2020/05/14 15:41:01 ET]
Table 'Euforbo IV' 6-max Seat #3 is the button
Seat 1: lawlex_2 ($2.07 in chips) 
Seat 2: perupoquer ($0.81 in chips) 
Seat 3: jpamb ($2 in chips) 
Seat 4: _Anagor_AA ($2.06 in chips) 
Seat 6: nigel161 ($5.90 in chips) 
_Anagor_AA: posts small blind $0.01
chiefbogo: is sitting out 
nigel161: posts big blind $0.02
*** HOLE CARDS ***
Dealt to lawlex_2 [Ad Tc]
lawlex_2: raises $0.03 to $0.05
chiefbogo leaves the table
perupoquer: folds 
jpamb: raises $0.13 to $0.18
_Anagor_AA: folds 
nigel161: folds 
lawlex_2: folds 
Uncalled bet ($0.13) returned to jpamb
jpamb collected $0.13 from pot
jpamb: doesn't show hand 
*** SUMMARY ***
Total pot $0.13 | Rake $0 
Seat 1: lawlex_2 folded before Flop
Seat 2: perupoquer folded before Flop (didn't bet)
Seat 3: jpamb (button) collected ($0.13)
Seat 4: _Anagor_AA (small blind) folded before Flop
Seat 6: nigel161 (big blind) folded before Flop



PokerStars Hand #213866803937:  Hold'em No Limit ($0.01/$0.02 USD) - 2020/05/14 22:41:17 MSK [2020/05/14 15:41:17 ET]
Table 'Euforbo IV' 6-max Seat #4 is the button
Seat 1: lawlex_2 ($2.02 in chips) 
Seat 2: perupoquer ($0.81 in chips) 
Seat 3: jpamb ($2.08 in chips) 
Seat 4: _Anagor_AA ($2.05 in chips) 
Seat 6: nigel161 ($5.88 in chips) 
nigel161: posts small blind $0.01
lawlex_2: posts big blind $0.02
*** HOLE CARDS ***
Dealt to lawlex_2 [Qs 9d]
perupoquer: raises $0.02 to $0.04
jpamb: folds 
_Anagor_AA: folds 
nigel161: calls $0.03
lawlex_2: folds 
*** FLOP *** [Js 5s 9h]
nigel161: bets $0.02
perupoquer: calls $0.02
*** TURN *** [Js 5s 9h] [Tc]
nigel161: bets $0.02
perupoquer: raises $0.10 to $0.12
nigel161: calls $0.10
*** RIVER *** [Js 5s 9h Tc] [Ts]
nigel161: checks 
perupoquer: checks 
*** SHOW DOWN ***
nigel161: shows [7h Ks] (a pair of Tens)
perupoquer: shows [Ad 7d] (a pair of Tens - Ace kicker)
perupoquer collected $0.37 from pot
*** SUMMARY ***
Total pot $0.38 | Rake $0.01 
Board [Js 5s 9h Tc Ts]
Seat 1: lawlex_2 (big blind) folded before Flop
Seat 2: perupoquer showed [Ad 7d] and won ($0.37) with a pair of Tens
Seat 3: jpamb folded before Flop (didn't bet)
Seat 4: _Anagor_AA (button) folded before Flop (didn't bet)
Seat 6: nigel161 (small blind) showed [7h Ks] and lost with a pair of Tens



PokerStars Hand #213866853146:  Hold'em No Limit ($0.01/$0.02 USD) - 2020/05/14 22:42:00 MSK [2020/05/14 15:42:00 ET]
Table 'Euforbo IV' 6-max Seat #6 is the button
Seat 1: lawlex_2 ($2 in chips) 
Seat 2: perupoquer ($1 in chips) 
Seat 3: jpamb ($2.08 in chips) 
Seat 4: _Anagor_AA ($2.05 in chips) 
Seat 6: nigel161 ($5.70 in chips) 
lawlex_2: posts small blind $0.01
perupoquer: posts big blind $0.02
*** HOLE CARDS ***
Dealt to lawlex_2 [7d Td]
jpamb: folds 
_Anagor_AA: folds 
nigel161: folds 
lawlex_2: folds 
Uncalled bet ($0.01) returned to perupoquer
perupoquer collected $0.02 from pot
perupoquer: doesn't show hand 
*** SUMMARY ***
Total pot $0.02 | Rake $0 
Seat 1: lawlex_2 (small blind) folded before Flop
Seat 2: perupoquer (big blind) collected ($0.02)
Seat 3: jpamb folded before Flop (didn't bet)
Seat 4: _Anagor_AA folded before Flop (didn't bet)
Seat 6: nigel161 (button) folded before Flop (didn't bet)



PokerStars Hand #213866867159:  Hold'em No Limit ($0.01/$0.02 USD) - 2020/05/14 22:42:13 MSK [2020/05/14 15:42:13 ET]
Table 'Euforbo IV' 6-max Seat #1 is the button
Seat 1: lawlex_2 ($1.99 in chips) 
Seat 2: perupoquer ($1.01 in chips) 
Seat 3: jpamb ($2.08 in chips) 
Seat 4: _Anagor_AA ($2.05 in chips) 
Seat 6: nigel161 ($5.70 in chips) 
perupoquer: posts small blind $0.01
jpamb: posts big blind $0.02
*** HOLE CARDS ***
Dealt to lawlex_2 [7s 6d]
_Anagor_AA: folds 
nigel161: calls $0.02
lawlex_2: folds 
perupoquer: folds 
jpamb: checks 
*** FLOP *** [Kh Ah Ac]
jpamb: checks 
nigel161: checks 
*** TURN *** [Kh Ah Ac] [6s]
jpamb: checks 
EggMayo joins the table at seat #5 
nigel161: bets $0.06
jpamb: folds 
Uncalled bet ($0.06) returned to nigel161
nigel161 collected $0.05 from pot
nigel161: doesn't show hand 
*** SUMMARY ***
Total pot $0.05 | Rake $0 
Board [Kh Ah Ac 6s]
Seat 1: lawlex_2 (button) folded before Flop (didn't bet)
Seat 2: perupoquer (small blind) folded before Flop
Seat 3: jpamb (big blind) folded on the Turn
Seat 4: _Anagor_AA folded before Flop (didn't bet)
Seat 6: nigel161 collected ($0.05)



PokerStars Hand #213866915968:  Hold'em No Limit ($0.01/$0.02 USD) - 2020/05/14 22:42:57 MSK [2020/05/14 15:42:57 ET]
Table 'Euforbo IV' 6-max Seat #2 is the button
Seat 1: lawlex_2 ($1.99 in chips) 
Seat 2: perupoquer ($1 in chips) 
Seat 3: jpamb ($2.06 in chips) 
Seat 4: _Anagor_AA ($2.05 in chips) 
Seat 6: nigel161 ($5.73 in chips) 
jpamb: posts small blind $0.01
_Anagor_AA: posts big blind $0.02
EggMayo: sits out 
*** HOLE CARDS ***
Dealt to lawlex_2 [9s 6h]
nigel161 has timed out
nigel161: folds 
lawlex_2: folds 
perupoquer: folds 
jpamb: folds 
Uncalled bet ($0.01) returned to _Anagor_AA
_Anagor_AA collected $0.02 from pot
_Anagor_AA: doesn't show hand 
*** SUMMARY ***
Total pot $0.02 | Rake $0 
Seat 1: lawlex_2 folded before Flop (didn't bet)
Seat 2: perupoquer (button) folded before Flop (didn't bet)
Seat 3: jpamb (small blind) folded before Flop
Seat 4: _Anagor_AA (big blind) collected ($0.02)
Seat 6: nigel161 folded before Flop (didn't bet)



PokerStars Hand #213866946042:  Hold'em No Limit ($0.01/$0.02 USD) - 2020/05/14 22:43:16 MSK [2020/05/14 15:43:16 ET]
Table 'Euforbo IV' 6-max Seat #3 is the button
Seat 1: lawlex_2 ($1.99 in chips) 
Seat 2: perupoquer ($1 in chips) 
Seat 3: jpamb ($2.05 in chips) 
Seat 4: _Anagor_AA ($2.06 in chips) 
Seat 5: EggMayo ($2 in chips) 
Seat 6: nigel161 ($5.73 in chips) 
_Anagor_AA: posts small blind $0.01
EggMayo: posts big blind $0.02
*** HOLE CARDS ***
Dealt to lawlex_2 [Tc 8h]
nigel161: calls $0.02
lawlex_2: folds 
perupoquer: calls $0.02
jpamb: folds 
_Anagor_AA: folds 
EggMayo: checks 
*** FLOP *** [Jc 3d 2d]
EggMayo: checks 
nigel161: checks 
perupoquer: checks 
*** TURN *** [Jc 3d 2d] [Ac]
EggMayo: checks 
nigel161: checks 
perupoquer: checks 
*** RIVER *** [Jc 3d 2d Ac] [5h]
EggMayo: bets $0.06
nigel161: folds 
perupoquer: folds 
Uncalled bet ($0.06) returned to EggMayo
EggMayo collected $0.07 from pot
EggMayo: doesn't show hand 
*** SUMMARY ***
Total pot $0.07 | Rake $0 
Board [Jc 3d 2d Ac 5h]
Seat 1: lawlex_2 folded before Flop (didn't bet)
Seat 2: perupoquer folded on the River
Seat 3: jpamb (button) folded before Flop (didn't bet)
Seat 4: _Anagor_AA (small blind) folded before Flop
Seat 5: EggMayo (big blind) collected ($0.07)
Seat 6: nigel161 folded on the River



PokerStars Hand #213867020070:  Hold'em No Limit ($0.01/$0.02 USD) - 2020/05/14 22:44:22 MSK [2020/05/14 15:44:22 ET]
Table 'Euforbo IV' 6-max Seat #4 is the button
Seat 1: lawlex_2 ($1.99 in chips) 
Seat 2: perupoquer ($0.98 in chips) 
Seat 3: jpamb ($2.05 in chips) 
Seat 4: _Anagor_AA ($2.05 in chips) 
Seat 5: EggMayo ($2.05 in chips) 
Seat 6: nigel161 ($5.71 in chips) 
EggMayo: posts small blind $0.01
nigel161: posts big blind $0.02
*** HOLE CARDS ***
Dealt to lawlex_2 [2h 3d]
lawlex_2: folds 
perupoquer: raises $0.02 to $0.04
jpamb: calls $0.04
_Anagor_AA: folds 
EggMayo: folds 
nigel161: calls $0.02
*** FLOP *** [9s 8c 8h]
nigel161: bets $0.02
perupoquer: calls $0.02
jpamb: calls $0.02
*** TURN *** [9s 8c 8h] [2c]
nigel161: bets $0.02
perupoquer: calls $0.02
jpamb: calls $0.02
*** RIVER *** [9s 8c 8h 2c] [9d]
nigel161: checks 
perupoquer: bets $0.02
jpamb: folds 
nigel161: calls $0.02
*** SHOW DOWN ***
perupoquer: shows [Js Ac] (two pair, Nines and Eights)
nigel161: shows [Ah Kh] (two pair, Nines and Eights)
nigel161 collected $0.14 from pot
perupoquer collected $0.14 from pot
*** SUMMARY ***
Total pot $0.29 | Rake $0.01 
Board [9s 8c 8h 2c 9d]
Seat 1: lawlex_2 folded before Flop (didn't bet)
Seat 2: perupoquer showed [Js Ac] and won ($0.14) with two pair, Nines and Eights
Seat 3: jpamb folded on the River
Seat 4: _Anagor_AA (button) folded before Flop (didn't bet)
Seat 5: EggMayo (small blind) folded before Flop
Seat 6: nigel161 (big blind) showed [Ah Kh] and won ($0.14) with two pair, Nines and Eights



PokerStars Hand #213867081016:  Hold'em No Limit ($0.01/$0.02 USD) - 2020/05/14 22:45:16 MSK [2020/05/14 15:45:16 ET]
Table 'Euforbo IV' 6-max Seat #5 is the button
Seat 1: lawlex_2 ($1.99 in chips) 
Seat 2: perupoquer ($1.02 in chips) 
Seat 3: jpamb ($2 in chips) 
Seat 4: _Anagor_AA ($2.05 in chips) 
Seat 5: EggMayo ($2.04 in chips) 
Seat 6: nigel161 ($5.75 in chips) 
nigel161: posts small blind $0.01
lawlex_2: posts big blind $0.02
*** HOLE CARDS ***
Dealt to lawlex_2 [5d 3h]
perupoquer: raises $0.02 to $0.04
jpamb: folds 
_Anagor_AA: folds 
EggMayo: folds 
nigel161: calls $0.03
lawlex_2: folds 
*** FLOP *** [Qc 3d 2c]
nigel161: bets $0.02
perupoquer: calls $0.02
*** TURN *** [Qc 3d 2c] [Ah]
nigel161: bets $0.02
perupoquer: calls $0.02
*** RIVER *** [Qc 3d 2c Ah] [4s]
nigel161: checks 
perupoquer: checks 
*** SHOW DOWN ***
nigel161: shows [8c Tc] (high card Ace)
perupoquer: shows [9c 9h] (a pair of Nines)
perupoquer collected $0.17 from pot
*** SUMMARY ***
Total pot $0.18 | Rake $0.01 
Board [Qc 3d 2c Ah 4s]
Seat 1: lawlex_2 (big blind) folded before Flop
Seat 2: perupoquer showed [9c 9h] and won ($0.17) with a pair of Nines
Seat 3: jpamb folded before Flop (didn't bet)
Seat 4: _Anagor_AA folded before Flop (didn't bet)
Seat 5: EggMayo (button) folded before Flop (didn't bet)
Seat 6: nigel161 (small blind) showed [8c Tc] and lost with high card Ace



PokerStars Hand #213867121308:  Hold'em No Limit ($0.01/$0.02 USD) - 2020/05/14 22:45:51 MSK [2020/05/14 15:45:51 ET]
Table 'Euforbo IV' 6-max Seat #6 is the button
Seat 1: lawlex_2 ($1.97 in chips) 
Seat 2: perupoquer ($1.11 in chips) 
Seat 3: jpamb ($2 in chips) 
Seat 4: _Anagor_AA ($2.05 in chips) 
Seat 5: EggMayo ($2.04 in chips) 
Seat 6: nigel161 ($5.67 in chips) 
lawlex_2: posts small blind $0.01
perupoquer: posts big blind $0.02
*** HOLE CARDS ***
Dealt to lawlex_2 [Qs 7s]
jpamb: folds 
_Anagor_AA: folds 
EggMayo: folds 
nigel161: calls $0.02
lawlex_2: folds 
perupoquer: raises $0.26 to $0.28
nigel161: folds 
Uncalled bet ($0.26) returned to perupoquer
perupoquer collected $0.05 from pot
perupoquer: doesn't show hand 
*** SUMMARY ***
Total pot $0.05 | Rake $0 
Seat 1: lawlex_2 (small blind) folded before Flop
Seat 2: perupoquer (big blind) collected ($0.05)
Seat 3: jpamb folded before Flop (didn't bet)
Seat 4: _Anagor_AA folded before Flop (didn't bet)
Seat 5: EggMayo folded before Flop (didn't bet)
Seat 6: nigel161 (button) folded before Flop



PokerStars Hand #213867155487:  Hold'em No Limit ($0.01/$0.02 USD) - 2020/05/14 22:46:22 MSK [2020/05/14 15:46:22 ET]
Table 'Euforbo IV' 6-max Seat #1 is the button
Seat 1: lawlex_2 ($1.96 in chips) 
Seat 2: perupoquer ($1.14 in chips) 
Seat 3: jpamb ($2 in chips) 
Seat 4: _Anagor_AA ($2.05 in chips) 
Seat 5: EggMayo ($2.04 in chips) 
Seat 6: nigel161 ($5.65 in chips) 
perupoquer: posts small blind $0.01
jpamb: posts big blind $0.02
*** HOLE CARDS ***
Dealt to lawlex_2 [4c 3d]
_Anagor_AA: folds 
EggMayo: folds 
nigel161: calls $0.02
lawlex_2: folds 
perupoquer: calls $0.01
jpamb: checks 
*** FLOP *** [5d Ad As]
perupoquer: checks 
jpamb: checks 
nigel161: checks 
*** TURN *** [5d Ad As] [5h]
perupoquer: bets $0.02
jpamb: folds 
nigel161: folds 
Uncalled bet ($0.02) returned to perupoquer
perupoquer collected $0.06 from pot
perupoquer: doesn't show hand 
*** SUMMARY ***
Total pot $0.06 | Rake $0 
Board [5d Ad As 5h]
Seat 1: lawlex_2 (button) folded before Flop (didn't bet)
Seat 2: perupoquer (small blind) collected ($0.06)
Seat 3: jpamb (big blind) folded on the Turn
Seat 4: _Anagor_AA folded before Flop (didn't bet)
Seat 5: EggMayo folded before Flop (didn't bet)
Seat 6: nigel161 folded on the Turn



PokerStars Hand #213867205042:  Hold'em No Limit ($0.01/$0.02 USD) - 2020/05/14 22:47:06 MSK [2020/05/14 15:47:06 ET]
Table 'Euforbo IV' 6-max Seat #2 is the button
Seat 1: lawlex_2 ($1.96 in chips) 
Seat 2: perupoquer ($1.18 in chips) 
Seat 3: jpamb ($2 in chips) 
Seat 4: _Anagor_AA ($2.05 in chips) 
Seat 5: EggMayo ($2.04 in chips) 
Seat 6: nigel161 ($5.63 in chips) 
jpamb: posts small blind $0.01
_Anagor_AA: posts big blind $0.02
*** HOLE CARDS ***
Dealt to lawlex_2 [Ac Jc]
EggMayo: raises $0.04 to $0.06
nigel161: folds 
lawlex_2: calls $0.06
perupoquer: folds 
jpamb: folds 
_Anagor_AA: calls $0.04
*** FLOP *** [3s Jh 5d]
_Anagor_AA: checks 
EggMayo: bets $0.06
lawlex_2: calls $0.06
_Anagor_AA: calls $0.06
*** TURN *** [3s Jh 5d] [Th]
_Anagor_AA: checks 
EggMayo: bets $0.15
lawlex_2: calls $0.15
_Anagor_AA: calls $0.15
*** RIVER *** [3s Jh 5d Th] [2h]
_Anagor_AA: checks 
EggMayo: checks 
lawlex_2: checks 
*** SHOW DOWN ***
_Anagor_AA: shows [Ah 9h] (a flush, Ace high)
EggMayo: mucks hand 
lawlex_2: mucks hand 
_Anagor_AA collected $0.79 from pot
*** SUMMARY ***
Total pot $0.82 | Rake $0.03 
Board [3s Jh 5d Th 2h]
Seat 1: lawlex_2 mucked [Ac Jc]
Seat 2: perupoquer (button) folded before Flop (didn't bet)
Seat 3: jpamb (small blind) folded before Flop
Seat 4: _Anagor_AA (big blind) showed [Ah 9h] and won ($0.79) with a flush, Ace high
Seat 5: EggMayo mucked [Kc Ks]
Seat 6: nigel161 folded before Flop (didn't bet)



PokerStars Hand #213867266646:  Hold'em No Limit ($0.01/$0.02 USD) - 2020/05/14 22:48:01 MSK [2020/05/14 15:48:01 ET]
Table 'Euforbo IV' 6-max Seat #3 is the button
Seat 1: lawlex_2 ($1.69 in chips) 
Seat 2: perupoquer ($1.18 in chips) 
Seat 3: jpamb ($2 in chips) 
Seat 4: _Anagor_AA ($2.57 in chips) 
Seat 5: EggMayo ($1.77 in chips) 
Seat 6: nigel161 ($5.63 in chips) 
_Anagor_AA: posts small blind $0.01
EggMayo: posts big blind $0.02
*** HOLE CARDS ***
Dealt to lawlex_2 [Qd 3d]
nigel161: calls $0.02
lawlex_2: folds 
perupoquer: folds 
jpamb: folds 
_Anagor_AA: calls $0.01
EggMayo: checks 
*** FLOP *** [Th Js 4h]
_Anagor_AA: checks 
EggMayo: checks 
nigel161: bets $0.02
_Anagor_AA: folds 
EggMayo: folds 
Uncalled bet ($0.02) returned to nigel161
nigel161 collected $0.06 from pot
nigel161: doesn't show hand 
*** SUMMARY ***
Total pot $0.06 | Rake $0 
Board [Th Js 4h]
Seat 1: lawlex_2 folded before Flop (didn't bet)
Seat 2: perupoquer folded before Flop (didn't bet)
Seat 3: jpamb (button) folded before Flop (didn't bet)
Seat 4: _Anagor_AA (small blind) folded on the Flop
Seat 5: EggMayo (big blind) folded on the Flop
Seat 6: nigel161 collected ($0.06)



PokerStars Hand #213867303337:  Hold'em No Limit ($0.01/$0.02 USD) - 2020/05/14 22:48:34 MSK [2020/05/14 15:48:34 ET]
Table 'Euforbo IV' 6-max Seat #4 is the button
Seat 1: lawlex_2 ($1.69 in chips) 
Seat 2: perupoquer ($1.18 in chips) 
Seat 3: jpamb ($2 in chips) 
Seat 4: _Anagor_AA ($2.55 in chips) 
Seat 5: EggMayo ($1.75 in chips) 
Seat 6: nigel161 ($5.67 in chips) 
EggMayo: posts small blind $0.01
nigel161: posts big blind $0.02
*** HOLE CARDS ***
Dealt to lawlex_2 [8c 5d]
lawlex_2: folds 
perupoquer: raises $0.02 to $0.04
jpamb: folds 
_Anagor_AA: folds 
EggMayo: raises $0.17 to $0.21
nigel161: calls $0.19
perupoquer: calls $0.17
*** FLOP *** [2c 3h 4s]
EggMayo: checks 
nigel161: bets $0.02
perupoquer: raises $0.16 to $0.18
EggMayo: folds 
nigel161: calls $0.16
*** TURN *** [2c 3h 4s] [2d]
nigel161: checks 
perupoquer: bets $0.79 and is all-in
nigel161: folds 
Uncalled bet ($0.79) returned to perupoquer
perupoquer collected $0.96 from pot
perupoquer: doesn't show hand 
*** SUMMARY ***
Total pot $0.99 | Rake $0.03 
Board [2c 3h 4s 2d]
Seat 1: lawlex_2 folded before Flop (didn't bet)
Seat 2: perupoquer collected ($0.96)
Seat 3: jpamb folded before Flop (didn't bet)
Seat 4: _Anagor_AA (button) folded before Flop (didn't bet)
Seat 5: EggMayo (small blind) folded on the Flop
Seat 6: nigel161 (big blind) folded on the Turn



PokerStars Hand #213867358147:  Hold'em No Limit ($0.01/$0.02 USD) - 2020/05/14 22:49:23 MSK [2020/05/14 15:49:23 ET]
Table 'Euforbo IV' 6-max Seat #5 is the button
Seat 1: lawlex_2 ($1.69 in chips) 
Seat 2: perupoquer ($1.75 in chips) 
Seat 3: jpamb ($2 in chips) 
Seat 4: _Anagor_AA ($2.55 in chips) 
Seat 5: EggMayo ($1.54 in chips) 
Seat 6: nigel161 ($5.28 in chips) 
nigel161: posts small blind $0.01
lawlex_2: posts big blind $0.02
*** HOLE CARDS ***
Dealt to lawlex_2 [5s 5c]
perupoquer: raises $0.02 to $0.04
jpamb: folds 
_Anagor_AA: calls $0.04
EggMayo: folds 
nigel161: calls $0.03
lawlex_2: calls $0.02
*** FLOP *** [9c Qc 4s]
nigel161: checks 
lawlex_2: bets $0.10
perupoquer: raises $0.19 to $0.29
_Anagor_AA: folds 
nigel161: folds 
lawlex_2: folds 
Uncalled bet ($0.19) returned to perupoquer
perupoquer collected $0.35 from pot
perupoquer: doesn't show hand 
*** SUMMARY ***
Total pot $0.36 | Rake $0.01 
Board [9c Qc 4s]
Seat 1: lawlex_2 (big blind) folded on the Flop
Seat 2: perupoquer collected ($0.35)
Seat 3: jpamb folded before Flop (didn't bet)
Seat 4: _Anagor_AA folded on the Flop
Seat 5: EggMayo (button) folded before Flop (didn't bet)
Seat 6: nigel161 (small blind) folded on the Flop



PokerStars Hand #213867396501:  Hold'em No Limit ($0.01/$0.02 USD) - 2020/05/14 22:49:57 MSK [2020/05/14 15:49:57 ET]
Table 'Euforbo IV' 6-max Seat #6 is the button
Seat 1: lawlex_2 ($1.55 in chips) 
Seat 2: perupoquer ($1.96 in chips) 
Seat 3: jpamb ($2 in chips) 
Seat 4: _Anagor_AA ($2.51 in chips) 
Seat 5: EggMayo ($1.54 in chips) 
Seat 6: nigel161 ($5.24 in chips) 
lawlex_2: posts small blind $0.01
perupoquer: posts big blind $0.02
*** HOLE CARDS ***
Dealt to lawlex_2 [4h 4d]
jpamb: folds 
_Anagor_AA: folds 
EggMayo: folds 
nigel161: calls $0.02
lawlex_2: raises $0.03 to $0.05
perupoquer: calls $0.03
nigel161: calls $0.03
*** FLOP *** [Kd 3c Jc]
lawlex_2: bets $0.09
perupoquer: calls $0.09
nigel161: raises $0.09 to $0.18
lawlex_2: folds 
perupoquer: calls $0.09
*** TURN *** [Kd 3c Jc] [8h]
perupoquer: checks 
nigel161: bets $0.14
perupoquer: folds 
Uncalled bet ($0.14) returned to nigel161
nigel161 collected $0.58 from pot
*** SUMMARY ***
Total pot $0.60 | Rake $0.02 
Board [Kd 3c Jc 8h]
Seat 1: lawlex_2 (small blind) folded on the Flop
Seat 2: perupoquer (big blind) folded on the Turn
Seat 3: jpamb folded before Flop (didn't bet)
Seat 4: _Anagor_AA folded before Flop (didn't bet)
Seat 5: EggMayo folded before Flop (didn't bet)
Seat 6: nigel161 (button) collected ($0.58)



PokerStars Hand #213867453187:  Hold'em No Limit ($0.01/$0.02 USD) - 2020/05/14 22:50:48 MSK [2020/05/14 15:50:48 ET]
Table 'Euforbo IV' 6-max Seat #1 is the button
Seat 1: lawlex_2 ($1.41 in chips) 
Seat 2: perupoquer ($1.73 in chips) 
Seat 3: jpamb ($2 in chips) 
Seat 4: _Anagor_AA ($2.51 in chips) 
Seat 5: EggMayo ($1.54 in chips) 
Seat 6: nigel161 ($5.59 in chips) 
perupoquer: posts small blind $0.01
jpamb: posts big blind $0.02
*** HOLE CARDS ***
Dealt to lawlex_2 [4h 9c]
_Anagor_AA: folds 
EggMayo: raises $0.04 to $0.06
nigel161: calls $0.06
lawlex_2: folds 
perupoquer: folds 
jpamb: raises $0.22 to $0.28
EggMayo: folds 
nigel161: folds 
Uncalled bet ($0.22) returned to jpamb
jpamb collected $0.19 from pot
jpamb: doesn't show hand 
*** SUMMARY ***
Total pot $0.19 | Rake $0 
Seat 1: lawlex_2 (button) folded before Flop (didn't bet)
Seat 2: perupoquer (small blind) folded before Flop
Seat 3: jpamb (big blind) collected ($0.19)
Seat 4: _Anagor_AA folded before Flop (didn't bet)
Seat 5: EggMayo folded before Flop
Seat 6: nigel161 folded before Flop



PokerStars Hand #213867484145:  Hold'em No Limit ($0.01/$0.02 USD) - 2020/05/14 22:51:16 MSK [2020/05/14 15:51:16 ET]
Table 'Euforbo IV' 6-max Seat #2 is the button
Seat 1: lawlex_2 ($1.41 in chips) 
Seat 2: perupoquer ($1.72 in chips) 
Seat 3: jpamb ($2.13 in chips) 
Seat 4: _Anagor_AA ($2.51 in chips) 
Seat 5: EggMayo ($1.48 in chips) 
Seat 6: nigel161 ($5.53 in chips) 
jpamb: posts small blind $0.01
_Anagor_AA: posts big blind $0.02
*** HOLE CARDS ***
Dealt to lawlex_2 [Ad Qs]
EggMayo: folds 
nigel161: calls $0.02
lawlex_2: raises $0.03 to $0.05
perupoquer: calls $0.05
jpamb: folds 
_Anagor_AA: folds 
nigel161: calls $0.03
*** FLOP *** [7d 3c 8s]
nigel161: bets $0.02
lawlex_2: calls $0.02
perupoquer: calls $0.02
*** TURN *** [7d 3c 8s] [Qd]
nigel161: bets $0.02
lawlex_2: raises $0.18 to $0.20
perupoquer: folds 
nigel161: folds 
Uncalled bet ($0.18) returned to lawlex_2
lawlex_2 collected $0.27 from pot
lawlex_2: doesn't show hand 
*** SUMMARY ***
Total pot $0.28 | Rake $0.01 
Board [7d 3c 8s Qd]
Seat 1: lawlex_2 collected ($0.27)
Seat 2: perupoquer (button) folded on the Turn
Seat 3: jpamb (small blind) folded before Flop
Seat 4: _Anagor_AA (big blind) folded before Flop
Seat 5: EggMayo folded before Flop (didn't bet)
Seat 6: nigel161 folded on the Turn



PokerStars Hand #213867552442:  Hold'em No Limit ($0.01/$0.02 USD) - 2020/05/14 22:52:16 MSK [2020/05/14 15:52:16 ET]
Table 'Euforbo IV' 6-max Seat #3 is the button
Seat 1: lawlex_2 ($1.59 in chips) 
Seat 2: perupoquer ($1.65 in chips) 
Seat 3: jpamb ($2.12 in chips) 
Seat 4: _Anagor_AA ($2.49 in chips) 
Seat 5: EggMayo ($1.48 in chips) 
Seat 6: nigel161 ($5.44 in chips) 
_Anagor_AA: posts small blind $0.01
EggMayo: posts big blind $0.02
*** HOLE CARDS ***
Dealt to lawlex_2 [Jh Jd]
nigel161: calls $0.02
lawlex_2: raises $0.03 to $0.05
perupoquer: calls $0.05
jpamb: folds 
_Anagor_AA: folds 
EggMayo: folds 
nigel161: calls $0.03
*** FLOP *** [Kh 2s 4s]
nigel161: bets $0.02
lawlex_2: raises $0.14 to $0.16
perupoquer: calls $0.16
nigel161: calls $0.14
*** TURN *** [Kh 2s 4s] [5c]
nigel161: bets $0.02
lawlex_2: calls $0.02
perupoquer: raises $0.22 to $0.24
nigel161: calls $0.22
lawlex_2: folds 
*** RIVER *** [Kh 2s 4s 5c] [5d]
nigel161: bets $0.56
perupoquer: raises $0.64 to $1.20 and is all-in
nigel161: calls $0.64
*** SHOW DOWN ***
perupoquer: shows [5s Ks] (a full house, Fives full of Kings)
nigel161: shows [Ad Ah] (two pair, Aces and Fives)
perupoquer collected $3.44 from pot
*** SUMMARY ***
Total pot $3.56 | Rake $0.12 
Board [Kh 2s 4s 5c 5d]
Seat 1: lawlex_2 folded on the Turn
Seat 2: perupoquer showed [5s Ks] and won ($3.44) with a full house, Fives full of Kings
Seat 3: jpamb (button) folded before Flop (didn't bet)
Seat 4: _Anagor_AA (small blind) folded before Flop
Seat 5: EggMayo (big blind) folded before Flop
Seat 6: nigel161 showed [Ad Ah] and lost with two pair, Aces and Fives



PokerStars Hand #213867632413:  Hold'em No Limit ($0.01/$0.02 USD) - 2020/05/14 22:53:28 MSK [2020/05/14 15:53:28 ET]
Table 'Euforbo IV' 6-max Seat #4 is the button
Seat 1: lawlex_2 ($1.36 in chips) 
Seat 2: perupoquer ($3.44 in chips) 
Seat 3: jpamb ($2.12 in chips) 
Seat 4: _Anagor_AA ($2.48 in chips) 
Seat 5: EggMayo ($1.46 in chips) 
Seat 6: nigel161 ($3.79 in chips) 
EggMayo: posts small blind $0.01
nigel161: posts big blind $0.02
*** HOLE CARDS ***
Dealt to lawlex_2 [2s 7d]
lawlex_2: folds 
perupoquer: folds 
jpamb: folds 
_Anagor_AA: raises $0.04 to $0.06
EggMayo: folds 
nigel161: calls $0.04
*** FLOP *** [Kd Ac Td]
nigel161: checks 
_Anagor_AA: bets $0.04
nigel161: folds 
Uncalled bet ($0.04) returned to _Anagor_AA
_Anagor_AA collected $0.13 from pot
_Anagor_AA: doesn't show hand 
*** SUMMARY ***
Total pot $0.13 | Rake $0 
Board [Kd Ac Td]
Seat 1: lawlex_2 folded before Flop (didn't bet)
Seat 2: perupoquer folded before Flop (didn't bet)
Seat 3: jpamb folded before Flop (didn't bet)
Seat 4: _Anagor_AA (button) collected ($0.13)
Seat 5: EggMayo (small blind) folded before Flop
Seat 6: nigel161 (big blind) folded on the Flop



PokerStars Hand #213867668170:  Hold'em No Limit ($0.01/$0.02 USD) - 2020/05/14 22:54:01 MSK [2020/05/14 15:54:01 ET]
Table 'Euforbo IV' 6-max Seat #5 is the button
Seat 1: lawlex_2 ($1.36 in chips) 
Seat 2: perupoquer ($3.44 in chips) 
Seat 3: jpamb ($2.12 in chips) 
Seat 4: _Anagor_AA ($2.55 in chips) 
Seat 5: EggMayo ($1.45 in chips) 
Seat 6: nigel161 ($3.73 in chips) 
nigel161: posts small blind $0.01
lawlex_2: posts big blind $0.02
*** HOLE CARDS ***
Dealt to lawlex_2 [6h Ks]
perupoquer: folds 
jpamb: raises $0.04 to $0.06
_Anagor_AA: folds 
EggMayo: folds 
nigel161: folds 
lawlex_2: folds 
Uncalled bet ($0.04) returned to jpamb
jpamb collected $0.05 from pot
jpamb: doesn't show hand 
*** SUMMARY ***
Total pot $0.05 | Rake $0 
Seat 1: lawlex_2 (big blind) folded before Flop
Seat 2: perupoquer folded before Flop (didn't bet)
Seat 3: jpamb collected ($0.05)
Seat 4: _Anagor_AA folded before Flop (didn't bet)
Seat 5: EggMayo (button) folded before Flop (didn't bet)
Seat 6: nigel161 (small blind) folded before Flop



PokerStars Hand #213867686111:  Hold'em No Limit ($0.01/$0.02 USD) - 2020/05/14 22:54:17 MSK [2020/05/14 15:54:17 ET]
Table 'Euforbo IV' 6-max Seat #6 is the button
Seat 1: lawlex_2 ($1.34 in chips) 
Seat 2: perupoquer ($3.44 in chips) 
Seat 3: jpamb ($2.15 in chips) 
Seat 4: _Anagor_AA ($2.55 in chips) 
Seat 5: EggMayo ($1.45 in chips) 
Seat 6: nigel161 ($3.72 in chips) 
lawlex_2: posts small blind $0.01
perupoquer: posts big blind $0.02
*** HOLE CARDS ***
Dealt to lawlex_2 [Kd As]
jpamb: folds 
_Anagor_AA: folds 
EggMayo: folds 
nigel161: calls $0.02
lawlex_2: raises $0.03 to $0.05
perupoquer: folds 
nigel161: calls $0.03
*** FLOP *** [3d Kc 5h]
lawlex_2: bets $0.08
nigel161: folds 
Uncalled bet ($0.08) returned to lawlex_2
lawlex_2 collected $0.12 from pot
lawlex_2: doesn't show hand 
*** SUMMARY ***
Total pot $0.12 | Rake $0 
Board [3d Kc 5h]
Seat 1: lawlex_2 (small blind) collected ($0.12)
Seat 2: perupoquer (big blind) folded before Flop
Seat 3: jpamb folded before Flop (didn't bet)
Seat 4: _Anagor_AA folded before Flop (didn't bet)
Seat 5: EggMayo folded before Flop (didn't bet)
Seat 6: nigel161 (button) folded on the Flop



PokerStars Hand #213867714583:  Hold'em No Limit ($0.01/$0.02 USD) - 2020/05/14 22:54:43 MSK [2020/05/14 15:54:43 ET]
Table 'Euforbo IV' 6-max Seat #1 is the button
Seat 1: lawlex_2 ($1.41 in chips) 
Seat 2: perupoquer ($3.42 in chips) 
Seat 3: jpamb ($2.15 in chips) 
Seat 4: _Anagor_AA ($2.55 in chips) 
Seat 5: EggMayo ($1.45 in chips) 
Seat 6: nigel161 ($3.67 in chips) 
perupoquer: posts small blind $0.01
jpamb: posts big blind $0.02
*** HOLE CARDS ***
Dealt to lawlex_2 [3d Qs]
_Anagor_AA: folds 
EggMayo: folds 
nigel161: calls $0.02
lawlex_2: folds 
perupoquer: folds 
jpamb: checks 
*** FLOP *** [Qd 5h 5d]
jpamb: checks 
nigel161: checks 
*** TURN *** [Qd 5h 5d] [2s]
jpamb: checks 
nigel161: checks 
*** RIVER *** [Qd 5h 5d 2s] [2h]
jpamb: checks 
nigel161: checks 
*** SHOW DOWN ***
jpamb: shows [Ah 9s] (two pair, Fives and Deuces)
nigel161: mucks hand 
jpamb collected $0.05 from pot
*** SUMMARY ***
Total pot $0.05 | Rake $0 
Board [Qd 5h 5d 2s 2h]
Seat 1: lawlex_2 (button) folded before Flop (didn't bet)
Seat 2: perupoquer (small blind) folded before Flop
Seat 3: jpamb (big blind) showed [Ah 9s] and won ($0.05) with two pair, Fives and Deuces
Seat 4: _Anagor_AA folded before Flop (didn't bet)
Seat 5: EggMayo folded before Flop (didn't bet)
Seat 6: nigel161 mucked [7c Ks]



PokerStars Hand #213867755221:  Hold'em No Limit ($0.01/$0.02 USD) - 2020/05/14 22:55:25 MSK [2020/05/14 15:55:25 ET]
Table 'Euforbo IV' 6-max Seat #2 is the button
Seat 1: lawlex_2 ($1.41 in chips) 
Seat 2: perupoquer ($3.41 in chips) 
Seat 3: jpamb ($2.18 in chips) 
Seat 4: _Anagor_AA ($2.55 in chips) 
Seat 5: EggMayo ($1.45 in chips) 
Seat 6: nigel161 ($3.65 in chips) 
jpamb: posts small blind $0.01
_Anagor_AA: posts big blind $0.02
*** HOLE CARDS ***
Dealt to lawlex_2 [Ac 5c]
EggMayo: folds 
nigel161: calls $0.02
lawlex_2: raises $0.03 to $0.05
perupoquer: folds 
jpamb: folds 
_Anagor_AA: calls $0.03
nigel161: calls $0.03
*** FLOP *** [As Jc 3s]
_Anagor_AA: checks 
nigel161: checks 
lawlex_2: bets $0.10
_Anagor_AA: folds 
nigel161: folds 
Uncalled bet ($0.10) returned to lawlex_2
lawlex_2 collected $0.15 from pot
lawlex_2: doesn't show hand 
*** SUMMARY ***
Total pot $0.16 | Rake $0.01 
Board [As Jc 3s]
Seat 1: lawlex_2 collected ($0.15)
Seat 2: perupoquer (button) folded before Flop (didn't bet)
Seat 3: jpamb (small blind) folded before Flop
Seat 4: _Anagor_AA (big blind) folded on the Flop
Seat 5: EggMayo folded before Flop (didn't bet)
Seat 6: nigel161 folded on the Flop



PokerStars Hand #213867783893:  Hold'em No Limit ($0.01/$0.02 USD) - 2020/05/14 22:56:03 MSK [2020/05/14 15:56:03 ET]
Table 'Euforbo IV' 6-max Seat #3 is the button
Seat 1: lawlex_2 ($1.51 in chips) 
Seat 2: perupoquer ($3.41 in chips) 
Seat 3: jpamb ($2.17 in chips) 
Seat 4: _Anagor_AA ($2.50 in chips) 
Seat 5: EggMayo ($1.45 in chips) 
Seat 6: nigel161 ($3.60 in chips) 
_Anagor_AA: posts small blind $0.01
EggMayo: posts big blind $0.02
*** HOLE CARDS ***
Dealt to lawlex_2 [Qh Ah]
nigel161: calls $0.02
lawlex_2: raises $0.03 to $0.05
perupoquer: folds 
jpamb: folds 
_Anagor_AA: folds 
EggMayo: folds 
nigel161: calls $0.03
*** FLOP *** [8c 7s Jh]
nigel161: checks 
lawlex_2: bets $0.09
nigel161: calls $0.09
*** TURN *** [8c 7s Jh] [6s]
nigel161: checks 
lawlex_2: bets $0.20
nigel161: calls $0.20
*** RIVER *** [8c 7s Jh 6s] [2d]
nigel161: checks 
lawlex_2: checks 
*** SHOW DOWN ***
nigel161: shows [Qs Jc] (a pair of Jacks)
lawlex_2: mucks hand 
nigel161 collected $0.69 from pot
*** SUMMARY ***
Total pot $0.71 | Rake $0.02 
Board [8c 7s Jh 6s 2d]
Seat 1: lawlex_2 mucked [Qh Ah]
Seat 2: perupoquer folded before Flop (didn't bet)
Seat 3: jpamb (button) folded before Flop (didn't bet)
Seat 4: _Anagor_AA (small blind) folded before Flop
Seat 5: EggMayo (big blind) folded before Flop
Seat 6: nigel161 showed [Qs Jc] and won ($0.69) with a pair of Jacks



PokerStars Hand #213867813735:  Hold'em No Limit ($0.01/$0.02 USD) - 2020/05/14 22:56:42 MSK [2020/05/14 15:56:42 ET]
Table 'Euforbo IV' 6-max Seat #4 is the button
Seat 1: lawlex_2 ($1.17 in chips) 
Seat 2: perupoquer ($3.41 in chips) 
Seat 3: jpamb ($2.17 in chips) 
Seat 4: _Anagor_AA ($2.49 in chips) 
Seat 5: EggMayo ($1.43 in chips) 
Seat 6: nigel161 ($3.95 in chips) 
EggMayo: posts small blind $0.01
nigel161: posts big blind $0.02
*** HOLE CARDS ***
Dealt to lawlex_2 [3h 2d]
lawlex_2: folds 
perupoquer has timed out
perupoquer: folds 
jpamb: folds 
_Anagor_AA: raises $0.04 to $0.06
EggMayo: folds 
nigel161: calls $0.04
*** FLOP *** [4d 5c 2h]
nigel161: bets $0.02
_Anagor_AA: calls $0.02
*** TURN *** [4d 5c 2h] [2c]
nigel161: bets $0.06
_Anagor_AA: folds 
Uncalled bet ($0.06) returned to nigel161
nigel161 collected $0.16 from pot
nigel161: doesn't show hand 
*** SUMMARY ***
Total pot $0.17 | Rake $0.01 
Board [4d 5c 2h 2c]
Seat 1: lawlex_2 folded before Flop (didn't bet)
Seat 2: perupoquer folded before Flop (didn't bet)
Seat 3: jpamb folded before Flop (didn't bet)
Seat 4: _Anagor_AA (button) folded on the Turn
Seat 5: EggMayo (small blind) folded before Flop
Seat 6: nigel161 (big blind) collected ($0.16)



PokerStars Hand #213867850208:  Hold'em No Limit ($0.01/$0.02 USD) - 2020/05/14 22:57:31 MSK [2020/05/14 15:57:31 ET]
Table 'Euforbo IV' 6-max Seat #5 is the button
Seat 1: lawlex_2 ($1.17 in chips) 
Seat 2: perupoquer ($3.41 in chips) 
Seat 3: jpamb ($2.17 in chips) 
Seat 4: _Anagor_AA ($2.41 in chips) 
Seat 5: EggMayo ($1.42 in chips) 
Seat 6: nigel161 ($4.03 in chips) 
nigel161: posts small blind $0.01
lawlex_2: posts big blind $0.02
*** HOLE CARDS ***
Dealt to lawlex_2 [9c 6h]
perupoquer: folds 
jpamb: folds 
_Anagor_AA: raises $0.04 to $0.06
EggMayo: folds 
nigel161: calls $0.05
lawlex_2: folds 
*** FLOP *** [6s Th Qc]
nigel161: checks 
_Anagor_AA: bets $0.08
nigel161: calls $0.08
*** TURN *** [6s Th Qc] [Kd]
nigel161: bets $0.04
_Anagor_AA: calls $0.04
*** RIVER *** [6s Th Qc Kd] [5d]
nigel161: checks 
_Anagor_AA: bets $0.20
nigel161: folds 
Uncalled bet ($0.20) returned to _Anagor_AA
_Anagor_AA collected $0.37 from pot
_Anagor_AA: doesn't show hand 
*** SUMMARY ***
Total pot $0.38 | Rake $0.01 
Board [6s Th Qc Kd 5d]
Seat 1: lawlex_2 (big blind) folded before Flop
Seat 2: perupoquer folded before Flop (didn't bet)
Seat 3: jpamb folded before Flop (didn't bet)
Seat 4: _Anagor_AA collected ($0.37)
Seat 5: EggMayo (button) folded before Flop (didn't bet)
Seat 6: nigel161 (small blind) folded on the River



PokerStars Hand #213867896536:  Hold'em No Limit ($0.01/$0.02 USD) - 2020/05/14 22:58:34 MSK [2020/05/14 15:58:34 ET]
Table 'Euforbo IV' 6-max Seat #6 is the button
Seat 1: lawlex_2 ($1.15 in chips) 
Seat 2: perupoquer ($3.41 in chips) 
Seat 3: jpamb ($2.17 in chips) 
Seat 4: _Anagor_AA ($2.60 in chips) 
Seat 5: EggMayo ($1.42 in chips) 
Seat 6: nigel161 ($3.85 in chips) 
lawlex_2: posts small blind $0.01
perupoquer: posts big blind $0.02
*** HOLE CARDS ***
Dealt to lawlex_2 [2h As]
jpamb: folds 
_Anagor_AA: raises $0.04 to $0.06
EggMayo: folds 
nigel161: calls $0.06
lawlex_2: folds 
perupoquer: calls $0.04
*** FLOP *** [5h 3c Ks]
perupoquer: checks 
_Anagor_AA: checks 
nigel161: bets $0.02
perupoquer: raises $0.06 to $0.08
_Anagor_AA: folds 
nigel161: calls $0.06
*** TURN *** [5h 3c Ks] [7h]
perupoquer: bets $0.19
nigel161: calls $0.19
*** RIVER *** [5h 3c Ks 7h] [Td]
perupoquer: bets $3.08 and is all-in
nigel161: folds [Kh]
Uncalled bet ($3.08) returned to perupoquer
perupoquer collected $0.70 from pot
perupoquer: doesn't show hand 
*** SUMMARY ***
Total pot $0.73 | Rake $0.03 
Board [5h 3c Ks 7h Td]
Seat 1: lawlex_2 (small blind) folded before Flop
Seat 2: perupoquer (big blind) collected ($0.70)
Seat 3: jpamb folded before Flop (didn't bet)
Seat 4: _Anagor_AA folded on the Flop
Seat 5: EggMayo folded before Flop (didn't bet)
Seat 6: nigel161 (button) folded on the River



PokerStars Hand #213867943791:  Hold'em No Limit ($0.01/$0.02 USD) - 2020/05/14 22:59:36 MSK [2020/05/14 15:59:36 ET]
Table 'Euforbo IV' 6-max Seat #1 is the button
Seat 1: lawlex_2 ($1.14 in chips) 
Seat 2: perupoquer ($3.78 in chips) 
Seat 3: jpamb ($2.17 in chips) 
Seat 4: _Anagor_AA ($2.54 in chips) 
Seat 5: EggMayo ($1.42 in chips) 
Seat 6: nigel161 ($3.52 in chips) 
perupoquer: posts small blind $0.01
jpamb: posts big blind $0.02
*** HOLE CARDS ***
Dealt to lawlex_2 [2s 5d]
_Anagor_AA: folds 
EggMayo: folds 
perupoquer said, "qq"
nigel161: calls $0.02
lawlex_2: folds 
perupoquer: calls $0.01
jpamb: checks 
*** FLOP *** [3h 5h Jd]
perupoquer: checks 
jpamb: checks 
nigel161: checks 
*** TURN *** [3h 5h Jd] [8h]
perupoquer: checks 
jpamb: checks 
nigel161: checks 
*** RIVER *** [3h 5h Jd 8h] [Ah]
perupoquer: bets $0.02
jpamb: folds 
nigel161: raises $0.10 to $0.12
perupoquer: folds 
Uncalled bet ($0.10) returned to nigel161
nigel161 collected $0.10 from pot
nigel161: doesn't show hand 
*** SUMMARY ***
Total pot $0.10 | Rake $0 
Board [3h 5h Jd 8h Ah]
Seat 1: lawlex_2 (button) folded before Flop (didn't bet)
Seat 2: perupoquer (small blind) folded on the River
Seat 3: jpamb (big blind) folded on the River
Seat 4: _Anagor_AA folded before Flop (didn't bet)
Seat 5: EggMayo folded before Flop (didn't bet)
Seat 6: nigel161 collected ($0.10)



PokerStars Hand #213867976362:  Hold'em No Limit ($0.01/$0.02 USD) - 2020/05/14 23:00:17 MSK [2020/05/14 16:00:17 ET]
Table 'Euforbo IV' 6-max Seat #2 is the button
Seat 1: lawlex_2 ($1.14 in chips) 
Seat 2: perupoquer ($3.74 in chips) 
Seat 3: jpamb ($2.15 in chips) 
Seat 4: _Anagor_AA ($2.54 in chips) 
Seat 5: EggMayo ($1.42 in chips) 
Seat 6: nigel161 ($3.58 in chips) 
jpamb: posts small blind $0.01
_Anagor_AA: posts big blind $0.02
*** HOLE CARDS ***
Dealt to lawlex_2 [Jc 7d]
EggMayo: folds 
nigel161: calls $0.02
lawlex_2: folds 
perupoquer: folds 
jpamb: folds 
_Anagor_AA: checks 
*** FLOP *** [6d Ah 8c]
_Anagor_AA: checks 
nigel161: checks 
*** TURN *** [6d Ah 8c] [Qs]
_Anagor_AA: checks 
nigel161: checks 
*** RIVER *** [6d Ah 8c Qs] [7h]
_Anagor_AA: checks 
nigel161: checks 
*** SHOW DOWN ***
_Anagor_AA: shows [Td 4h] (high card Ace)
nigel161: shows [4c 7s] (a pair of Sevens)
nigel161 collected $0.05 from pot
*** SUMMARY ***
Total pot $0.05 | Rake $0 
Board [6d Ah 8c Qs 7h]
Seat 1: lawlex_2 folded before Flop (didn't bet)
Seat 2: perupoquer (button) folded before Flop (didn't bet)
Seat 3: jpamb (small blind) folded before Flop
Seat 4: _Anagor_AA (big blind) showed [Td 4h] and lost with high card Ace
Seat 5: EggMayo folded before Flop (didn't bet)
Seat 6: nigel161 showed [4c 7s] and won ($0.05) with a pair of Sevens



PokerStars Hand #213868012007:  Hold'em No Limit ($0.01/$0.02 USD) - 2020/05/14 23:00:58 MSK [2020/05/14 16:00:58 ET]
Table 'Euforbo IV' 6-max Seat #3 is the button
Seat 1: lawlex_2 ($1.14 in chips) 
Seat 2: perupoquer ($3.74 in chips) 
Seat 3: jpamb ($2.14 in chips) 
Seat 4: _Anagor_AA ($2.52 in chips) 
Seat 5: EggMayo ($1.42 in chips) 
Seat 6: nigel161 ($3.61 in chips) 
_Anagor_AA: posts small blind $0.01
EggMayo: posts big blind $0.02
*** HOLE CARDS ***
Dealt to lawlex_2 [5d 9h]
nigel161: calls $0.02
lawlex_2: folds 
perupoquer: folds 
jpamb: folds 
_Anagor_AA: calls $0.01
EggMayo: checks 
*** FLOP *** [2d 7s Kd]
_Anagor_AA: checks 
EggMayo: checks 
nigel161: checks 
*** TURN *** [2d 7s Kd] [9s]
_Anagor_AA: checks 
EggMayo: checks 
nigel161: checks 
*** RIVER *** [2d 7s Kd 9s] [4d]
_Anagor_AA: checks 
EggMayo: checks 
nigel161: checks 
*** SHOW DOWN ***
_Anagor_AA: shows [8h As] (high card Ace)
EggMayo: mucks hand 
nigel161: mucks hand 
_Anagor_AA collected $0.06 from pot
*** SUMMARY ***
Total pot $0.06 | Rake $0 
Board [2d 7s Kd 9s 4d]
Seat 1: lawlex_2 folded before Flop (didn't bet)
Seat 2: perupoquer folded before Flop (didn't bet)
Seat 3: jpamb (button) folded before Flop (didn't bet)
Seat 4: _Anagor_AA (small blind) showed [8h As] and won ($0.06) with high card Ace
Seat 5: EggMayo (big blind) mucked [Ts 3s]
Seat 6: nigel161 mucked [Ah 3c]



PokerStars Hand #213868068373:  Hold'em No Limit ($0.01/$0.02 USD) - 2020/05/14 23:01:52 MSK [2020/05/14 16:01:52 ET]
Table 'Euforbo IV' 6-max Seat #4 is the button
Seat 1: lawlex_2 ($1.14 in chips) 
Seat 2: perupoquer ($3.74 in chips) 
Seat 3: jpamb ($2.14 in chips) 
Seat 4: _Anagor_AA ($2.56 in chips) 
Seat 5: EggMayo ($1.40 in chips) 
Seat 6: nigel161 ($3.59 in chips) 
EggMayo: posts small blind $0.01
nigel161: posts big blind $0.02
*** HOLE CARDS ***
Dealt to lawlex_2 [Ah Tc]
lawlex_2: raises $0.03 to $0.05
perupoquer: folds 
jpamb: folds 
_Anagor_AA: folds 
EggMayo: folds 
nigel161: calls $0.03
*** FLOP *** [7d 5s 2c]
nigel161: checks 
lawlex_2: bets $0.07
nigel161: folds 
Uncalled bet ($0.07) returned to lawlex_2
lawlex_2 collected $0.11 from pot
lawlex_2: doesn't show hand 
*** SUMMARY ***
Total pot $0.11 | Rake $0 
Board [7d 5s 2c]
Seat 1: lawlex_2 collected ($0.11)
Seat 2: perupoquer folded before Flop (didn't bet)
Seat 3: jpamb folded before Flop (didn't bet)
Seat 4: _Anagor_AA (button) folded before Flop (didn't bet)
Seat 5: EggMayo (small blind) folded before Flop
Seat 6: nigel161 (big blind) folded on the Flop



PokerStars Hand #213868101631:  Hold'em No Limit ($0.01/$0.02 USD) - 2020/05/14 23:02:15 MSK [2020/05/14 16:02:15 ET]
Table 'Euforbo IV' 6-max Seat #5 is the button
Seat 1: lawlex_2 ($1.20 in chips) 
Seat 2: perupoquer ($3.74 in chips) 
Seat 3: jpamb ($2.14 in chips) 
Seat 4: _Anagor_AA ($2.56 in chips) 
Seat 5: EggMayo ($1.39 in chips) 
Seat 6: nigel161 ($3.54 in chips) 
nigel161: posts small blind $0.01
lawlex_2: posts big blind $0.02
*** HOLE CARDS ***
Dealt to lawlex_2 [2h 6s]
perupoquer: folds 
jpamb: folds 
_Anagor_AA: raises $0.04 to $0.06
EggMayo: folds 
nigel161: folds 
lawlex_2: folds 
Uncalled bet ($0.04) returned to _Anagor_AA
_Anagor_AA collected $0.05 from pot
_Anagor_AA: doesn't show hand 
*** SUMMARY ***
Total pot $0.05 | Rake $0 
Seat 1: lawlex_2 (big blind) folded before Flop
Seat 2: perupoquer folded before Flop (didn't bet)
Seat 3: jpamb folded before Flop (didn't bet)
Seat 4: _Anagor_AA collected ($0.05)
Seat 5: EggMayo (button) folded before Flop (didn't bet)
Seat 6: nigel161 (small blind) folded before Flop



PokerStars Hand #213868116619:  Hold'em No Limit ($0.01/$0.02 USD) - 2020/05/14 23:02:30 MSK [2020/05/14 16:02:30 ET]
Table 'Euforbo IV' 6-max Seat #6 is the button
Seat 1: lawlex_2 ($1.18 in chips) 
Seat 2: perupoquer ($3.74 in chips) 
Seat 3: jpamb ($2.14 in chips) 
Seat 4: _Anagor_AA ($2.59 in chips) 
Seat 5: EggMayo ($1.39 in chips) 
Seat 6: nigel161 ($3.53 in chips) 
lawlex_2: posts small blind $0.01
perupoquer: posts big blind $0.02
*** HOLE CARDS ***
Dealt to lawlex_2 [4s As]
jpamb: folds 
_Anagor_AA: folds 
EggMayo: folds 
nigel161: calls $0.02
lawlex_2: raises $0.03 to $0.05
perupoquer: calls $0.03
nigel161: calls $0.03
*** FLOP *** [9c 2d 3c]
lawlex_2: bets $0.09
perupoquer: calls $0.09
nigel161: calls $0.09
*** TURN *** [9c 2d 3c] [6c]
lawlex_2: bets $0.27
perupoquer: folds 
nigel161: raises $0.27 to $0.54
lawlex_2: folds 
Uncalled bet ($0.27) returned to nigel161
nigel161 collected $0.93 from pot
nigel161: doesn't show hand 
*** SUMMARY ***
Total pot $0.96 | Rake $0.03 
Board [9c 2d 3c 6c]
Seat 1: lawlex_2 (small blind) folded on the Turn
Seat 2: perupoquer (big blind) folded on the Turn
Seat 3: jpamb folded before Flop (didn't bet)
Seat 4: _Anagor_AA folded before Flop (didn't bet)
Seat 5: EggMayo folded before Flop (didn't bet)
Seat 6: nigel161 (button) collected ($0.93)



PokerStars Hand #213868170497:  Hold'em No Limit ($0.01/$0.02 USD) - 2020/05/14 23:03:18 MSK [2020/05/14 16:03:18 ET]
Table 'Euforbo IV' 6-max Seat #1 is the button
Seat 1: lawlex_2 ($0.77 in chips) 
Seat 2: perupoquer ($3.60 in chips) 
Seat 3: jpamb ($2.14 in chips) 
Seat 4: _Anagor_AA ($2.59 in chips) 
Seat 5: EggMayo ($1.39 in chips) 
Seat 6: nigel161 ($4.05 in chips) 
perupoquer: posts small blind $0.01
jpamb: posts big blind $0.02
*** HOLE CARDS ***
Dealt to lawlex_2 [As 2h]
_Anagor_AA: raises $0.04 to $0.06
EggMayo: folds 
nigel161: calls $0.06
lawlex_2: folds 
perupoquer: folds 
jpamb: folds 
*** FLOP *** [Jh Th 8s]
_Anagor_AA: checks 
nigel161: checks 
*** TURN *** [Jh Th 8s] [Td]
_Anagor_AA: checks 
nigel161: checks 
*** RIVER *** [Jh Th 8s Td] [6c]
_Anagor_AA: bets $0.02
nigel161: raises $0.02 to $0.04
_Anagor_AA: calls $0.02
*** SHOW DOWN ***
nigel161: shows [Ks 6s] (two pair, Tens and Sixes)
_Anagor_AA: mucks hand 
nigel161 collected $0.22 from pot
*** SUMMARY ***
Total pot $0.23 | Rake $0.01 
Board [Jh Th 8s Td 6c]
Seat 1: lawlex_2 (button) folded before Flop (didn't bet)
Seat 2: perupoquer (small blind) folded before Flop
Seat 3: jpamb (big blind) folded before Flop
Seat 4: _Anagor_AA mucked [4c 4h]
Seat 5: EggMayo folded before Flop (didn't bet)
Seat 6: nigel161 showed [Ks 6s] and won ($0.22) with two pair, Tens and Sixes



PokerStars Hand #213868207644:  Hold'em No Limit ($0.01/$0.02 USD) - 2020/05/14 23:03:52 MSK [2020/05/14 16:03:52 ET]
Table 'Euforbo IV' 6-max Seat #2 is the button
Seat 1: lawlex_2 ($0.77 in chips) 
Seat 2: perupoquer ($3.59 in chips) 
Seat 3: jpamb ($2.12 in chips) 
Seat 4: _Anagor_AA ($2.49 in chips) 
Seat 5: EggMayo ($1.39 in chips) 
Seat 6: nigel161 ($4.17 in chips) 
jpamb: posts small blind $0.01
_Anagor_AA: posts big blind $0.02
*** HOLE CARDS ***
Dealt to lawlex_2 [5h 4d]
EggMayo: folds 
nigel161: calls $0.02
lawlex_2: folds 
perupoquer: calls $0.02
jpamb: folds 
_Anagor_AA: checks 
*** FLOP *** [Kc Td 2d]
_Anagor_AA: bets $0.04
nigel161: calls $0.04
perupoquer: folds 
*** TURN *** [Kc Td 2d] [6c]
_Anagor_AA: bets $0.08
nigel161: calls $0.08
*** RIVER *** [Kc Td 2d 6c] [Tc]
_Anagor_AA: checks 
nigel161: checks 
*** SHOW DOWN ***
_Anagor_AA: shows [5d 3d] (a pair of Tens)
nigel161: shows [Js Kd] (two pair, Kings and Tens)
nigel161 collected $0.30 from pot
*** SUMMARY ***
Total pot $0.31 | Rake $0.01 
Board [Kc Td 2d 6c Tc]
Seat 1: lawlex_2 folded before Flop (didn't bet)
Seat 2: perupoquer (button) folded on the Flop
Seat 3: jpamb (small blind) folded before Flop
Seat 4: _Anagor_AA (big blind) showed [5d 3d] and lost with a pair of Tens
Seat 5: EggMayo folded before Flop (didn't bet)
Seat 6: nigel161 showed [Js Kd] and won ($0.30) with two pair, Kings and Tens



PokerStars Hand #213868258818:  Hold'em No Limit ($0.01/$0.02 USD) - 2020/05/14 23:04:37 MSK [2020/05/14 16:04:37 ET]
Table 'Euforbo IV' 6-max Seat #3 is the button
Seat 1: lawlex_2 ($0.77 in chips) 
Seat 2: perupoquer ($3.57 in chips) 
Seat 3: jpamb ($2.11 in chips) 
Seat 4: _Anagor_AA ($2.35 in chips) 
Seat 5: EggMayo ($1.39 in chips) 
Seat 6: nigel161 ($4.33 in chips) 
_Anagor_AA: posts small blind $0.01
EggMayo: posts big blind $0.02
*** HOLE CARDS ***
Dealt to lawlex_2 [3s Qc]
nigel161: calls $0.02
lawlex_2: folds 
perupoquer: folds 
jpamb: folds 
_Anagor_AA: calls $0.01
EggMayo: checks 
*** FLOP *** [Jc Ts 4d]
_Anagor_AA: bets $0.02
EggMayo: calls $0.02
nigel161: raises $0.02 to $0.04
_Anagor_AA: calls $0.02
EggMayo: calls $0.02
*** TURN *** [Jc Ts 4d] [Jh]
_Anagor_AA: checks 
EggMayo: checks 
nigel161: checks 
*** RIVER *** [Jc Ts 4d Jh] [5d]
_Anagor_AA: bets $0.08
EggMayo: folds 
nigel161: folds 
Uncalled bet ($0.08) returned to _Anagor_AA
_Anagor_AA collected $0.17 from pot
_Anagor_AA: doesn't show hand 
*** SUMMARY ***
Total pot $0.18 | Rake $0.01 
Board [Jc Ts 4d Jh 5d]
Seat 1: lawlex_2 folded before Flop (didn't bet)
Seat 2: perupoquer folded before Flop (didn't bet)
Seat 3: jpamb (button) folded before Flop (didn't bet)
Seat 4: _Anagor_AA (small blind) collected ($0.17)
Seat 5: EggMayo (big blind) folded on the River
Seat 6: nigel161 folded on the River



PokerStars Hand #213868323165:  Hold'em No Limit ($0.01/$0.02 USD) - 2020/05/14 23:05:34 MSK [2020/05/14 16:05:34 ET]
Table 'Euforbo IV' 6-max Seat #4 is the button
Seat 1: lawlex_2 ($0.77 in chips) 
Seat 2: perupoquer ($3.57 in chips) 
Seat 3: jpamb ($2.11 in chips) 
Seat 4: _Anagor_AA ($2.46 in chips) 
Seat 5: EggMayo ($1.33 in chips) 
Seat 6: nigel161 ($4.27 in chips) 
EggMayo: posts small blind $0.01
nigel161: posts big blind $0.02
*** HOLE CARDS ***
Dealt to lawlex_2 [4h 2d]
lawlex_2: folds 
perupoquer: folds 
jpamb: folds 
_Anagor_AA: raises $0.04 to $0.06
EggMayo: folds 
nigel161: calls $0.04
*** FLOP *** [5d Ac 5c]
nigel161: checks 
_Anagor_AA: checks 
*** TURN *** [5d Ac 5c] [Ah]
nigel161: checks 
_Anagor_AA: bets $0.02
nigel161: raises $0.09 to $0.11
_Anagor_AA: folds 
Uncalled bet ($0.09) returned to nigel161
nigel161 collected $0.16 from pot
nigel161: doesn't show hand 
*** SUMMARY ***
Total pot $0.17 | Rake $0.01 
Board [5d Ac 5c Ah]
Seat 1: lawlex_2 folded before Flop (didn't bet)
Seat 2: perupoquer folded before Flop (didn't bet)
Seat 3: jpamb folded before Flop (didn't bet)
Seat 4: _Anagor_AA (button) folded on the Turn
Seat 5: EggMayo (small blind) folded before Flop
Seat 6: nigel161 (big blind) collected ($0.16)



PokerStars Hand #213868383447:  Hold'em No Limit ($0.01/$0.02 USD) - 2020/05/14 23:06:28 MSK [2020/05/14 16:06:28 ET]
Table 'Euforbo IV' 6-max Seat #5 is the button
Seat 1: lawlex_2 ($0.77 in chips) 
Seat 2: perupoquer ($3.57 in chips) 
Seat 3: jpamb ($2.11 in chips) 
Seat 4: _Anagor_AA ($2.38 in chips) 
Seat 5: EggMayo ($1.32 in chips) 
Seat 6: nigel161 ($4.35 in chips) 
nigel161: posts small blind $0.01
lawlex_2: posts big blind $0.02
*** HOLE CARDS ***
Dealt to lawlex_2 [Qc 7s]
perupoquer: folds 
jpamb: raises $0.04 to $0.06
_Anagor_AA: calls $0.06
EggMayo: folds 
nigel161: calls $0.05
lawlex_2: folds 
*** FLOP *** [4c Ac 8h]
nigel161: checks 
jpamb: bets $0.12
_Anagor_AA: raises $0.30 to $0.42
nigel161: folds 
jpamb: calls $0.30
*** TURN *** [4c Ac 8h] [4s]
jpamb: checks 
_Anagor_AA: bets $0.50
jpamb: folds 
Uncalled bet ($0.50) returned to _Anagor_AA
_Anagor_AA collected $1 from pot
_Anagor_AA: doesn't show hand 
*** SUMMARY ***
Total pot $1.04 | Rake $0.04 
Board [4c Ac 8h 4s]
Seat 1: lawlex_2 (big blind) folded before Flop
Seat 2: perupoquer folded before Flop (didn't bet)
Seat 3: jpamb folded on the Turn
Seat 4: _Anagor_AA collected ($1)
Seat 5: EggMayo (button) folded before Flop (didn't bet)
Seat 6: nigel161 (small blind) folded on the Flop



PokerStars Hand #213868496690:  Hold'em No Limit ($0.01/$0.02 USD) - 2020/05/14 23:08:09 MSK [2020/05/14 16:08:09 ET]
Table 'Euforbo IV' 6-max Seat #6 is the button
Seat 1: lawlex_2 ($0.75 in chips) 
Seat 2: perupoquer ($3.57 in chips) 
Seat 3: jpamb ($2 in chips) 
Seat 4: _Anagor_AA ($2.90 in chips) 
Seat 5: EggMayo ($1.32 in chips) 
Seat 6: nigel161 ($4.29 in chips) 
lawlex_2: posts small blind $0.01
perupoquer: posts big blind $0.02
*** HOLE CARDS ***
Dealt to lawlex_2 [9d Kh]
jpamb: raises $0.04 to $0.06
_Anagor_AA: folds 
EggMayo: folds 
nigel161: calls $0.06
lawlex_2: folds 
perupoquer: calls $0.04
*** FLOP *** [Jc 3s 5h]
perupoquer: checks 
jpamb: checks 
nigel161: bets $0.02
perupoquer: raises $0.04 to $0.06
jpamb: folds 
nigel161: calls $0.04
*** TURN *** [Jc 3s 5h] [Ad]
perupoquer: checks 
nigel161: bets $0.10
perupoquer: calls $0.10
*** RIVER *** [Jc 3s 5h Ad] [Ah]
perupoquer: checks 
nigel161: bets $0.10
perupoquer: calls $0.10
*** SHOW DOWN ***
nigel161: shows [Qd Qc] (two pair, Aces and Queens)
perupoquer: mucks hand 
nigel161 collected $0.69 from pot
*** SUMMARY ***
Total pot $0.71 | Rake $0.02 
Board [Jc 3s 5h Ad Ah]
Seat 1: lawlex_2 (small blind) folded before Flop
Seat 2: perupoquer (big blind) mucked [Js 9s]
Seat 3: jpamb folded on the Flop
Seat 4: _Anagor_AA folded before Flop (didn't bet)
Seat 5: EggMayo folded before Flop (didn't bet)
Seat 6: nigel161 (button) showed [Qd Qc] and won ($0.69) with two pair, Aces and Queens



PokerStars Hand #213868568723:  Hold'em No Limit ($0.01/$0.02 USD) - 2020/05/14 23:09:13 MSK [2020/05/14 16:09:13 ET]
Table 'Euforbo IV' 6-max Seat #1 is the button
Seat 1: lawlex_2 ($0.74 in chips) 
Seat 2: perupoquer ($3.25 in chips) 
Seat 3: jpamb ($2 in chips) 
Seat 4: _Anagor_AA ($2.90 in chips) 
Seat 5: EggMayo ($1.32 in chips) 
Seat 6: nigel161 ($4.66 in chips) 
perupoquer: posts small blind $0.01
jpamb: posts big blind $0.02
*** HOLE CARDS ***
Dealt to lawlex_2 [6c Td]
_Anagor_AA: folds 
EggMayo: folds 
nigel161: calls $0.02
lawlex_2: folds 
perupoquer: calls $0.01
jpamb: checks 
*** FLOP *** [Th 9s Qs]
perupoquer: checks 
jpamb: checks 
nigel161: checks 
*** TURN *** [Th 9s Qs] [Jh]
perupoquer: checks 
jpamb: checks 
nigel161: bets $0.10
perupoquer: folds 
jpamb: folds 
Uncalled bet ($0.10) returned to nigel161
nigel161 collected $0.06 from pot
nigel161: doesn't show hand 
*** SUMMARY ***
Total pot $0.06 | Rake $0 
Board [Th 9s Qs Jh]
Seat 1: lawlex_2 (button) folded before Flop (didn't bet)
Seat 2: perupoquer (small blind) folded on the Turn
Seat 3: jpamb (big blind) folded on the Turn
Seat 4: _Anagor_AA folded before Flop (didn't bet)
Seat 5: EggMayo folded before Flop (didn't bet)
Seat 6: nigel161 collected ($0.06)



PokerStars Hand #213868626007:  Hold'em No Limit ($0.01/$0.02 USD) - 2020/05/14 23:10:04 MSK [2020/05/14 16:10:04 ET]
Table 'Euforbo IV' 6-max Seat #2 is the button
Seat 1: lawlex_2 ($0.74 in chips) 
Seat 2: perupoquer ($3.23 in chips) 
Seat 3: jpamb ($2 in chips) 
Seat 4: _Anagor_AA ($2.90 in chips) 
Seat 5: EggMayo ($1.32 in chips) 
Seat 6: nigel161 ($4.70 in chips) 
jpamb: posts small blind $0.01
_Anagor_AA: posts big blind $0.02
*** HOLE CARDS ***
Dealt to lawlex_2 [7d 4h]
EggMayo: folds 
nigel161: calls $0.02
lawlex_2: folds 
perupoquer: calls $0.02
jpamb: folds 
_Anagor_AA: checks 
*** FLOP *** [6c 5h 3c]
_Anagor_AA: checks 
nigel161: checks 
perupoquer: checks 
*** TURN *** [6c 5h 3c] [3s]
_Anagor_AA: bets $0.02
nigel161: folds 
perupoquer: folds 
Uncalled bet ($0.02) returned to _Anagor_AA
_Anagor_AA collected $0.07 from pot
_Anagor_AA: doesn't show hand 
*** SUMMARY ***
Total pot $0.07 | Rake $0 
Board [6c 5h 3c 3s]
Seat 1: lawlex_2 folded before Flop (didn't bet)
Seat 2: perupoquer (button) folded on the Turn
Seat 3: jpamb (small blind) folded before Flop
Seat 4: _Anagor_AA (big blind) collected ($0.07)
Seat 5: EggMayo folded before Flop (didn't bet)
Seat 6: nigel161 folded on the Turn



PokerStars Hand #213868680629:  Hold'em No Limit ($0.01/$0.02 USD) - 2020/05/14 23:10:52 MSK [2020/05/14 16:10:52 ET]
Table 'Euforbo IV' 6-max Seat #3 is the button
Seat 1: lawlex_2 ($0.74 in chips) 
Seat 2: perupoquer ($3.21 in chips) 
Seat 3: jpamb ($2 in chips) 
Seat 4: _Anagor_AA ($2.95 in chips) 
Seat 5: EggMayo ($1.32 in chips) 
Seat 6: nigel161 ($4.68 in chips) 
_Anagor_AA: posts small blind $0.01
EggMayo: posts big blind $0.02
*** HOLE CARDS ***
Dealt to lawlex_2 [2h 8d]
nigel161: calls $0.02
lawlex_2: folds 
perupoquer: folds 
jpamb: folds 
_Anagor_AA: calls $0.01
EggMayo: checks 
*** FLOP *** [5h 2d 4c]
_Anagor_AA: bets $0.02
EggMayo: calls $0.02
nigel161: raises $0.02 to $0.04
_Anagor_AA: calls $0.02
EggMayo: folds 
*** TURN *** [5h 2d 4c] [3d]
_Anagor_AA: checks 
nigel161: bets $0.06
_Anagor_AA: calls $0.06
*** RIVER *** [5h 2d 4c 3d] [8s]
_Anagor_AA: checks 
nigel161: bets $0.08
_Anagor_AA: calls $0.08
*** SHOW DOWN ***
nigel161: shows [3s 3c] (three of a kind, Threes)
_Anagor_AA: mucks hand 
nigel161 collected $0.42 from pot
*** SUMMARY ***
Total pot $0.44 | Rake $0.02 
Board [5h 2d 4c 3d 8s]
Seat 1: lawlex_2 folded before Flop (didn't bet)
Seat 2: perupoquer folded before Flop (didn't bet)
Seat 3: jpamb (button) folded before Flop (didn't bet)
Seat 4: _Anagor_AA (small blind) mucked [Td 5d]
Seat 5: EggMayo (big blind) folded on the Flop
Seat 6: nigel161 showed [3s 3c] and won ($0.42) with three of a kind, Threes



PokerStars Hand #213868772258:  Hold'em No Limit ($0.01/$0.02 USD) - 2020/05/14 23:12:13 MSK [2020/05/14 16:12:13 ET]
Table 'Euforbo IV' 6-max Seat #4 is the button
Seat 1: lawlex_2 ($0.74 in chips) 
Seat 2: perupoquer ($3.21 in chips) 
Seat 3: jpamb ($2 in chips) 
Seat 4: _Anagor_AA ($2.75 in chips) 
Seat 5: EggMayo ($1.28 in chips) 
Seat 6: nigel161 ($4.90 in chips) 
EggMayo: posts small blind $0.01
nigel161: posts big blind $0.02
*** HOLE CARDS ***
Dealt to lawlex_2 [6h 8h]
lawlex_2: folds 
perupoquer: folds 
jpamb: folds 
_Anagor_AA: raises $0.04 to $0.06
EggMayo: folds 
nigel161: calls $0.04
*** FLOP *** [Jh Qc 3h]
nigel161: checks 
_Anagor_AA: checks 
*** TURN *** [Jh Qc 3h] [Qd]
nigel161: checks 
_Anagor_AA: checks 
*** RIVER *** [Jh Qc 3h Qd] [Qh]
nigel161: checks 
_Anagor_AA: bets $0.06
nigel161: calls $0.06
*** SHOW DOWN ***
_Anagor_AA: shows [2d 2c] (a full house, Queens full of Deuces)
nigel161: shows [3c 8d] (a full house, Queens full of Threes)
nigel161 collected $0.24 from pot
*** SUMMARY ***
Total pot $0.25 | Rake $0.01 
Board [Jh Qc 3h Qd Qh]
Seat 1: lawlex_2 folded before Flop (didn't bet)
Seat 2: perupoquer folded before Flop (didn't bet)
Seat 3: jpamb folded before Flop (didn't bet)
Seat 4: _Anagor_AA (button) showed [2d 2c] and lost with a full house, Queens full of Deuces
Seat 5: EggMayo (small blind) folded before Flop
Seat 6: nigel161 (big blind) showed [3c 8d] and won ($0.24) with a full house, Queens full of Threes



PokerStars Hand #213868818499:  Hold'em No Limit ($0.01/$0.02 USD) - 2020/05/14 23:12:54 MSK [2020/05/14 16:12:54 ET]
Table 'Euforbo IV' 6-max Seat #5 is the button
Seat 1: lawlex_2 ($0.74 in chips) 
Seat 2: perupoquer ($3.21 in chips) 
Seat 3: jpamb ($2 in chips) 
Seat 4: _Anagor_AA ($2.63 in chips) 
Seat 5: EggMayo ($1.27 in chips) 
Seat 6: nigel161 ($5.02 in chips) 
nigel161: posts small blind $0.01
lawlex_2: posts big blind $0.02
*** HOLE CARDS ***
Dealt to lawlex_2 [2h Kh]
perupoquer: raises $0.02 to $0.04
jpamb: folds 
_Anagor_AA: raises $0.02 to $0.06
EggMayo: folds 
nigel161: calls $0.05
lawlex_2: folds 
perupoquer: calls $0.02
*** FLOP *** [8h Kd 3d]
nigel161: checks 
perupoquer: checks 
_Anagor_AA: checks 
*** TURN *** [8h Kd 3d] [3s]
nigel161: checks 
perupoquer: bets $0.05
_Anagor_AA: calls $0.05
nigel161: folds 
*** RIVER *** [8h Kd 3d 3s] [4d]
perupoquer: bets $0.16
_Anagor_AA: calls $0.16
*** SHOW DOWN ***
perupoquer: shows [Qd 5d] (a flush, King high)
_Anagor_AA: mucks hand 
perupoquer collected $0.60 from pot
*** SUMMARY ***
Total pot $0.62 | Rake $0.02 
Board [8h Kd 3d 3s 4d]
Seat 1: lawlex_2 (big blind) folded before Flop
Seat 2: perupoquer showed [Qd 5d] and won ($0.60) with a flush, King high
Seat 3: jpamb folded before Flop (didn't bet)
Seat 4: _Anagor_AA mucked [9c 8c]
Seat 5: EggMayo (button) folded before Flop (didn't bet)
Seat 6: nigel161 (small blind) folded on the Turn



PokerStars Hand #213868883553:  Hold'em No Limit ($0.01/$0.02 USD) - 2020/05/14 23:13:53 MSK [2020/05/14 16:13:53 ET]
Table 'Euforbo IV' 6-max Seat #6 is the button
Seat 1: lawlex_2 ($0.72 in chips) 
Seat 2: perupoquer ($3.54 in chips) 
Seat 3: jpamb ($2 in chips) 
Seat 4: _Anagor_AA ($2.36 in chips) 
Seat 5: EggMayo ($1.27 in chips) 
Seat 6: nigel161 ($4.96 in chips) 
lawlex_2: posts small blind $0.01
perupoquer: posts big blind $0.02
*** HOLE CARDS ***
Dealt to lawlex_2 [2s 3c]
jpamb: folds 
_Anagor_AA: folds 
EggMayo: folds 
nigel161: calls $0.02
lawlex_2: folds 
perupoquer: checks 
*** FLOP *** [Ks Ad 3d]
perupoquer: checks 
nigel161: checks 
*** TURN *** [Ks Ad 3d] [7s]
perupoquer: bets $0.02
nigel161: calls $0.02
*** RIVER *** [Ks Ad 3d 7s] [8d]
perupoquer: bets $0.04
nigel161: folds 
Uncalled bet ($0.04) returned to perupoquer
perupoquer collected $0.09 from pot
perupoquer: doesn't show hand 
*** SUMMARY ***
Total pot $0.09 | Rake $0 
Board [Ks Ad 3d 7s 8d]
Seat 1: lawlex_2 (small blind) folded before Flop
Seat 2: perupoquer (big blind) collected ($0.09)
Seat 3: jpamb folded before Flop (didn't bet)
Seat 4: _Anagor_AA folded before Flop (didn't bet)
Seat 5: EggMayo folded before Flop (didn't bet)
Seat 6: nigel161 (button) folded on the River



PokerStars Hand #213868949393:  Hold'em No Limit ($0.01/$0.02 USD) - 2020/05/14 23:14:43 MSK [2020/05/14 16:14:43 ET]
Table 'Euforbo IV' 6-max Seat #1 is the button
Seat 1: lawlex_2 ($0.71 in chips) 
Seat 2: perupoquer ($3.59 in chips) 
Seat 3: jpamb ($2 in chips) 
Seat 4: _Anagor_AA ($2.36 in chips) 
Seat 5: EggMayo ($1.27 in chips) 
Seat 6: nigel161 ($4.92 in chips) 
perupoquer: posts small blind $0.01
jpamb: posts big blind $0.02
*** HOLE CARDS ***
Dealt to lawlex_2 [4s 2c]
_Anagor_AA: folds 
EggMayo: folds 
nigel161: calls $0.02
lawlex_2: folds 
perupoquer: folds 
jpamb: checks 
*** FLOP *** [9s Td Kc]
jpamb: checks 
nigel161: checks 
*** TURN *** [9s Td Kc] [Jd]
jpamb: checks 
nigel161: checks 
*** RIVER *** [9s Td Kc Jd] [As]
jpamb: checks 
nigel161: checks 
*** SHOW DOWN ***
jpamb: shows [6c 8c] (high card Ace)
nigel161: shows [7s 9h] (a pair of Nines)
nigel161 collected $0.05 from pot
*** SUMMARY ***
Total pot $0.05 | Rake $0 
Board [9s Td Kc Jd As]
Seat 1: lawlex_2 (button) folded before Flop (didn't bet)
Seat 2: perupoquer (small blind) folded before Flop
Seat 3: jpamb (big blind) showed [6c 8c] and lost with high card Ace
Seat 4: _Anagor_AA folded before Flop (didn't bet)
Seat 5: EggMayo folded before Flop (didn't bet)
Seat 6: nigel161 showed [7s 9h] and won ($0.05) with a pair of Nines



PokerStars Hand #213868992374:  Hold'em No Limit ($0.01/$0.02 USD) - 2020/05/14 23:15:20 MSK [2020/05/14 16:15:20 ET]
Table 'Euforbo IV' 6-max Seat #2 is the button
Seat 1: lawlex_2 ($0.71 in chips) 
Seat 2: perupoquer ($3.58 in chips) 
Seat 3: jpamb ($2 in chips) 
Seat 4: _Anagor_AA ($2.36 in chips) 
Seat 5: EggMayo ($1.27 in chips) 
Seat 6: nigel161 ($4.95 in chips) 
jpamb: posts small blind $0.01
_Anagor_AA: posts big blind $0.02
*** HOLE CARDS ***
Dealt to lawlex_2 [3s Kc]
EggMayo: folds 
nigel161: calls $0.02
lawlex_2: folds 
perupoquer: folds 
jpamb: folds 
_Anagor_AA: checks 
*** FLOP *** [6c 8h As]
_Anagor_AA: checks 
nigel161: checks 
*** TURN *** [6c 8h As] [7c]
_Anagor_AA: bets $0.04
nigel161: folds 
Uncalled bet ($0.04) returned to _Anagor_AA
_Anagor_AA collected $0.05 from pot
_Anagor_AA: doesn't show hand 
*** SUMMARY ***
Total pot $0.05 | Rake $0 
Board [6c 8h As 7c]
Seat 1: lawlex_2 folded before Flop (didn't bet)
Seat 2: perupoquer (button) folded before Flop (didn't bet)
Seat 3: jpamb (small blind) folded before Flop
Seat 4: _Anagor_AA (big blind) collected ($0.05)
Seat 5: EggMayo folded before Flop (didn't bet)
Seat 6: nigel161 folded on the Turn



PokerStars Hand #213869030483:  Hold'em No Limit ($0.01/$0.02 USD) - 2020/05/14 23:15:54 MSK [2020/05/14 16:15:54 ET]
Table 'Euforbo IV' 6-max Seat #3 is the button
Seat 1: lawlex_2 ($0.71 in chips) 
Seat 2: perupoquer ($3.58 in chips) 
Seat 3: jpamb ($2 in chips) 
Seat 4: _Anagor_AA ($2.39 in chips) 
Seat 5: EggMayo ($1.27 in chips) 
Seat 6: nigel161 ($4.93 in chips) 
_Anagor_AA: posts small blind $0.01
EggMayo: posts big blind $0.02
*** HOLE CARDS ***
Dealt to lawlex_2 [7s 2d]
nigel161: calls $0.02
lawlex_2: folds 
perupoquer: calls $0.02
jpamb: folds 
_Anagor_AA: calls $0.01
EggMayo: checks 
*** FLOP *** [8h 7c 4c]
_Anagor_AA: bets $0.04
EggMayo: folds 
nigel161: calls $0.04
perupoquer: calls $0.04
*** TURN *** [8h 7c 4c] [Qc]
_Anagor_AA: checks 
nigel161: bets $0.06
perupoquer: folds 
_Anagor_AA: calls $0.06
*** RIVER *** [8h 7c 4c Qc] [6c]
_Anagor_AA: checks 
nigel161: bets $0.10
_Anagor_AA: calls $0.10
*** SHOW DOWN ***
nigel161: shows [Jc 5c] (a flush, Queen high)
_Anagor_AA: mucks hand 
nigel161 collected $0.50 from pot
*** SUMMARY ***
Total pot $0.52 | Rake $0.02 
Board [8h 7c 4c Qc 6c]
Seat 1: lawlex_2 folded before Flop (didn't bet)
Seat 2: perupoquer folded on the Turn
Seat 3: jpamb (button) folded before Flop (didn't bet)
Seat 4: _Anagor_AA (small blind) mucked [7h 8c]
Seat 5: EggMayo (big blind) folded on the Flop
Seat 6: nigel161 showed [Jc 5c] and won ($0.50) with a flush, Queen high



PokerStars Hand #213869106064:  Hold'em No Limit ($0.01/$0.02 USD) - 2020/05/14 23:16:59 MSK [2020/05/14 16:16:59 ET]
Table 'Euforbo IV' 6-max Seat #4 is the button
Seat 1: lawlex_2 ($0.71 in chips) 
Seat 2: perupoquer ($3.52 in chips) 
Seat 3: jpamb ($2 in chips) 
Seat 4: _Anagor_AA ($2.17 in chips) 
Seat 5: EggMayo ($1.25 in chips) 
Seat 6: nigel161 ($5.21 in chips) 
EggMayo: posts small blind $0.01
nigel161: posts big blind $0.02
*** HOLE CARDS ***
Dealt to lawlex_2 [6s Kh]
lawlex_2: folds 
perupoquer: folds 
jpamb: folds 
_Anagor_AA: folds 
EggMayo: raises $0.04 to $0.06
nigel161: calls $0.04
*** FLOP *** [4h 2c Qs]
EggMayo: checks 
nigel161: checks 
*** TURN *** [4h 2c Qs] [9h]
EggMayo: checks 
nigel161: checks 
*** RIVER *** [4h 2c Qs 9h] [As]
EggMayo: checks 
nigel161: checks 
*** SHOW DOWN ***
EggMayo: shows [8c Qc] (a pair of Queens)
nigel161: mucks hand 
EggMayo collected $0.12 from pot
*** SUMMARY ***
Total pot $0.12 | Rake $0 
Board [4h 2c Qs 9h As]
Seat 1: lawlex_2 folded before Flop (didn't bet)
Seat 2: perupoquer folded before Flop (didn't bet)
Seat 3: jpamb folded before Flop (didn't bet)
Seat 4: _Anagor_AA (button) folded before Flop (didn't bet)
Seat 5: EggMayo (small blind) showed [8c Qc] and won ($0.12) with a pair of Queens
Seat 6: nigel161 (big blind) mucked [7d 3s]



PokerStars Hand #213869167457:  Hold'em No Limit ($0.01/$0.02 USD) - 2020/05/14 23:17:52 MSK [2020/05/14 16:17:52 ET]
Table 'Euforbo IV' 6-max Seat #5 is the button
Seat 1: lawlex_2 ($0.71 in chips) 
Seat 2: perupoquer ($3.52 in chips) 
Seat 3: jpamb ($2 in chips) 
Seat 4: _Anagor_AA ($2.17 in chips) 
Seat 5: EggMayo ($1.31 in chips) 
Seat 6: nigel161 ($5.15 in chips) 
nigel161: posts small blind $0.01
lawlex_2: posts big blind $0.02
*** HOLE CARDS ***
Dealt to lawlex_2 [5h Jh]
perupoquer has timed out
perupoquer: folds 
jpamb: folds 
_Anagor_AA: raises $0.04 to $0.06
EggMayo: raises $0.15 to $0.21
nigel161: folds 
lawlex_2: folds 
_Anagor_AA: calls $0.15
*** FLOP *** [Qh Jc 6c]
_Anagor_AA: checks 
EggMayo: bets $0.14
_Anagor_AA: folds 
Uncalled bet ($0.14) returned to EggMayo
EggMayo collected $0.43 from pot
EggMayo: doesn't show hand 
*** SUMMARY ***
Total pot $0.45 | Rake $0.02 
Board [Qh Jc 6c]
Seat 1: lawlex_2 (big blind) folded before Flop
Seat 2: perupoquer folded before Flop (didn't bet)
Seat 3: jpamb folded before Flop (didn't bet)
Seat 4: _Anagor_AA folded on the Flop
Seat 5: EggMayo (button) collected ($0.43)
Seat 6: nigel161 (small blind) folded before Flop



PokerStars Hand #213869214840:  Hold'em No Limit ($0.01/$0.02 USD) - 2020/05/14 23:18:33 MSK [2020/05/14 16:18:33 ET]
Table 'Euforbo IV' 6-max Seat #6 is the button
Seat 1: lawlex_2 ($0.69 in chips) 
Seat 2: perupoquer ($3.52 in chips) 
Seat 3: jpamb ($2 in chips) 
Seat 4: _Anagor_AA ($1.96 in chips) 
Seat 5: EggMayo ($1.53 in chips) 
Seat 6: nigel161 ($5.14 in chips) 
lawlex_2: posts small blind $0.01
perupoquer: posts big blind $0.02
*** HOLE CARDS ***
Dealt to lawlex_2 [Jc Qh]
jpamb: folds 
_Anagor_AA: raises $0.04 to $0.06
EggMayo: folds 
nigel161: calls $0.06
lawlex_2: folds 
perupoquer: calls $0.04
*** FLOP *** [8d 2s 6s]
perupoquer: checks 
_Anagor_AA: bets $0.18
nigel161: folds 
perupoquer: folds 
Uncalled bet ($0.18) returned to _Anagor_AA
_Anagor_AA collected $0.18 from pot
_Anagor_AA: doesn't show hand 
*** SUMMARY ***
Total pot $0.19 | Rake $0.01 
Board [8d 2s 6s]
Seat 1: lawlex_2 (small blind) folded before Flop
Seat 2: perupoquer (big blind) folded on the Flop
Seat 3: jpamb folded before Flop (didn't bet)
Seat 4: _Anagor_AA collected ($0.18)
Seat 5: EggMayo folded before Flop (didn't bet)
Seat 6: nigel161 (button) folded on the Flop



PokerStars Hand #213869240234:  Hold'em No Limit ($0.01/$0.02 USD) - 2020/05/14 23:18:55 MSK [2020/05/14 16:18:55 ET]
Table 'Euforbo IV' 6-max Seat #1 is the button
Seat 1: lawlex_2 ($0.68 in chips) 
Seat 2: perupoquer ($3.46 in chips) 
Seat 3: jpamb ($2 in chips) 
Seat 4: _Anagor_AA ($2.08 in chips) 
Seat 5: EggMayo ($1.53 in chips) 
Seat 6: nigel161 ($5.08 in chips) 
perupoquer: posts small blind $0.01
jpamb: posts big blind $0.02
*** HOLE CARDS ***
Dealt to lawlex_2 [2c 5c]
_Anagor_AA: raises $0.04 to $0.06
EggMayo: folds 
nigel161: calls $0.06
lawlex_2: folds 
perupoquer: folds 
jpamb: folds 
*** FLOP *** [6h Th Jc]
_Anagor_AA: bets $0.14
nigel161: calls $0.14
*** TURN *** [6h Th Jc] [4h]
_Anagor_AA: bets $0.20
nigel161: folds 
Uncalled bet ($0.20) returned to _Anagor_AA
_Anagor_AA collected $0.41 from pot
_Anagor_AA: doesn't show hand 
*** SUMMARY ***
Total pot $0.43 | Rake $0.02 
Board [6h Th Jc 4h]
Seat 1: lawlex_2 (button) folded before Flop (didn't bet)
Seat 2: perupoquer (small blind) folded before Flop
Seat 3: jpamb (big blind) folded before Flop
Seat 4: _Anagor_AA collected ($0.41)
Seat 5: EggMayo folded before Flop (didn't bet)
Seat 6: nigel161 folded on the Turn



PokerStars Hand #213869276089:  Hold'em No Limit ($0.01/$0.02 USD) - 2020/05/14 23:19:26 MSK [2020/05/14 16:19:26 ET]
Table 'Euforbo IV' 6-max Seat #2 is the button
Seat 1: lawlex_2 ($0.68 in chips) 
Seat 2: perupoquer ($3.45 in chips) 
Seat 3: jpamb ($2 in chips) 
Seat 4: _Anagor_AA ($2.29 in chips) 
Seat 5: EggMayo ($1.53 in chips) 
Seat 6: nigel161 ($4.88 in chips) 
jpamb: posts small blind $0.01
_Anagor_AA: posts big blind $0.02
*** HOLE CARDS ***
Dealt to lawlex_2 [8s 4s]
EggMayo: folds 
nigel161: calls $0.02
lawlex_2: folds 
perupoquer: calls $0.02
jpamb: folds 
_Anagor_AA: checks 
*** FLOP *** [As 2h Qh]
_Anagor_AA: checks 
nigel161: checks 
perupoquer: bets $0.04
_Anagor_AA: folds 
nigel161: calls $0.04
*** TURN *** [As 2h Qh] [Qc]
nigel161: checks 
perupoquer: checks 
*** RIVER *** [As 2h Qh Qc] [6h]
nigel161: bets $0.10
perupoquer: calls $0.10
*** SHOW DOWN ***
nigel161: shows [2d Ad] (two pair, Aces and Queens)
perupoquer: shows [Js Ac] (two pair, Aces and Queens - Jack kicker)
perupoquer collected $0.34 from pot
*** SUMMARY ***
Total pot $0.35 | Rake $0.01 
Board [As 2h Qh Qc 6h]
Seat 1: lawlex_2 folded before Flop (didn't bet)
Seat 2: perupoquer (button) showed [Js Ac] and won ($0.34) with two pair, Aces and Queens
Seat 3: jpamb (small blind) folded before Flop
Seat 4: _Anagor_AA (big blind) folded on the Flop
Seat 5: EggMayo folded before Flop (didn't bet)
Seat 6: nigel161 showed [2d Ad] and lost with two pair, Aces and Queens



PokerStars Hand #213869338492:  Hold'em No Limit ($0.01/$0.02 USD) - 2020/05/14 23:20:20 MSK [2020/05/14 16:20:20 ET]
Table 'Euforbo IV' 6-max Seat #3 is the button
Seat 1: lawlex_2 ($0.68 in chips) 
Seat 2: perupoquer ($3.63 in chips) 
Seat 3: jpamb ($2 in chips) 
Seat 4: _Anagor_AA ($2.27 in chips) 
Seat 5: EggMayo ($1.53 in chips) 
Seat 6: nigel161 ($4.72 in chips) 
_Anagor_AA: posts small blind $0.01
EggMayo: posts big blind $0.02
*** HOLE CARDS ***
Dealt to lawlex_2 [Jh Ad]
nigel161: folds 
lawlex_2: raises $0.03 to $0.05
perupoquer: folds 
jpamb: folds 
_Anagor_AA: folds 
EggMayo: calls $0.03
*** FLOP *** [4h Js 6s]
EggMayo: checks 
lawlex_2: bets $0.07
EggMayo: folds 
Uncalled bet ($0.07) returned to lawlex_2
lawlex_2 collected $0.11 from pot
lawlex_2: doesn't show hand 
*** SUMMARY ***
Total pot $0.11 | Rake $0 
Board [4h Js 6s]
Seat 1: lawlex_2 collected ($0.11)
Seat 2: perupoquer folded before Flop (didn't bet)
Seat 3: jpamb (button) folded before Flop (didn't bet)
Seat 4: _Anagor_AA (small blind) folded before Flop
Seat 5: EggMayo (big blind) folded on the Flop
Seat 6: nigel161 folded before Flop (didn't bet)



PokerStars Hand #213869369827:  Hold'em No Limit ($0.01/$0.02 USD) - 2020/05/14 23:20:47 MSK [2020/05/14 16:20:47 ET]
Table 'Euforbo IV' 6-max Seat #4 is the button
Seat 1: lawlex_2 ($0.74 in chips) 
Seat 2: perupoquer ($3.63 in chips) 
Seat 3: jpamb ($2 in chips) 
Seat 4: _Anagor_AA ($2.26 in chips) 
Seat 5: EggMayo ($1.48 in chips) 
Seat 6: nigel161 ($4.72 in chips) 
EggMayo: posts small blind $0.01
nigel161: posts big blind $0.02
*** HOLE CARDS ***
Dealt to lawlex_2 [Ac Jc]
lawlex_2: raises $0.03 to $0.05
perupoquer: folds 
jpamb: calls $0.05
_Anagor_AA: folds 
EggMayo: folds 
nigel161: calls $0.03
*** FLOP *** [8s 9s 9h]
nigel161: checks 
lawlex_2: bets $0.10
jpamb: folds 
nigel161: folds 
Uncalled bet ($0.10) returned to lawlex_2
lawlex_2 collected $0.15 from pot
lawlex_2: doesn't show hand 
*** SUMMARY ***
Total pot $0.16 | Rake $0.01 
Board [8s 9s 9h]
Seat 1: lawlex_2 collected ($0.15)
Seat 2: perupoquer folded before Flop (didn't bet)
Seat 3: jpamb folded on the Flop
Seat 4: _Anagor_AA (button) folded before Flop (didn't bet)
Seat 5: EggMayo (small blind) folded before Flop
Seat 6: nigel161 (big blind) folded on the Flop



PokerStars Hand #213869400711:  Hold'em No Limit ($0.01/$0.02 USD) - 2020/05/14 23:21:14 MSK [2020/05/14 16:21:14 ET]
Table 'Euforbo IV' 6-max Seat #5 is the button
Seat 1: lawlex_2 ($0.84 in chips) 
Seat 2: perupoquer ($3.63 in chips) 
Seat 3: jpamb ($2 in chips) 
Seat 4: _Anagor_AA ($2.26 in chips) 
Seat 5: EggMayo ($1.47 in chips) 
Seat 6: nigel161 ($4.67 in chips) 
nigel161: posts small blind $0.01
lawlex_2: posts big blind $0.02
*** HOLE CARDS ***
Dealt to lawlex_2 [Ah Qs]
perupoquer: folds 
jpamb: folds 
_Anagor_AA: raises $0.04 to $0.06
EggMayo: folds 
nigel161: calls $0.05
lawlex_2: calls $0.04
*** FLOP *** [2c Ad 7c]
nigel161: checks 
lawlex_2: bets $0.11
_Anagor_AA: folds 
nigel161: calls $0.11
*** TURN *** [2c Ad 7c] [Jc]
nigel161: checks 
lawlex_2: bets $0.26
nigel161: folds 
Uncalled bet ($0.26) returned to lawlex_2
lawlex_2 collected $0.39 from pot
lawlex_2: doesn't show hand 
*** SUMMARY ***
Total pot $0.40 | Rake $0.01 
Board [2c Ad 7c Jc]
Seat 1: lawlex_2 (big blind) collected ($0.39)
Seat 2: perupoquer folded before Flop (didn't bet)
Seat 3: jpamb folded before Flop (didn't bet)
Seat 4: _Anagor_AA folded on the Flop
Seat 5: EggMayo (button) folded before Flop (didn't bet)
Seat 6: nigel161 (small blind) folded on the Turn



PokerStars Hand #213869461881:  Hold'em No Limit ($0.01/$0.02 USD) - 2020/05/14 23:22:07 MSK [2020/05/14 16:22:07 ET]
Table 'Euforbo IV' 6-max Seat #6 is the button
Seat 1: lawlex_2 ($1.06 in chips) 
Seat 2: perupoquer ($3.63 in chips) 
Seat 3: jpamb ($2 in chips) 
Seat 4: _Anagor_AA ($2.20 in chips) 
Seat 5: EggMayo ($1.47 in chips) 
Seat 6: nigel161 ($4.50 in chips) 
lawlex_2: posts small blind $0.01
perupoquer: posts big blind $0.02
*** HOLE CARDS ***
Dealt to lawlex_2 [7s Ah]
jpamb: folds 
_Anagor_AA: folds 
EggMayo: folds 
nigel161: folds 
lawlex_2: folds 
Uncalled bet ($0.01) returned to perupoquer
perupoquer collected $0.02 from pot
*** SUMMARY ***
Total pot $0.02 | Rake $0 
Seat 1: lawlex_2 (small blind) folded before Flop
Seat 2: perupoquer (big blind) collected ($0.02)
Seat 3: jpamb folded before Flop (didn't bet)
Seat 4: _Anagor_AA folded before Flop (didn't bet)
Seat 5: EggMayo folded before Flop (didn't bet)
Seat 6: nigel161 (button) folded before Flop (didn't bet)



PokerStars Hand #213869473836:  Hold'em No Limit ($0.01/$0.02 USD) - 2020/05/14 23:22:18 MSK [2020/05/14 16:22:18 ET]
Table 'Euforbo IV' 6-max Seat #1 is the button
Seat 1: lawlex_2 ($1.05 in chips) 
Seat 2: perupoquer ($3.64 in chips) 
Seat 3: jpamb ($2 in chips) 
Seat 4: _Anagor_AA ($2.20 in chips) 
Seat 5: EggMayo ($1.47 in chips) 
Seat 6: nigel161 ($4.50 in chips) 
perupoquer: posts small blind $0.01
jpamb: posts big blind $0.02
*** HOLE CARDS ***
Dealt to lawlex_2 [3c 5s]
_Anagor_AA: folds 
EggMayo: folds 
nigel161: folds 
lawlex_2: folds 
perupoquer: calls $0.01
jpamb: checks 
*** FLOP *** [7s Jh Th]
perupoquer: checks 
jpamb: checks 
*** TURN *** [7s Jh Th] [Td]
perupoquer: bets $0.02
jpamb: raises $0.08 to $0.10
perupoquer: folds 
Uncalled bet ($0.08) returned to jpamb
jpamb collected $0.08 from pot
jpamb: doesn't show hand 
*** SUMMARY ***
Total pot $0.08 | Rake $0 
Board [7s Jh Th Td]
Seat 1: lawlex_2 (button) folded before Flop (didn't bet)
Seat 2: perupoquer (small blind) folded on the Turn
Seat 3: jpamb (big blind) collected ($0.08)
Seat 4: _Anagor_AA folded before Flop (didn't bet)
Seat 5: EggMayo folded before Flop (didn't bet)
Seat 6: nigel161 folded before Flop (didn't bet)



PokerStars Hand #213869516098:  Hold'em No Limit ($0.01/$0.02 USD) - 2020/05/14 23:22:54 MSK [2020/05/14 16:22:54 ET]
Table 'Euforbo IV' 6-max Seat #2 is the button
Seat 1: lawlex_2 ($1.05 in chips) 
Seat 2: perupoquer ($3.60 in chips) 
Seat 3: jpamb ($2.04 in chips) 
Seat 4: _Anagor_AA ($2.20 in chips) 
Seat 5: EggMayo ($1.47 in chips) 
Seat 6: nigel161 ($4.50 in chips) 
jpamb: posts small blind $0.01
_Anagor_AA: posts big blind $0.02
*** HOLE CARDS ***
Dealt to lawlex_2 [8h Ah]
EggMayo: folds 
nigel161: calls $0.02
lawlex_2: raises $0.03 to $0.05
perupoquer: folds 
jpamb: calls $0.04
_Anagor_AA: calls $0.03
nigel161: calls $0.03
*** FLOP *** [6c Ac 7d]
jpamb: checks 
_Anagor_AA: checks 
nigel161: checks 
lawlex_2: bets $0.13
jpamb: folds 
_Anagor_AA: folds 
nigel161: calls $0.13
*** TURN *** [6c Ac 7d] [Td]
nigel161: checks 
lawlex_2: bets $0.29
nigel161: calls $0.29
*** RIVER *** [6c Ac 7d Td] [3s]
nigel161: bets $0.18
lawlex_2: calls $0.18
*** SHOW DOWN ***
nigel161: shows [Kc Tc] (a pair of Tens)
lawlex_2: shows [8h Ah] (a pair of Aces)
lawlex_2 collected $1.35 from pot
*** SUMMARY ***
Total pot $1.40 | Rake $0.05 
Board [6c Ac 7d Td 3s]
Seat 1: lawlex_2 showed [8h Ah] and won ($1.35) with a pair of Aces
Seat 2: perupoquer (button) folded before Flop (didn't bet)
Seat 3: jpamb (small blind) folded on the Flop
Seat 4: _Anagor_AA (big blind) folded on the Flop
Seat 5: EggMayo folded before Flop (didn't bet)
Seat 6: nigel161 showed [Kc Tc] and lost with a pair of Tens



PokerStars Hand #213869583821:  Hold'em No Limit ($0.01/$0.02 USD) - 2020/05/14 23:23:53 MSK [2020/05/14 16:23:53 ET]
Table 'Euforbo IV' 6-max Seat #3 is the button
Seat 1: lawlex_2 ($1.75 in chips) 
Seat 2: perupoquer ($3.60 in chips) 
Seat 3: jpamb ($2 in chips) 
Seat 4: _Anagor_AA ($2.15 in chips) 
Seat 5: EggMayo ($1.47 in chips) 
Seat 6: nigel161 ($3.85 in chips) 
_Anagor_AA: posts small blind $0.01
EggMayo: posts big blind $0.02
*** HOLE CARDS ***
Dealt to lawlex_2 [4c Kd]
nigel161: folds 
lawlex_2: folds 
perupoquer: raises $0.02 to $0.04
jpamb: folds 
_Anagor_AA: raises $0.16 to $0.20
EggMayo: folds 
perupoquer: folds 
Uncalled bet ($0.16) returned to _Anagor_AA
_Anagor_AA collected $0.10 from pot
_Anagor_AA: doesn't show hand 
*** SUMMARY ***
Total pot $0.10 | Rake $0 
Seat 1: lawlex_2 folded before Flop (didn't bet)
Seat 2: perupoquer folded before Flop
Seat 3: jpamb (button) folded before Flop (didn't bet)
Seat 4: _Anagor_AA (small blind) collected ($0.10)
Seat 5: EggMayo (big blind) folded before Flop
Seat 6: nigel161 folded before Flop (didn't bet)



PokerStars Hand #213869617778:  Hold'em No Limit ($0.01/$0.02 USD) - 2020/05/14 23:24:23 MSK [2020/05/14 16:24:23 ET]
Table 'Euforbo IV' 6-max Seat #4 is the button
Seat 1: lawlex_2 ($1.75 in chips) 
Seat 2: perupoquer ($3.56 in chips) 
Seat 3: jpamb ($2 in chips) 
Seat 4: _Anagor_AA ($2.21 in chips) 
Seat 5: EggMayo ($1.45 in chips) 
Seat 6: nigel161 ($3.85 in chips) 
EggMayo: posts small blind $0.01
nigel161: posts big blind $0.02
*** HOLE CARDS ***
Dealt to lawlex_2 [8c 6d]
lawlex_2: folds 
perupoquer: folds 
jpamb: folds 
_Anagor_AA: raises $0.04 to $0.06
EggMayo: folds 
nigel161: calls $0.04
*** FLOP *** [Qh 3h 7d]
nigel161: checks 
_Anagor_AA: bets $0.10
nigel161: calls $0.10
*** TURN *** [Qh 3h 7d] [8s]
nigel161: checks 
_Anagor_AA: bets $0.32
nigel161: calls $0.32
*** RIVER *** [Qh 3h 7d 8s] [Js]
nigel161: checks 
_Anagor_AA: checks 
*** SHOW DOWN ***
nigel161: shows [3s Qd] (two pair, Queens and Threes)
_Anagor_AA: mucks hand 
nigel161 collected $0.94 from pot
*** SUMMARY ***
Total pot $0.97 | Rake $0.03 
Board [Qh 3h 7d 8s Js]
Seat 1: lawlex_2 folded before Flop (didn't bet)
Seat 2: perupoquer folded before Flop (didn't bet)
Seat 3: jpamb folded before Flop (didn't bet)
Seat 4: _Anagor_AA (button) mucked [6c Ad]
Seat 5: EggMayo (small blind) folded before Flop
Seat 6: nigel161 (big blind) showed [3s Qd] and won ($0.94) with two pair, Queens and Threes



PokerStars Hand #213869690987:  Hold'em No Limit ($0.01/$0.02 USD) - 2020/05/14 23:25:26 MSK [2020/05/14 16:25:26 ET]
Table 'Euforbo IV' 6-max Seat #5 is the button
Seat 1: lawlex_2 ($1.75 in chips) 
Seat 2: perupoquer ($3.56 in chips) 
Seat 3: jpamb ($2 in chips) 
Seat 4: _Anagor_AA ($1.73 in chips) 
Seat 5: EggMayo ($1.44 in chips) 
Seat 6: nigel161 ($4.31 in chips) 
nigel161: posts small blind $0.01
lawlex_2: posts big blind $0.02
*** HOLE CARDS ***
Dealt to lawlex_2 [Ad 5s]
perupoquer: raises $0.02 to $0.04
jpamb: folds 
_Anagor_AA: calls $0.04
EggMayo: raises $0.17 to $0.21
nigel161: folds 
lawlex_2: folds 
perupoquer: folds 
_Anagor_AA: folds 
Uncalled bet ($0.17) returned to EggMayo
EggMayo collected $0.15 from pot
EggMayo: doesn't show hand 
*** SUMMARY ***
Total pot $0.15 | Rake $0 
Seat 1: lawlex_2 (big blind) folded before Flop
Seat 2: perupoquer folded before Flop
Seat 3: jpamb folded before Flop (didn't bet)
Seat 4: _Anagor_AA folded before Flop
Seat 5: EggMayo (button) collected ($0.15)
Seat 6: nigel161 (small blind) folded before Flop



PokerStars Hand #213869717880:  Hold'em No Limit ($0.01/$0.02 USD) - 2020/05/14 23:25:50 MSK [2020/05/14 16:25:50 ET]
Table 'Euforbo IV' 6-max Seat #6 is the button
Seat 1: lawlex_2 ($1.73 in chips) 
Seat 2: perupoquer ($3.52 in chips) 
Seat 3: jpamb ($2 in chips) 
Seat 4: _Anagor_AA ($1.69 in chips) 
Seat 5: EggMayo ($1.55 in chips) 
Seat 6: nigel161 ($4.30 in chips) 
lawlex_2: posts small blind $0.01
perupoquer: posts big blind $0.02
*** HOLE CARDS ***
Dealt to lawlex_2 [6c 7h]
jpamb: raises $0.04 to $0.06
_Anagor_AA: folds 
EggMayo: folds 
nigel161: calls $0.06
lawlex_2: folds 
perupoquer: raises $0.19 to $0.25
jpamb: calls $0.19
nigel161: folds 
*** FLOP *** [9s 7s Ks]
perupoquer: bets $0.14
jpamb: calls $0.14
*** TURN *** [9s 7s Ks] [9d]
perupoquer: bets $0.45
jpamb: raises $1.16 to $1.61 and is all-in
perupoquer: calls $1.16
perupoquer has timed out
*** RIVER *** [9s 7s Ks 9d] [7d]
*** SHOW DOWN ***
perupoquer: shows [Kh Ad] (two pair, Kings and Nines)
jpamb: shows [Qs Qc] (two pair, Queens and Nines)
perupoquer collected $3.93 from pot
*** SUMMARY ***
Total pot $4.07 | Rake $0.14 
Board [9s 7s Ks 9d 7d]
Seat 1: lawlex_2 (small blind) folded before Flop
Seat 2: perupoquer (big blind) showed [Kh Ad] and won ($3.93) with two pair, Kings and Nines
Seat 3: jpamb showed [Qs Qc] and lost with two pair, Queens and Nines
Seat 4: _Anagor_AA folded before Flop (didn't bet)
Seat 5: EggMayo folded before Flop (didn't bet)
Seat 6: nigel161 (button) folded before Flop



PokerStars Hand #213869801510:  Hold'em No Limit ($0.01/$0.02 USD) - 2020/05/14 23:27:02 MSK [2020/05/14 16:27:02 ET]
Table 'Euforbo IV' 6-max Seat #1 is the button
Seat 1: lawlex_2 ($1.72 in chips) 
Seat 2: perupoquer ($5.45 in chips) 
Seat 3: jpamb ($2 in chips) 
Seat 4: _Anagor_AA ($1.69 in chips) 
Seat 5: EggMayo ($1.55 in chips) 
Seat 6: nigel161 ($4.24 in chips) 
perupoquer: posts small blind $0.01
jpamb: posts big blind $0.02
*** HOLE CARDS ***
Dealt to lawlex_2 [4h Jc]
_Anagor_AA: folds 
EggMayo: raises $0.03 to $0.05
nigel161 has timed out
nigel161: folds 
lawlex_2: folds 
perupoquer has timed out
perupoquer: folds 
jpamb: raises $0.15 to $0.20
EggMayo: folds 
Uncalled bet ($0.15) returned to jpamb
jpamb collected $0.11 from pot
jpamb: doesn't show hand 
*** SUMMARY ***
Total pot $0.11 | Rake $0 
Seat 1: lawlex_2 (button) folded before Flop (didn't bet)
Seat 2: perupoquer (small blind) folded before Flop
Seat 3: jpamb (big blind) collected ($0.11)
Seat 4: _Anagor_AA folded before Flop (didn't bet)
Seat 5: EggMayo folded before Flop
Seat 6: nigel161 folded before Flop (didn't bet)



PokerStars Hand #213869903942:  Hold'em No Limit ($0.01/$0.02 USD) - 2020/05/14 23:28:32 MSK [2020/05/14 16:28:32 ET]
Table 'Euforbo IV' 6-max Seat #3 is the button
Seat 1: lawlex_2 ($1.72 in chips) 
Seat 3: jpamb ($2.06 in chips) 
Seat 4: _Anagor_AA ($1.69 in chips) 
Seat 5: EggMayo ($1.50 in chips) 
Seat 6: nigel161 ($4.24 in chips) 
_Anagor_AA: posts small blind $0.01
EggMayo: posts big blind $0.02
*** HOLE CARDS ***
Dealt to lawlex_2 [Jc Ts]
nigel161: calls $0.02
lawlex_2: raises $0.03 to $0.05
jpamb: folds 
_Anagor_AA: folds 
EggMayo: folds 
nigel161: calls $0.03
*** FLOP *** [Js Qs 4d]
nigel161: checks 
lawlex_2: bets $0.09
nigel161: calls $0.09
*** TURN *** [Js Qs 4d] [4h]
nigel161: checks 
lawlex_2: checks 
*** RIVER *** [Js Qs 4d 4h] [8c]
nigel161: bets $0.08
lawlex_2: calls $0.08
*** SHOW DOWN ***
nigel161: shows [Qh 6h] (two pair, Queens and Fours)
lawlex_2: mucks hand 
nigel161 collected $0.45 from pot
*** SUMMARY ***
Total pot $0.47 | Rake $0.02 
Board [Js Qs 4d 4h 8c]
Seat 1: lawlex_2 mucked [Jc Ts]
Seat 3: jpamb (button) folded before Flop (didn't bet)
Seat 4: _Anagor_AA (small blind) folded before Flop
Seat 5: EggMayo (big blind) folded before Flop
Seat 6: nigel161 showed [Qh 6h] and won ($0.45) with two pair, Queens and Fours



PokerStars Hand #213869968180:  Hold'em No Limit ($0.01/$0.02 USD) - 2020/05/14 23:29:28 MSK [2020/05/14 16:29:28 ET]
Table 'Euforbo IV' 6-max Seat #4 is the button
Seat 1: lawlex_2 ($1.50 in chips) 
Seat 3: jpamb ($2.06 in chips) 
Seat 4: _Anagor_AA ($1.68 in chips) 
Seat 5: EggMayo ($1.48 in chips) 
Seat 6: nigel161 ($4.47 in chips) 
EggMayo: posts small blind $0.01
nigel161: posts big blind $0.02
*** HOLE CARDS ***
Dealt to lawlex_2 [Kd 2h]
lawlex_2: folds 
jpamb: folds 
_Anagor_AA: folds 
EggMayo: raises $0.04 to $0.06
nigel161: calls $0.04
*** FLOP *** [3s Qc 5c]
EggMayo: checks 
nigel161: checks 
*** TURN *** [3s Qc 5c] [4c]
EggMayo: checks 
nigel161: bets $0.02
EggMayo: folds 
Uncalled bet ($0.02) returned to nigel161
nigel161 collected $0.12 from pot
nigel161: doesn't show hand 
*** SUMMARY ***
Total pot $0.12 | Rake $0 
Board [3s Qc 5c 4c]
Seat 1: lawlex_2 folded before Flop (didn't bet)
Seat 3: jpamb folded before Flop (didn't bet)
Seat 4: _Anagor_AA (button) folded before Flop (didn't bet)
Seat 5: EggMayo (small blind) folded on the Turn
Seat 6: nigel161 (big blind) collected ($0.12)



PokerStars Hand #213870026190:  Hold'em No Limit ($0.01/$0.02 USD) - 2020/05/14 23:30:18 MSK [2020/05/14 16:30:18 ET]
Table 'Euforbo IV' 6-max Seat #5 is the button
Seat 1: lawlex_2 ($1.50 in chips) 
Seat 3: jpamb ($2.06 in chips) 
Seat 4: _Anagor_AA ($1.68 in chips) 
Seat 5: EggMayo ($1.42 in chips) 
Seat 6: nigel161 ($4.53 in chips) 
nigel161: posts small blind $0.01
lawlex_2: posts big blind $0.02
*** HOLE CARDS ***
Dealt to lawlex_2 [7c 9s]
jpamb: folds 
_Anagor_AA: raises $0.04 to $0.06
EggMayo: folds 
nigel161: calls $0.05
lawlex_2: folds 
*** FLOP *** [Jc 5s 8h]
nigel161: checks 
_Anagor_AA: checks 
*** TURN *** [Jc 5s 8h] [6s]
nigel161: checks 
_Anagor_AA: bets $0.04
nigel161: calls $0.04
*** RIVER *** [Jc 5s 8h 6s] [3h]
nigel161: bets $0.02
_Anagor_AA: calls $0.02
*** SHOW DOWN ***
nigel161: shows [6d Qh] (a pair of Sixes)
_Anagor_AA: shows [6h Kh] (a pair of Sixes - King kicker)
_Anagor_AA collected $0.25 from pot
*** SUMMARY ***
Total pot $0.26 | Rake $0.01 
Board [Jc 5s 8h 6s 3h]
Seat 1: lawlex_2 (big blind) folded before Flop
Seat 3: jpamb folded before Flop (didn't bet)
Seat 4: _Anagor_AA showed [6h Kh] and won ($0.25) with a pair of Sixes
Seat 5: EggMayo (button) folded before Flop (didn't bet)
Seat 6: nigel161 (small blind) showed [6d Qh] and lost with a pair of Sixes



PokerStars Hand #213870067755:  Hold'em No Limit ($0.01/$0.02 USD) - 2020/05/14 23:30:55 MSK [2020/05/14 16:30:55 ET]
Table 'Euforbo IV' 6-max Seat #6 is the button
Seat 1: lawlex_2 ($1.48 in chips) 
Seat 3: jpamb ($2.06 in chips) 
Seat 4: _Anagor_AA ($1.81 in chips) 
Seat 5: EggMayo ($1.42 in chips) 
Seat 6: nigel161 ($4.41 in chips) 
lawlex_2: posts small blind $0.01
jpamb: posts big blind $0.02
*** HOLE CARDS ***
Dealt to lawlex_2 [Qc 3h]
_Anagor_AA: folds 
EggMayo: raises $0.04 to $0.06
nigel161: calls $0.06
lawlex_2: folds 
jpamb: folds 
*** FLOP *** [Kd Td 2c]
EggMayo: checks 
nigel161: bets $0.02
EggMayo: folds 
Uncalled bet ($0.02) returned to nigel161
nigel161 collected $0.14 from pot
nigel161: doesn't show hand 
*** SUMMARY ***
Total pot $0.15 | Rake $0.01 
Board [Kd Td 2c]
Seat 1: lawlex_2 (small blind) folded before Flop
Seat 3: jpamb (big blind) folded before Flop
Seat 4: _Anagor_AA folded before Flop (didn't bet)
Seat 5: EggMayo folded on the Flop
Seat 6: nigel161 (button) collected ($0.14)



PokerStars Hand #213870102425:  Hold'em No Limit ($0.01/$0.02 USD) - 2020/05/14 23:31:25 MSK [2020/05/14 16:31:25 ET]
Table 'Euforbo IV' 6-max Seat #1 is the button
Seat 1: lawlex_2 ($1.47 in chips) 
Seat 3: jpamb ($2.04 in chips) 
Seat 4: _Anagor_AA ($1.81 in chips) 
Seat 5: EggMayo ($1.36 in chips) 
Seat 6: nigel161 ($4.49 in chips) 
jpamb: posts small blind $0.01
_Anagor_AA: posts big blind $0.02
*** HOLE CARDS ***
Dealt to lawlex_2 [Qh Qs]
EggMayo: folds 
nigel161: calls $0.02
lawlex_2: raises $0.03 to $0.05
jpamb: folds 
_Anagor_AA: folds 
nigel161: calls $0.03
*** FLOP *** [8d 9h 8c]
nigel161: checks 
lawlex_2: bets $0.09
nigel161: folds 
Uncalled bet ($0.09) returned to lawlex_2
lawlex_2 collected $0.13 from pot
lawlex_2: doesn't show hand 
*** SUMMARY ***
Total pot $0.13 | Rake $0 
Board [8d 9h 8c]
Seat 1: lawlex_2 (button) collected ($0.13)
Seat 3: jpamb (small blind) folded before Flop
Seat 4: _Anagor_AA (big blind) folded before Flop
Seat 5: EggMayo folded before Flop (didn't bet)
Seat 6: nigel161 folded on the Flop



PokerStars Hand #213870130742:  Hold'em No Limit ($0.01/$0.02 USD) - 2020/05/14 23:31:50 MSK [2020/05/14 16:31:50 ET]
Table 'Euforbo IV' 6-max Seat #3 is the button
Seat 1: lawlex_2 ($1.55 in chips) 
Seat 3: jpamb ($2.03 in chips) 
Seat 4: _Anagor_AA ($1.79 in chips) 
Seat 5: EggMayo ($1.36 in chips) 
Seat 6: nigel161 ($4.44 in chips) 
_Anagor_AA: posts small blind $0.01
EggMayo: posts big blind $0.02
*** HOLE CARDS ***
Dealt to lawlex_2 [3s Qs]
nigel161: calls $0.02
lawlex_2: folds 
jpamb: folds 
_Anagor_AA: calls $0.01
EggMayo: checks 
*** FLOP *** [8s 2c Kh]
_Anagor_AA: checks 
EggMayo: checks 
nigel161: checks 
*** TURN *** [8s 2c Kh] [Ac]
_Anagor_AA: checks 
EggMayo: checks 
nigel161: checks 
*** RIVER *** [8s 2c Kh Ac] [Tc]
_Anagor_AA: checks 
EggMayo: checks 
nigel161: checks 
*** SHOW DOWN ***
_Anagor_AA: shows [9d Jh] (high card Ace)
EggMayo: shows [Qh 6h] (high card Ace - King+Queen kicker)
nigel161: shows [Qd 2s] (a pair of Deuces)
nigel161 collected $0.06 from pot
*** SUMMARY ***
Total pot $0.06 | Rake $0 
Board [8s 2c Kh Ac Tc]
Seat 1: lawlex_2 folded before Flop (didn't bet)
Seat 3: jpamb (button) folded before Flop (didn't bet)
Seat 4: _Anagor_AA (small blind) showed [9d Jh] and lost with high card Ace
Seat 5: EggMayo (big blind) showed [Qh 6h] and lost with high card Ace
Seat 6: nigel161 showed [Qd 2s] and won ($0.06) with a pair of Deuces



PokerStars Hand #213870195998:  Hold'em No Limit ($0.01/$0.02 USD) - 2020/05/14 23:32:47 MSK [2020/05/14 16:32:47 ET]
Table 'Euforbo IV' 6-max Seat #4 is the button
Seat 1: lawlex_2 ($1.55 in chips) 
Seat 3: jpamb ($2.03 in chips) 
Seat 4: _Anagor_AA ($1.77 in chips) 
Seat 5: EggMayo ($1.34 in chips) 
Seat 6: nigel161 ($4.48 in chips) 
EggMayo: posts small blind $0.01
nigel161: posts big blind $0.02
*** HOLE CARDS ***
Dealt to lawlex_2 [4h Ts]
lawlex_2: folds 
jpamb: folds 
_Anagor_AA: raises $0.04 to $0.06
EggMayo: folds 
nigel161: calls $0.04
*** FLOP *** [Qc 8h 5h]
nigel161: checks 
_Anagor_AA: bets $0.06
nigel161: calls $0.06
*** TURN *** [Qc 8h 5h] [4s]
nigel161: checks 
_Anagor_AA: checks 
*** RIVER *** [Qc 8h 5h 4s] [6h]
nigel161: checks 
_Anagor_AA: checks 
*** SHOW DOWN ***
nigel161: shows [8d Ah] (a pair of Eights)
_Anagor_AA: mucks hand 
nigel161 collected $0.24 from pot
*** SUMMARY ***
Total pot $0.25 | Rake $0.01 
Board [Qc 8h 5h 4s 6h]
Seat 1: lawlex_2 folded before Flop (didn't bet)
Seat 3: jpamb folded before Flop (didn't bet)
Seat 4: _Anagor_AA (button) mucked [Ad 4c]
Seat 5: EggMayo (small blind) folded before Flop
Seat 6: nigel161 (big blind) showed [8d Ah] and won ($0.24) with a pair of Eights



PokerStars Hand #213870234240:  Hold'em No Limit ($0.01/$0.02 USD) - 2020/05/14 23:33:21 MSK [2020/05/14 16:33:21 ET]
Table 'Euforbo IV' 6-max Seat #5 is the button
Seat 1: lawlex_2 ($1.55 in chips) 
Seat 3: jpamb ($2.03 in chips) 
Seat 4: _Anagor_AA ($1.65 in chips) 
Seat 5: EggMayo ($1.33 in chips) 
Seat 6: nigel161 ($4.60 in chips) 
nigel161: posts small blind $0.01
lawlex_2: posts big blind $0.02
*** HOLE CARDS ***
Dealt to lawlex_2 [5d 6s]
jpamb: folds 
_Anagor_AA: raises $0.04 to $0.06
EggMayo: folds 
nigel161: calls $0.05
lawlex_2: folds 
*** FLOP *** [7c 2h Jd]
nigel161: checks 
_Anagor_AA: bets $0.06
nigel161: calls $0.06
*** TURN *** [7c 2h Jd] [Kc]
nigel161: checks 
_Anagor_AA: checks 
*** RIVER *** [7c 2h Jd Kc] [Qc]
nigel161: checks 
_Anagor_AA: bets $0.12
nigel161: raises $0.12 to $0.24
_Anagor_AA: calls $0.12
*** SHOW DOWN ***
nigel161: shows [Jc Tc] (a flush, King high)
_Anagor_AA: mucks hand 
nigel161 collected $0.71 from pot
*** SUMMARY ***
Total pot $0.74 | Rake $0.03 
Board [7c 2h Jd Kc Qc]
Seat 1: lawlex_2 (big blind) folded before Flop
Seat 3: jpamb folded before Flop (didn't bet)
Seat 4: _Anagor_AA mucked [Qs Kd]
Seat 5: EggMayo (button) folded before Flop (didn't bet)
Seat 6: nigel161 (small blind) showed [Jc Tc] and won ($0.71) with a flush, King high



PokerStars Hand #213870285595:  Hold'em No Limit ($0.01/$0.02 USD) - 2020/05/14 23:34:02 MSK [2020/05/14 16:34:02 ET]
Table 'Euforbo IV' 6-max Seat #6 is the button
Seat 1: lawlex_2 ($1.53 in chips) 
Seat 2: perupoquer ($5.44 in chips) 
Seat 3: jpamb ($2.03 in chips) 
Seat 4: _Anagor_AA ($1.29 in chips) 
Seat 5: EggMayo ($1.33 in chips) 
Seat 6: nigel161 ($4.95 in chips) 
lawlex_2: posts small blind $0.01
perupoquer: posts big blind $0.02
*** HOLE CARDS ***
Dealt to lawlex_2 [9s Kc]
jpamb: folds 
_Anagor_AA: raises $0.04 to $0.06
EggMayo: folds 
nigel161: folds 
lawlex_2: folds 
perupoquer: raises $0.13 to $0.19
_Anagor_AA: raises $0.39 to $0.58
perupoquer has timed out
perupoquer: folds 
Uncalled bet ($0.39) returned to _Anagor_AA
_Anagor_AA collected $0.39 from pot
_Anagor_AA: doesn't show hand 
*** SUMMARY ***
Total pot $0.39 | Rake $0 
Seat 1: lawlex_2 (small blind) folded before Flop
Seat 2: perupoquer (big blind) folded before Flop
Seat 3: jpamb folded before Flop (didn't bet)
Seat 4: _Anagor_AA collected ($0.39)
Seat 5: EggMayo folded before Flop (didn't bet)
Seat 6: nigel161 (button) folded before Flop (didn't bet)



PokerStars Hand #213870328662:  Hold'em No Limit ($0.01/$0.02 USD) - 2020/05/14 23:34:40 MSK [2020/05/14 16:34:40 ET]
Table 'Euforbo IV' 6-max Seat #1 is the button
Seat 1: lawlex_2 ($1.52 in chips) 
Seat 2: perupoquer ($5.25 in chips) 
Seat 3: jpamb ($2.03 in chips) 
Seat 4: _Anagor_AA ($1.49 in chips) 
Seat 5: EggMayo ($1.33 in chips) 
Seat 6: nigel161 ($4.95 in chips) 
perupoquer: posts small blind $0.01
jpamb: posts big blind $0.02
*** HOLE CARDS ***
Dealt to lawlex_2 [Qc Ts]
_Anagor_AA: folds 
EggMayo: raises $0.03 to $0.05
nigel161: calls $0.05
lawlex_2: folds 
perupoquer: folds 
jpamb: folds 
*** FLOP *** [7c Tc Jh]
EggMayo: checks 
nigel161: checks 
*** TURN *** [7c Tc Jh] [8c]
EggMayo: checks 
nigel161: checks 
*** RIVER *** [7c Tc Jh 8c] [Kh]
EggMayo: checks 
nigel161: checks 
*** SHOW DOWN ***
EggMayo: shows [Ah Js] (a pair of Jacks)
nigel161: shows [Ks 4h] (a pair of Kings)
nigel161 collected $0.13 from pot
*** SUMMARY ***
Total pot $0.13 | Rake $0 
Board [7c Tc Jh 8c Kh]
Seat 1: lawlex_2 (button) folded before Flop (didn't bet)
Seat 2: perupoquer (small blind) folded before Flop
Seat 3: jpamb (big blind) folded before Flop
Seat 4: _Anagor_AA folded before Flop (didn't bet)
Seat 5: EggMayo showed [Ah Js] and lost with a pair of Jacks
Seat 6: nigel161 showed [Ks 4h] and won ($0.13) with a pair of Kings



PokerStars Hand #213870381002:  Hold'em No Limit ($0.01/$0.02 USD) - 2020/05/14 23:35:26 MSK [2020/05/14 16:35:26 ET]
Table 'Euforbo IV' 6-max Seat #2 is the button
Seat 1: lawlex_2 ($1.52 in chips) 
Seat 2: perupoquer ($5.24 in chips) 
Seat 3: jpamb ($2.01 in chips) 
Seat 4: _Anagor_AA ($1.49 in chips) 
Seat 5: EggMayo ($1.28 in chips) 
Seat 6: nigel161 ($5.03 in chips) 
jpamb: posts small blind $0.01
_Anagor_AA: posts big blind $0.02
*** HOLE CARDS ***
Dealt to lawlex_2 [3s 7s]
EggMayo: folds 
nigel161: calls $0.02
lawlex_2: folds 
perupoquer: calls $0.02
jpamb: folds 
_Anagor_AA: checks 
*** FLOP *** [2d Qd 4s]
_Anagor_AA: checks 
nigel161: checks 
perupoquer: checks 
*** TURN *** [2d Qd 4s] [Qs]
_Anagor_AA: checks 
nigel161: checks 
perupoquer: checks 
*** RIVER *** [2d Qd 4s Qs] [Jh]
_Anagor_AA: checks 
nigel161: bets $0.06
perupoquer: folds 
_Anagor_AA: folds 
Uncalled bet ($0.06) returned to nigel161
nigel161 collected $0.07 from pot
nigel161: doesn't show hand 
*** SUMMARY ***
Total pot $0.07 | Rake $0 
Board [2d Qd 4s Qs Jh]
Seat 1: lawlex_2 folded before Flop (didn't bet)
Seat 2: perupoquer (button) folded on the River
Seat 3: jpamb (small blind) folded before Flop
Seat 4: _Anagor_AA (big blind) folded on the River
Seat 5: EggMayo folded before Flop (didn't bet)
Seat 6: nigel161 collected ($0.07)



PokerStars Hand #213870427862:  Hold'em No Limit ($0.01/$0.02 USD) - 2020/05/14 23:36:08 MSK [2020/05/14 16:36:08 ET]
Table 'Euforbo IV' 6-max Seat #3 is the button
Seat 1: lawlex_2 ($1.52 in chips) 
Seat 2: perupoquer ($5.22 in chips) 
Seat 3: jpamb ($2 in chips) 
Seat 4: _Anagor_AA ($1.47 in chips) 
Seat 5: EggMayo ($1.28 in chips) 
Seat 6: nigel161 ($5.08 in chips) 
_Anagor_AA: posts small blind $0.01
EggMayo: posts big blind $0.02
*** HOLE CARDS ***
Dealt to lawlex_2 [Qs 4h]
nigel161: calls $0.02
lawlex_2: folds 
perupoquer: folds 
jpamb: folds 
_Anagor_AA: raises $0.04 to $0.06
EggMayo: folds 
nigel161: calls $0.04
*** FLOP *** [Qh Kd 6d]
_Anagor_AA: checks 
nigel161: bets $0.02
_Anagor_AA: calls $0.02
*** TURN *** [Qh Kd 6d] [5c]
_Anagor_AA: checks 
nigel161: bets $0.02
_Anagor_AA: calls $0.02
*** RIVER *** [Qh Kd 6d 5c] [8c]
_Anagor_AA: checks 
nigel161: bets $0.02
_Anagor_AA: folds 
Uncalled bet ($0.02) returned to nigel161
nigel161 collected $0.21 from pot
nigel161: doesn't show hand 
*** SUMMARY ***
Total pot $0.22 | Rake $0.01 
Board [Qh Kd 6d 5c 8c]
Seat 1: lawlex_2 folded before Flop (didn't bet)
Seat 2: perupoquer folded before Flop (didn't bet)
Seat 3: jpamb (button) folded before Flop (didn't bet)
Seat 4: _Anagor_AA (small blind) folded on the River
Seat 5: EggMayo (big blind) folded before Flop
Seat 6: nigel161 collected ($0.21)



PokerStars Hand #213870486605:  Hold'em No Limit ($0.01/$0.02 USD) - 2020/05/14 23:36:55 MSK [2020/05/14 16:36:55 ET]
Table 'Euforbo IV' 6-max Seat #4 is the button
Seat 1: lawlex_2 ($1.52 in chips) 
Seat 2: perupoquer ($5.22 in chips) 
Seat 3: jpamb ($2 in chips) 
Seat 4: _Anagor_AA ($1.37 in chips) 
Seat 5: EggMayo ($1.26 in chips) 
Seat 6: nigel161 ($5.19 in chips) 
EggMayo: posts small blind $0.01
nigel161: posts big blind $0.02
*** HOLE CARDS ***
Dealt to lawlex_2 [2c 9h]
lawlex_2: folds 
perupoquer: folds 
jpamb: folds 
_Anagor_AA: folds 
EggMayo: folds 
Uncalled bet ($0.01) returned to nigel161
nigel161 collected $0.02 from pot
nigel161: doesn't show hand 
*** SUMMARY ***
Total pot $0.02 | Rake $0 
Seat 1: lawlex_2 folded before Flop (didn't bet)
Seat 2: perupoquer folded before Flop (didn't bet)
Seat 3: jpamb folded before Flop (didn't bet)
Seat 4: _Anagor_AA (button) folded before Flop (didn't bet)
Seat 5: EggMayo (small blind) folded before Flop
Seat 6: nigel161 (big blind) collected ($0.02)



PokerStars Hand #213870502671:  Hold'em No Limit ($0.01/$0.02 USD) - 2020/05/14 23:37:09 MSK [2020/05/14 16:37:09 ET]
Table 'Euforbo IV' 6-max Seat #5 is the button
Seat 1: lawlex_2 ($1.52 in chips) 
Seat 3: jpamb ($2 in chips) 
Seat 4: _Anagor_AA ($1.37 in chips) 
Seat 5: EggMayo ($1.25 in chips) 
Seat 6: nigel161 ($5.20 in chips) 
nigel161: posts small blind $0.01
lawlex_2: posts big blind $0.02
*** HOLE CARDS ***
Dealt to lawlex_2 [2s Kd]
jpamb: folds 
_Anagor_AA: folds 
EggMayo: folds 
nigel161: calls $0.01
lawlex_2: checks 
*** FLOP *** [Jh 4d Th]
nigel161: checks 
lawlex_2: checks 
*** TURN *** [Jh 4d Th] [4h]
nigel161: checks 
lawlex_2: checks 
*** RIVER *** [Jh 4d Th 4h] [Qd]
nigel161: checks 
lawlex_2: checks 
*** SHOW DOWN ***
nigel161: shows [Tc 5c] (two pair, Tens and Fours)
lawlex_2: mucks hand 
nigel161 collected $0.04 from pot
*** SUMMARY ***
Total pot $0.04 | Rake $0 
Board [Jh 4d Th 4h Qd]
Seat 1: lawlex_2 (big blind) mucked [2s Kd]
Seat 3: jpamb folded before Flop (didn't bet)
Seat 4: _Anagor_AA folded before Flop (didn't bet)
Seat 5: EggMayo (button) folded before Flop (didn't bet)
Seat 6: nigel161 (small blind) showed [Tc 5c] and won ($0.04) with two pair, Tens and Fours



PokerStars Hand #213870548732:  Hold'em No Limit ($0.01/$0.02 USD) - 2020/05/14 23:37:50 MSK [2020/05/14 16:37:50 ET]
Table 'Euforbo IV' 6-max Seat #6 is the button
Seat 1: lawlex_2 ($1.50 in chips) 
Seat 3: jpamb ($2 in chips) 
Seat 4: _Anagor_AA ($1.37 in chips) 
Seat 5: EggMayo ($1.25 in chips) 
Seat 6: nigel161 ($5.22 in chips) 
lawlex_2: posts small blind $0.01
jpamb: posts big blind $0.02
*** HOLE CARDS ***
Dealt to lawlex_2 [Qs 9s]
_Anagor_AA: folds 
EggMayo: raises $0.04 to $0.06
nigel161: calls $0.06
lawlex_2: calls $0.05
jpamb: folds 
*** FLOP *** [Qh Qd 8d]
lawlex_2: checks 
EggMayo: bets $0.11
nigel161: folds 
lawlex_2: calls $0.11
*** TURN *** [Qh Qd 8d] [Jc]
lawlex_2: checks 
EggMayo: bets $0.21
lawlex_2: calls $0.21
*** RIVER *** [Qh Qd 8d Jc] [9c]
lawlex_2: checks 
EggMayo: bets $0.87 and is all-in
lawlex_2: calls $0.87
*** SHOW DOWN ***
EggMayo: shows [Kd 4d] (a pair of Queens)
lawlex_2: shows [Qs 9s] (a full house, Queens full of Nines)
lawlex_2 collected $2.49 from pot
*** SUMMARY ***
Total pot $2.58 | Rake $0.09 
Board [Qh Qd 8d Jc 9c]
Seat 1: lawlex_2 (small blind) showed [Qs 9s] and won ($2.49) with a full house, Queens full of Nines
Seat 3: jpamb (big blind) folded before Flop
Seat 4: _Anagor_AA folded before Flop (didn't bet)
Seat 5: EggMayo showed [Kd 4d] and lost with a pair of Queens
Seat 6: nigel161 (button) folded on the Flop



