PokerStars Hand #213053039781:  Hold'em No Limit ($0.01/$0.02 USD) - 2020/05/01 12:17:50 MSK [2020/05/01 5:17:50 ET]
Table 'Okavango III' 6-max Seat #4 is the button
Seat 1: mattie98.ms ($1.67 in chips) 
Seat 2: Vadim755 ($1.66 in chips) 
Seat 3: DovileGa ($0.70 in chips) 
Seat 4: Fran_Emm ($2.40 in chips) 
Seat 5: tasty_fish90 ($3.38 in chips) 
Seat 6: lawlex_2 ($2 in chips) 
tasty_fish90: posts small blind $0.01
lawlex_2: posts big blind $0.02
*** HOLE CARDS ***
Dealt to lawlex_2 [5h 9d]
mattie98.ms: calls $0.02
Vadim755: raises $0.02 to $0.04
DovileGa: raises $0.06 to $0.10
Fran_Emm: folds 
tasty_fish90: folds 
lawlex_2: folds 
mattie98.ms: raises $0.06 to $0.16
Vadim755: calls $0.12
DovileGa: raises $0.32 to $0.48
mattie98.ms: raises $0.32 to $0.80
Vadim755: folds 
DovileGa: calls $0.22 and is all-in
Uncalled bet ($0.10) returned to mattie98.ms
*** FLOP *** [Qc 4s 8c]
*** TURN *** [Qc 4s 8c] [2h]
*** RIVER *** [Qc 4s 8c 2h] [9s]
*** SHOW DOWN ***
mattie98.ms: shows [2d Kc] (a pair of Deuces)
DovileGa: shows [Ad Ah] (a pair of Aces)
DovileGa collected $1.53 from pot
*** SUMMARY ***
Total pot $1.59 | Rake $0.06 
Board [Qc 4s 8c 2h 9s]
Seat 1: mattie98.ms showed [2d Kc] and lost with a pair of Deuces
Seat 2: Vadim755 folded before Flop
Seat 3: DovileGa showed [Ad Ah] and won ($1.53) with a pair of Aces
Seat 4: Fran_Emm (button) folded before Flop (didn't bet)
Seat 5: tasty_fish90 (small blind) folded before Flop
Seat 6: lawlex_2 (big blind) folded before Flop



PokerStars Hand #213053082965:  Hold'em No Limit ($0.01/$0.02 USD) - 2020/05/01 12:19:11 MSK [2020/05/01 5:19:11 ET]
Table 'Okavango III' 6-max Seat #5 is the button
Seat 1: mattie98.ms ($0.97 in chips) 
Seat 2: Vadim755 ($1.50 in chips) 
Seat 3: DovileGa ($1.53 in chips) 
Seat 4: Fran_Emm ($2.40 in chips) 
Seat 5: tasty_fish90 ($3.37 in chips) 
Seat 6: lawlex_2 ($1.98 in chips) 
lawlex_2: posts small blind $0.01
mattie98.ms: posts big blind $0.02
*** HOLE CARDS ***
Dealt to lawlex_2 [4s 8d]
Vadim755: folds 
DovileGa: calls $0.02
Fran_Emm: raises $0.06 to $0.08
tasty_fish90: folds 
lawlex_2: folds 
mattie98.ms: calls $0.06
DovileGa: calls $0.06
*** FLOP *** [6d 8h Kd]
mattie98.ms: bets $0.02
DovileGa: folds 
Fran_Emm: calls $0.02
*** TURN *** [6d 8h Kd] [Th]
mattie98.ms: bets $0.02
Fran_Emm: calls $0.02
*** RIVER *** [6d 8h Kd Th] [Qd]
mattie98.ms: bets $0.02
Fran_Emm: calls $0.02
*** SHOW DOWN ***
mattie98.ms: shows [Qh 7d] (a pair of Queens)
Fran_Emm: mucks hand 
mattie98.ms collected $0.36 from pot
*** SUMMARY ***
Total pot $0.37 | Rake $0.01 
Board [6d 8h Kd Th Qd]
Seat 1: mattie98.ms (big blind) showed [Qh 7d] and won ($0.36) with a pair of Queens
Seat 2: Vadim755 folded before Flop (didn't bet)
Seat 3: DovileGa folded on the Flop
Seat 4: Fran_Emm mucked [As 6h]
Seat 5: tasty_fish90 (button) folded before Flop (didn't bet)
Seat 6: lawlex_2 (small blind) folded before Flop



PokerStars Hand #213053104056:  Hold'em No Limit ($0.01/$0.02 USD) - 2020/05/01 12:19:51 MSK [2020/05/01 5:19:51 ET]
Table 'Okavango III' 6-max Seat #6 is the button
Seat 1: mattie98.ms ($1.19 in chips) 
Seat 2: Vadim755 ($1.50 in chips) 
Seat 3: DovileGa ($1.45 in chips) 
Seat 4: Fran_Emm ($2.26 in chips) 
Seat 5: tasty_fish90 ($3.37 in chips) 
Seat 6: lawlex_2 ($1.97 in chips) 
mattie98.ms: posts small blind $0.01
Vadim755: posts big blind $0.02
*** HOLE CARDS ***
Dealt to lawlex_2 [4s Th]
DovileGa: raises $0.02 to $0.04
Fran_Emm: folds 
tasty_fish90: folds 
lawlex_2: folds 
mattie98.ms: raises $0.02 to $0.06
Vadim755: folds 
DovileGa: calls $0.02
*** FLOP *** [Jh 9c Kc]
mattie98.ms: bets $0.02
DovileGa: calls $0.02
*** TURN *** [Jh 9c Kc] [4d]
mattie98.ms: checks 
DovileGa: bets $0.08
mattie98.ms: raises $0.08 to $0.16
DovileGa: calls $0.08
*** RIVER *** [Jh 9c Kc 4d] [2s]
mattie98.ms: checks 
DovileGa: checks 
*** SHOW DOWN ***
mattie98.ms: shows [Ks Ac] (a pair of Kings)
DovileGa: mucks hand 
mattie98.ms collected $0.48 from pot
*** SUMMARY ***
Total pot $0.50 | Rake $0.02 
Board [Jh 9c Kc 4d 2s]
Seat 1: mattie98.ms (small blind) showed [Ks Ac] and won ($0.48) with a pair of Kings
Seat 2: Vadim755 (big blind) folded before Flop
Seat 3: DovileGa mucked [Jd Ts]
Seat 4: Fran_Emm folded before Flop (didn't bet)
Seat 5: tasty_fish90 folded before Flop (didn't bet)
Seat 6: lawlex_2 (button) folded before Flop (didn't bet)



PokerStars Hand #213053124915:  Hold'em No Limit ($0.01/$0.02 USD) - 2020/05/01 12:20:31 MSK [2020/05/01 5:20:31 ET]
Table 'Okavango III' 6-max Seat #1 is the button
Seat 1: mattie98.ms ($1.43 in chips) 
Seat 2: Vadim755 ($1.48 in chips) 
Seat 3: DovileGa ($1.21 in chips) 
Seat 4: Fran_Emm ($2.26 in chips) 
Seat 5: tasty_fish90 ($3.37 in chips) 
Seat 6: lawlex_2 ($1.97 in chips) 
Vadim755: posts small blind $0.01
DovileGa: posts big blind $0.02
*** HOLE CARDS ***
Dealt to lawlex_2 [Kh 4c]
Fran_Emm: folds 
tasty_fish90: folds 
lawlex_2: folds 
mattie98.ms: raises $0.02 to $0.04
Vadim755: folds 
DovileGa: calls $0.02
*** FLOP *** [6d 3h Jh]
DovileGa: bets $0.02
mattie98.ms: calls $0.02
*** TURN *** [6d 3h Jh] [9d]
DovileGa: bets $0.02
mattie98.ms: raises $0.02 to $0.04
DovileGa: calls $0.02
*** RIVER *** [6d 3h Jh 9d] [4d]
DovileGa: checks 
mattie98.ms: bets $0.18
DovileGa: folds 
Uncalled bet ($0.18) returned to mattie98.ms
mattie98.ms collected $0.20 from pot
mattie98.ms: doesn't show hand 
*** SUMMARY ***
Total pot $0.21 | Rake $0.01 
Board [6d 3h Jh 9d 4d]
Seat 1: mattie98.ms (button) collected ($0.20)
Seat 2: Vadim755 (small blind) folded before Flop
Seat 3: DovileGa (big blind) folded on the River
Seat 4: Fran_Emm folded before Flop (didn't bet)
Seat 5: tasty_fish90 folded before Flop (didn't bet)
Seat 6: lawlex_2 folded before Flop (didn't bet)



PokerStars Hand #213053150514:  Hold'em No Limit ($0.01/$0.02 USD) - 2020/05/01 12:21:20 MSK [2020/05/01 5:21:20 ET]
Table 'Okavango III' 6-max Seat #2 is the button
Seat 1: mattie98.ms ($1.53 in chips) 
Seat 2: Vadim755 ($1.47 in chips) 
Seat 3: DovileGa ($1.11 in chips) 
Seat 4: Fran_Emm ($2.26 in chips) 
Seat 5: tasty_fish90 ($3.37 in chips) 
Seat 6: lawlex_2 ($1.97 in chips) 
DovileGa: posts small blind $0.01
Fran_Emm: posts big blind $0.02
*** HOLE CARDS ***
Dealt to lawlex_2 [8h Kd]
tasty_fish90: folds 
lawlex_2: folds 
mattie98.ms: calls $0.02
Vadim755: folds 
DovileGa: raises $0.04 to $0.06
Fran_Emm: folds 
mattie98.ms: calls $0.04
*** FLOP *** [7s 4s 3s]
DovileGa: checks 
mattie98.ms: checks 
*** TURN *** [7s 4s 3s] [Th]
DovileGa: checks 
mattie98.ms: bets $0.02
DovileGa: calls $0.02
*** RIVER *** [7s 4s 3s Th] [5c]
DovileGa: checks 
mattie98.ms: bets $0.08
DovileGa: folds 
Uncalled bet ($0.08) returned to mattie98.ms
mattie98.ms collected $0.17 from pot
mattie98.ms: doesn't show hand 
*** SUMMARY ***
Total pot $0.18 | Rake $0.01 
Board [7s 4s 3s Th 5c]
Seat 1: mattie98.ms collected ($0.17)
Seat 2: Vadim755 (button) folded before Flop (didn't bet)
Seat 3: DovileGa (small blind) folded on the River
Seat 4: Fran_Emm (big blind) folded before Flop
Seat 5: tasty_fish90 folded before Flop (didn't bet)
Seat 6: lawlex_2 folded before Flop (didn't bet)



PokerStars Hand #213053172799:  Hold'em No Limit ($0.01/$0.02 USD) - 2020/05/01 12:22:02 MSK [2020/05/01 5:22:02 ET]
Table 'Okavango III' 6-max Seat #3 is the button
Seat 1: mattie98.ms ($1.62 in chips) 
Seat 2: Vadim755 ($1.47 in chips) 
Seat 3: DovileGa ($1.03 in chips) 
Seat 4: Fran_Emm ($2.24 in chips) 
Seat 5: tasty_fish90 ($3.37 in chips) 
Seat 6: lawlex_2 ($1.97 in chips) 
Fran_Emm: posts small blind $0.01
tasty_fish90: posts big blind $0.02
*** HOLE CARDS ***
Dealt to lawlex_2 [7h 2s]
lawlex_2: folds 
mattie98.ms: calls $0.02
Vadim755: raises $0.02 to $0.04
DovileGa: calls $0.04
Fran_Emm: folds 
tasty_fish90: calls $0.02
mattie98.ms: calls $0.02
*** FLOP *** [Kc 7d 5c]
tasty_fish90: checks 
mattie98.ms: bets $0.02
Vadim755: raises $0.02 to $0.04
DovileGa: calls $0.04
tasty_fish90: calls $0.04
mattie98.ms: calls $0.02
*** TURN *** [Kc 7d 5c] [4h]
tasty_fish90: checks 
mattie98.ms: checks 
Vadim755: checks 
DovileGa: checks 
*** RIVER *** [Kc 7d 5c 4h] [4d]
tasty_fish90: bets $0.16
mattie98.ms: raises $0.16 to $0.32
Vadim755: folds 
DovileGa: folds 
tasty_fish90: calls $0.16
*** SHOW DOWN ***
mattie98.ms: shows [6c 4s] (three of a kind, Fours)
tasty_fish90: mucks hand 
mattie98.ms collected $0.94 from pot
*** SUMMARY ***
Total pot $0.97 | Rake $0.03 
Board [Kc 7d 5c 4h 4d]
Seat 1: mattie98.ms showed [6c 4s] and won ($0.94) with three of a kind, Fours
Seat 2: Vadim755 folded on the River
Seat 3: DovileGa (button) folded on the River
Seat 4: Fran_Emm (small blind) folded before Flop
Seat 5: tasty_fish90 (big blind) mucked [Js Kd]
Seat 6: lawlex_2 folded before Flop (didn't bet)



PokerStars Hand #213053205127:  Hold'em No Limit ($0.01/$0.02 USD) - 2020/05/01 12:23:03 MSK [2020/05/01 5:23:03 ET]
Table 'Okavango III' 6-max Seat #4 is the button
Seat 1: mattie98.ms ($2.16 in chips) 
Seat 2: Vadim755 ($1.39 in chips) 
Seat 3: DovileGa ($0.95 in chips) 
Seat 4: Fran_Emm ($2.23 in chips) 
Seat 5: tasty_fish90 ($2.97 in chips) 
Seat 6: lawlex_2 ($1.97 in chips) 
tasty_fish90: posts small blind $0.01
lawlex_2: posts big blind $0.02
*** HOLE CARDS ***
Dealt to lawlex_2 [9c 8h]
mattie98.ms: calls $0.02
Vadim755: folds 
DovileGa: calls $0.02
Fran_Emm: raises $0.08 to $0.10
tasty_fish90: folds 
lawlex_2: folds 
mattie98.ms: calls $0.08
DovileGa: folds 
*** FLOP *** [8s Qs 7h]
mattie98.ms: checks 
Fran_Emm: bets $0.14
mattie98.ms: calls $0.14
*** TURN *** [8s Qs 7h] [2c]
mattie98.ms: checks 
Fran_Emm: checks 
*** RIVER *** [8s Qs 7h 2c] [5d]
mattie98.ms: checks 
Fran_Emm: checks 
*** SHOW DOWN ***
mattie98.ms: shows [7c 8c] (two pair, Eights and Sevens)
Fran_Emm: mucks hand 
mattie98.ms collected $0.51 from pot
*** SUMMARY ***
Total pot $0.53 | Rake $0.02 
Board [8s Qs 7h 2c 5d]
Seat 1: mattie98.ms showed [7c 8c] and won ($0.51) with two pair, Eights and Sevens
Seat 2: Vadim755 folded before Flop (didn't bet)
Seat 3: DovileGa folded before Flop
Seat 4: Fran_Emm (button) mucked [Jc Ah]
Seat 5: tasty_fish90 (small blind) folded before Flop
Seat 6: lawlex_2 (big blind) folded before Flop



PokerStars Hand #213053232636:  Hold'em No Limit ($0.01/$0.02 USD) - 2020/05/01 12:23:55 MSK [2020/05/01 5:23:55 ET]
Table 'Okavango III' 6-max Seat #5 is the button
Seat 1: mattie98.ms ($2.43 in chips) 
Seat 2: Vadim755 ($1.39 in chips) 
Seat 3: DovileGa ($0.93 in chips) 
Seat 4: Fran_Emm ($2 in chips) 
Seat 5: tasty_fish90 ($2.96 in chips) 
Seat 6: lawlex_2 ($1.95 in chips) 
lawlex_2: posts small blind $0.01
mattie98.ms: posts big blind $0.02
*** HOLE CARDS ***
Dealt to lawlex_2 [Qh 6d]
Vadim755: raises $0.02 to $0.04
DovileGa: raises $0.06 to $0.10
Fran_Emm: folds 
tasty_fish90: folds 
lawlex_2: folds 
mattie98.ms: folds 
Vadim755: calls $0.06
*** FLOP *** [Ah Jd Jc]
Vadim755: checks 
DovileGa: bets $0.10
Vadim755: raises $0.10 to $0.20
DovileGa: calls $0.10
*** TURN *** [Ah Jd Jc] [Kd]
Vadim755: checks 
DovileGa: bets $0.63 and is all-in
Vadim755: calls $0.63
*** RIVER *** [Ah Jd Jc Kd] [2d]
*** SHOW DOWN ***
Vadim755: shows [As 7c] (two pair, Aces and Jacks)
DovileGa: shows [Kc Ad] (two pair, Aces and Kings)
DovileGa collected $1.82 from pot
Vadim755 cashed out the hand for $0.05
*** SUMMARY ***
Total pot $1.89 | Rake $0.07 
Board [Ah Jd Jc Kd 2d]
Seat 1: mattie98.ms (big blind) folded before Flop
Seat 2: Vadim755 showed [As 7c] and lost with two pair, Aces and Jacks (cashed out).
Seat 3: DovileGa showed [Kc Ad] and won ($1.82) with two pair, Aces and Kings
Seat 4: Fran_Emm folded before Flop (didn't bet)
Seat 5: tasty_fish90 (button) folded before Flop (didn't bet)
Seat 6: lawlex_2 (small blind) folded before Flop



PokerStars Hand #213053254890:  Hold'em No Limit ($0.01/$0.02 USD) - 2020/05/01 12:24:37 MSK [2020/05/01 5:24:37 ET]
Table 'Okavango III' 6-max Seat #6 is the button
Seat 1: mattie98.ms ($2.41 in chips) 
Seat 2: Vadim755 ($0.51 in chips) 
Seat 3: DovileGa ($1.82 in chips) 
Seat 4: Fran_Emm ($2 in chips) 
Seat 5: tasty_fish90 ($2.96 in chips) 
Seat 6: lawlex_2 ($1.94 in chips) 
mattie98.ms: posts small blind $0.01
Vadim755: posts big blind $0.02
*** HOLE CARDS ***
Dealt to lawlex_2 [Jd Ah]
DovileGa: folds 
Fran_Emm: folds 
tasty_fish90: folds 
lawlex_2: raises $0.05 to $0.07
mattie98.ms: calls $0.06
Vadim755: calls $0.05
*** FLOP *** [4s 7h 8c]
mattie98.ms: checks 
Vadim755: bets $0.04
lawlex_2: calls $0.04
mattie98.ms: folds 
*** TURN *** [4s 7h 8c] [Kh]
Vadim755: bets $0.06
lawlex_2: folds 
Uncalled bet ($0.06) returned to Vadim755
Vadim755 collected $0.28 from pot
Vadim755: doesn't show hand 
*** SUMMARY ***
Total pot $0.29 | Rake $0.01 
Board [4s 7h 8c Kh]
Seat 1: mattie98.ms (small blind) folded on the Flop
Seat 2: Vadim755 (big blind) collected ($0.28)
Seat 3: DovileGa folded before Flop (didn't bet)
Seat 4: Fran_Emm folded before Flop (didn't bet)
Seat 5: tasty_fish90 folded before Flop (didn't bet)
Seat 6: lawlex_2 (button) folded on the Turn



PokerStars Hand #213053279172:  Hold'em No Limit ($0.01/$0.02 USD) - 2020/05/01 12:25:23 MSK [2020/05/01 5:25:23 ET]
Table 'Okavango III' 6-max Seat #1 is the button
Seat 1: mattie98.ms ($2.34 in chips) 
Seat 2: Vadim755 ($0.68 in chips) 
Seat 3: DovileGa ($1.82 in chips) 
Seat 4: Fran_Emm ($2 in chips) 
Seat 5: tasty_fish90 ($2.96 in chips) 
Seat 6: lawlex_2 ($1.83 in chips) 
Vadim755: posts small blind $0.01
DovileGa: posts big blind $0.02
*** HOLE CARDS ***
Dealt to lawlex_2 [5c 7h]
Fran_Emm: folds 
tasty_fish90: folds 
lawlex_2: folds 
mattie98.ms has timed out
mattie98.ms: folds 
Vadim755: raises $0.02 to $0.04
DovileGa: folds 
Uncalled bet ($0.02) returned to Vadim755
Vadim755 collected $0.04 from pot
Vadim755: doesn't show hand 
*** SUMMARY ***
Total pot $0.04 | Rake $0 
Seat 1: mattie98.ms (button) folded before Flop (didn't bet)
Seat 2: Vadim755 (small blind) collected ($0.04)
Seat 3: DovileGa (big blind) folded before Flop
Seat 4: Fran_Emm folded before Flop (didn't bet)
Seat 5: tasty_fish90 folded before Flop (didn't bet)
Seat 6: lawlex_2 folded before Flop (didn't bet)



PokerStars Hand #213053290155:  Hold'em No Limit ($0.01/$0.02 USD) - 2020/05/01 12:25:44 MSK [2020/05/01 5:25:44 ET]
Table 'Okavango III' 6-max Seat #2 is the button
Seat 1: mattie98.ms ($2.34 in chips) 
Seat 2: Vadim755 ($0.70 in chips) 
Seat 3: DovileGa ($1.80 in chips) 
Seat 4: Fran_Emm ($2 in chips) 
Seat 5: tasty_fish90 ($2.96 in chips) 
Seat 6: lawlex_2 ($1.83 in chips) 
DovileGa: posts small blind $0.01
Fran_Emm: posts big blind $0.02
*** HOLE CARDS ***
Dealt to lawlex_2 [6s Ks]
tasty_fish90: folds 
lawlex_2: calls $0.02
mattie98.ms: calls $0.02
Vadim755: calls $0.02
DovileGa: calls $0.01
Fran_Emm: checks 
*** FLOP *** [7c 5c 8h]
DovileGa: bets $0.04
Fran_Emm: folds 
lawlex_2: calls $0.04
mattie98.ms: folds 
Vadim755: folds 
*** TURN *** [7c 5c 8h] [Ac]
DovileGa: checks 
lawlex_2: bets $0.11
DovileGa: folds 
Uncalled bet ($0.11) returned to lawlex_2
lawlex_2 collected $0.17 from pot
lawlex_2: doesn't show hand 
*** SUMMARY ***
Total pot $0.18 | Rake $0.01 
Board [7c 5c 8h Ac]
Seat 1: mattie98.ms folded on the Flop
Seat 2: Vadim755 (button) folded on the Flop
Seat 3: DovileGa (small blind) folded on the Turn
Seat 4: Fran_Emm (big blind) folded on the Flop
Seat 5: tasty_fish90 folded before Flop (didn't bet)
Seat 6: lawlex_2 collected ($0.17)



PokerStars Hand #213053317305:  Hold'em No Limit ($0.01/$0.02 USD) - 2020/05/01 12:26:36 MSK [2020/05/01 5:26:36 ET]
Table 'Okavango III' 6-max Seat #3 is the button
Seat 1: mattie98.ms ($2.32 in chips) 
Seat 2: Vadim755 ($0.68 in chips) 
Seat 3: DovileGa ($1.74 in chips) 
Seat 4: Fran_Emm ($2 in chips) 
Seat 5: tasty_fish90 ($2.96 in chips) 
Seat 6: lawlex_2 ($1.94 in chips) 
Fran_Emm: posts small blind $0.01
tasty_fish90: posts big blind $0.02
*** HOLE CARDS ***
Dealt to lawlex_2 [6c 9d]
lawlex_2: folds 
mattie98.ms: calls $0.02
Vadim755: folds 
DovileGa: folds 
Fran_Emm: folds 
tasty_fish90: checks 
*** FLOP *** [6s 9h 4h]
tasty_fish90: checks 
mattie98.ms: checks 
*** TURN *** [6s 9h 4h] [2d]
tasty_fish90: bets $0.03
mattie98.ms: calls $0.03
*** RIVER *** [6s 9h 4h 2d] [Jc]
tasty_fish90: checks 
mattie98.ms: bets $0.02
tasty_fish90: raises $0.08 to $0.10
mattie98.ms: raises $0.08 to $0.18
tasty_fish90: calls $0.08
*** SHOW DOWN ***
mattie98.ms: shows [3h 9s] (a pair of Nines)
tasty_fish90: shows [2c 4c] (two pair, Fours and Deuces)
tasty_fish90 collected $0.45 from pot
*** SUMMARY ***
Total pot $0.47 | Rake $0.02 
Board [6s 9h 4h 2d Jc]
Seat 1: mattie98.ms showed [3h 9s] and lost with a pair of Nines
Seat 2: Vadim755 folded before Flop (didn't bet)
Seat 3: DovileGa (button) folded before Flop (didn't bet)
Seat 4: Fran_Emm (small blind) folded before Flop
Seat 5: tasty_fish90 (big blind) showed [2c 4c] and won ($0.45) with two pair, Fours and Deuces
Seat 6: lawlex_2 folded before Flop (didn't bet)



PokerStars Hand #213053341321:  Hold'em No Limit ($0.01/$0.02 USD) - 2020/05/01 12:27:21 MSK [2020/05/01 5:27:21 ET]
Table 'Okavango III' 6-max Seat #4 is the button
Seat 1: mattie98.ms ($2.09 in chips) 
Seat 2: Vadim755 ($0.68 in chips) 
Seat 3: DovileGa ($1.74 in chips) 
Seat 4: Fran_Emm ($2 in chips) 
Seat 5: tasty_fish90 ($3.18 in chips) 
Seat 6: lawlex_2 ($1.94 in chips) 
tasty_fish90: posts small blind $0.01
lawlex_2: posts big blind $0.02
*** HOLE CARDS ***
Dealt to lawlex_2 [5h Ah]
mattie98.ms: raises $0.02 to $0.04
Vadim755: folds 
DovileGa: calls $0.04
Fran_Emm: folds 
tasty_fish90: folds 
lawlex_2: calls $0.02
*** FLOP *** [Kc Kh 9c]
lawlex_2: checks 
mattie98.ms: checks 
DovileGa: checks 
*** TURN *** [Kc Kh 9c] [Td]
lawlex_2: bets $0.09
mattie98.ms: calls $0.09
DovileGa: folds 
*** RIVER *** [Kc Kh 9c Td] [2h]
lawlex_2: checks 
mattie98.ms: bets $0.15
lawlex_2: folds 
Uncalled bet ($0.15) returned to mattie98.ms
mattie98.ms collected $0.30 from pot
mattie98.ms: doesn't show hand 
*** SUMMARY ***
Total pot $0.31 | Rake $0.01 
Board [Kc Kh 9c Td 2h]
Seat 1: mattie98.ms collected ($0.30)
Seat 2: Vadim755 folded before Flop (didn't bet)
Seat 3: DovileGa folded on the Turn
Seat 4: Fran_Emm (button) folded before Flop (didn't bet)
Seat 5: tasty_fish90 (small blind) folded before Flop
Seat 6: lawlex_2 (big blind) folded on the River



PokerStars Hand #213053363564:  Hold'em No Limit ($0.01/$0.02 USD) - 2020/05/01 12:28:03 MSK [2020/05/01 5:28:03 ET]
Table 'Okavango III' 6-max Seat #5 is the button
Seat 1: mattie98.ms ($2.26 in chips) 
Seat 2: Vadim755 ($0.68 in chips) 
Seat 3: DovileGa ($1.70 in chips) 
Seat 4: Fran_Emm ($2 in chips) 
Seat 5: tasty_fish90 ($3.17 in chips) 
Seat 6: lawlex_2 ($1.81 in chips) 
lawlex_2: posts small blind $0.01
mattie98.ms: posts big blind $0.02
*** HOLE CARDS ***
Dealt to lawlex_2 [Kd Js]
Vadim755: raises $0.02 to $0.04
DovileGa: folds 
Fran_Emm: folds 
tasty_fish90 has timed out
tasty_fish90: folds 
lawlex_2: calls $0.03
mattie98.ms: calls $0.02
*** FLOP *** [9s Qs 7c]
lawlex_2: checks 
mattie98.ms: checks 
Vadim755: bets $0.04
lawlex_2: calls $0.04
mattie98.ms: calls $0.04
*** TURN *** [9s Qs 7c] [Qh]
lawlex_2: checks 
mattie98.ms: checks 
Vadim755: bets $0.06
lawlex_2: folds 
mattie98.ms: folds 
Uncalled bet ($0.06) returned to Vadim755
Vadim755 collected $0.23 from pot
Vadim755: doesn't show hand 
*** SUMMARY ***
Total pot $0.24 | Rake $0.01 
Board [9s Qs 7c Qh]
Seat 1: mattie98.ms (big blind) folded on the Turn
Seat 2: Vadim755 collected ($0.23)
Seat 3: DovileGa folded before Flop (didn't bet)
Seat 4: Fran_Emm folded before Flop (didn't bet)
Seat 5: tasty_fish90 (button) folded before Flop (didn't bet)
Seat 6: lawlex_2 (small blind) folded on the Turn



PokerStars Hand #213053401886:  Hold'em No Limit ($0.01/$0.02 USD) - 2020/05/01 12:29:15 MSK [2020/05/01 5:29:15 ET]
Table 'Okavango III' 6-max Seat #6 is the button
Seat 1: mattie98.ms ($2.18 in chips) 
Seat 2: Vadim755 ($0.83 in chips) 
Seat 3: DovileGa ($1.70 in chips) 
Seat 4: Fran_Emm ($2 in chips) 
Seat 5: tasty_fish90 ($3.17 in chips) 
Seat 6: lawlex_2 ($1.73 in chips) 
mattie98.ms: posts small blind $0.01
Vadim755: posts big blind $0.02
*** HOLE CARDS ***
Dealt to lawlex_2 [9s 6c]
DovileGa: folds 
Fran_Emm: raises $0.04 to $0.06
tasty_fish90: folds 
lawlex_2: folds 
mattie98.ms: folds 
Vadim755: folds 
Uncalled bet ($0.04) returned to Fran_Emm
mattie98.ms leaves the table
Fran_Emm collected $0.05 from pot
*** SUMMARY ***
Total pot $0.05 | Rake $0 
Seat 1: mattie98.ms (small blind) folded before Flop
Seat 2: Vadim755 (big blind) folded before Flop
Seat 3: DovileGa folded before Flop (didn't bet)
Seat 4: Fran_Emm collected ($0.05)
Seat 5: tasty_fish90 folded before Flop (didn't bet)
Seat 6: lawlex_2 (button) folded before Flop (didn't bet)



PokerStars Hand #213053411520:  Hold'em No Limit ($0.01/$0.02 USD) - 2020/05/01 12:29:33 MSK [2020/05/01 5:29:33 ET]
Table 'Okavango III' 6-max Seat #2 is the button
Seat 2: Vadim755 ($0.81 in chips) 
Seat 3: DovileGa ($1.70 in chips) 
Seat 4: Fran_Emm ($2.03 in chips) 
Seat 5: tasty_fish90 ($3.17 in chips) 
Seat 6: lawlex_2 ($1.73 in chips) 
DovileGa: posts small blind $0.01
Fran_Emm: posts big blind $0.02
*** HOLE CARDS ***
Dealt to lawlex_2 [Ts 2h]
tasty_fish90 has timed out
tasty_fish90: folds 
lawlex_2: folds 
Vadim755: raises $0.02 to $0.04
DovileGa: calls $0.03
Fran_Emm: calls $0.02
*** FLOP *** [8d 9s Tc]
gavrosh5555 joins the table at seat #1 
DovileGa: checks 
Fran_Emm: checks 
Vadim755: bets $0.04
DovileGa: folds 
Fran_Emm: calls $0.04
*** TURN *** [8d 9s Tc] [4c]
Fran_Emm: checks 
Vadim755: bets $0.04
Fran_Emm: calls $0.04
*** RIVER *** [8d 9s Tc 4c] [Qh]
Fran_Emm: checks 
Vadim755: bets $0.12
Fran_Emm: folds 
Uncalled bet ($0.12) returned to Vadim755
Vadim755 collected $0.27 from pot
Vadim755: doesn't show hand 
*** SUMMARY ***
Total pot $0.28 | Rake $0.01 
Board [8d 9s Tc 4c Qh]
Seat 2: Vadim755 (button) collected ($0.27)
Seat 3: DovileGa (small blind) folded on the Flop
Seat 4: Fran_Emm (big blind) folded on the River
Seat 5: tasty_fish90 folded before Flop (didn't bet)
Seat 6: lawlex_2 folded before Flop (didn't bet)



PokerStars Hand #213053458100:  Hold'em No Limit ($0.01/$0.02 USD) - 2020/05/01 12:31:01 MSK [2020/05/01 5:31:01 ET]
Table 'Okavango III' 6-max Seat #3 is the button
Seat 1: gavrosh5555 ($0.80 in chips) 
Seat 2: Vadim755 ($0.96 in chips) 
Seat 3: DovileGa ($1.66 in chips) 
Seat 4: Fran_Emm ($2 in chips) 
Seat 5: tasty_fish90 ($3.17 in chips) 
Seat 6: lawlex_2 ($1.73 in chips) 
Fran_Emm: posts small blind $0.01
tasty_fish90: posts big blind $0.02
gavrosh5555: posts big blind $0.02
*** HOLE CARDS ***
Dealt to lawlex_2 [8d 6d]
lawlex_2: folds 
gavrosh5555: checks 
Vadim755: folds 
DovileGa: raises $0.02 to $0.04
Fran_Emm: calls $0.03
tasty_fish90: folds 
gavrosh5555: calls $0.02
*** FLOP *** [Ac Kd Ah]
Fran_Emm: checks 
gavrosh5555: bets $0.07
DovileGa: folds 
Fran_Emm: folds 
Uncalled bet ($0.07) returned to gavrosh5555
gavrosh5555 collected $0.14 from pot
*** SUMMARY ***
Total pot $0.14 | Rake $0 
Board [Ac Kd Ah]
Seat 1: gavrosh5555 collected ($0.14)
Seat 2: Vadim755 folded before Flop (didn't bet)
Seat 3: DovileGa (button) folded on the Flop
Seat 4: Fran_Emm (small blind) folded on the Flop
Seat 5: tasty_fish90 (big blind) folded before Flop
Seat 6: lawlex_2 folded before Flop (didn't bet)



PokerStars Hand #213053475349:  Hold'em No Limit ($0.01/$0.02 USD) - 2020/05/01 12:31:33 MSK [2020/05/01 5:31:33 ET]
Table 'Okavango III' 6-max Seat #4 is the button
Seat 1: gavrosh5555 ($0.90 in chips) 
Seat 2: Vadim755 ($0.96 in chips) 
Seat 3: DovileGa ($1.62 in chips) 
Seat 4: Fran_Emm ($2 in chips) 
Seat 5: tasty_fish90 ($3.15 in chips) 
Seat 6: lawlex_2 ($1.73 in chips) 
tasty_fish90: posts small blind $0.01
lawlex_2: posts big blind $0.02
*** HOLE CARDS ***
Dealt to lawlex_2 [9c 8c]
gavrosh5555: calls $0.02
Vadim755 has timed out
Vadim755: folds 
DovileGa: calls $0.02
Fran_Emm: folds 
tasty_fish90: raises $0.04 to $0.06
lawlex_2: calls $0.04
gavrosh5555: calls $0.04
DovileGa: folds 
*** FLOP *** [7d 9d 8h]
tasty_fish90: checks 
lawlex_2: checks 
DovileGa leaves the table
gavrosh5555: bets $0.10
UnRRRReal joins the table at seat #3 
tasty_fish90: calls $0.10
lawlex_2: calls $0.10
*** TURN *** [7d 9d 8h] [Qd]
tasty_fish90: checks 
lawlex_2: bets $0.32
gavrosh5555: folds 
tasty_fish90: calls $0.32
*** RIVER *** [7d 9d 8h Qd] [Th]
tasty_fish90: checks 
lawlex_2: checks 
*** SHOW DOWN ***
tasty_fish90: shows [Qc Qs] (three of a kind, Queens)
lawlex_2: mucks hand 
tasty_fish90 collected $1.10 from pot
*** SUMMARY ***
Total pot $1.14 | Rake $0.04 
Board [7d 9d 8h Qd Th]
Seat 1: gavrosh5555 folded on the Turn
Seat 2: Vadim755 folded before Flop (didn't bet)
Seat 3: DovileGa folded before Flop
Seat 4: Fran_Emm (button) folded before Flop (didn't bet)
Seat 5: tasty_fish90 (small blind) showed [Qc Qs] and won ($1.10) with three of a kind, Queens
Seat 6: lawlex_2 (big blind) mucked [9c 8c]



PokerStars Hand #213053509861:  Hold'em No Limit ($0.01/$0.02 USD) - 2020/05/01 12:32:38 MSK [2020/05/01 5:32:38 ET]
Table 'Okavango III' 6-max Seat #5 is the button
Seat 1: gavrosh5555 ($0.74 in chips) 
Seat 2: Vadim755 ($0.96 in chips) 
Seat 4: Fran_Emm ($2 in chips) 
Seat 5: tasty_fish90 ($3.77 in chips) 
Seat 6: lawlex_2 ($1.25 in chips) 
lawlex_2: posts small blind $0.01
gavrosh5555: posts big blind $0.02
UnRRRReal: sits out 
*** HOLE CARDS ***
Dealt to lawlex_2 [Qc 7s]
Vadim755: calls $0.02
Fran_Emm: raises $0.06 to $0.08
tasty_fish90: folds 
lawlex_2: folds 
gavrosh5555: calls $0.06
Vadim755: folds 
*** FLOP *** [Qs 4d 4c]
gavrosh5555: bets $0.09
Fran_Emm: calls $0.09
*** TURN *** [Qs 4d 4c] [6h]
gavrosh5555: bets $0.18
Fran_Emm: calls $0.18
*** RIVER *** [Qs 4d 4c 6h] [Jh]
gavrosh5555: bets $0.39 and is all-in
Fran_Emm: calls $0.39
*** SHOW DOWN ***
gavrosh5555: shows [Js Qd] (two pair, Queens and Jacks)
Fran_Emm: shows [Qh 9h] (two pair, Queens and Fours)
gavrosh5555 collected $1.46 from pot
*** SUMMARY ***
Total pot $1.51 | Rake $0.05 
Board [Qs 4d 4c 6h Jh]
Seat 1: gavrosh5555 (big blind) showed [Js Qd] and won ($1.46) with two pair, Queens and Jacks
Seat 2: Vadim755 folded before Flop
Seat 4: Fran_Emm showed [Qh 9h] and lost with two pair, Queens and Fours
Seat 5: tasty_fish90 (button) folded before Flop (didn't bet)
Seat 6: lawlex_2 (small blind) folded before Flop



PokerStars Hand #213053531029:  Hold'em No Limit ($0.01/$0.02 USD) - 2020/05/01 12:33:18 MSK [2020/05/01 5:33:18 ET]
Table 'Okavango III' 6-max Seat #6 is the button
Seat 1: gavrosh5555 ($1.46 in chips) 
Seat 2: Vadim755 ($0.94 in chips) 
Seat 4: Fran_Emm ($2 in chips) 
Seat 5: tasty_fish90 ($3.77 in chips) 
Seat 6: lawlex_2 ($1.24 in chips) 
gavrosh5555: posts small blind $0.01
Vadim755: posts big blind $0.02
UnRRRReal: sits out 
*** HOLE CARDS ***
Dealt to lawlex_2 [6s Qc]
Fran_Emm: folds 
tasty_fish90: folds 
lawlex_2: folds 
gavrosh5555: raises $0.02 to $0.04
Vadim755 is connected 
Vadim755: folds 
Uncalled bet ($0.02) returned to gavrosh5555
gavrosh5555 collected $0.04 from pot
*** SUMMARY ***
Total pot $0.04 | Rake $0 
Seat 1: gavrosh5555 (small blind) collected ($0.04)
Seat 2: Vadim755 (big blind) folded before Flop
Seat 4: Fran_Emm folded before Flop (didn't bet)
Seat 5: tasty_fish90 folded before Flop (didn't bet)
Seat 6: lawlex_2 (button) folded before Flop (didn't bet)



PokerStars Hand #213053556099:  Hold'em No Limit ($0.01/$0.02 USD) - 2020/05/01 12:34:05 MSK [2020/05/01 5:34:05 ET]
Table 'Okavango III' 6-max Seat #1 is the button
Seat 1: gavrosh5555 ($1.48 in chips) 
Seat 2: Vadim755 ($0.92 in chips) 
Seat 3: UnRRRReal ($2 in chips) 
Seat 4: Fran_Emm ($2 in chips) 
Seat 5: tasty_fish90 ($3.77 in chips) 
Seat 6: lawlex_2 ($1.24 in chips) 
Vadim755: posts small blind $0.01
UnRRRReal: posts big blind $0.02
*** HOLE CARDS ***
Dealt to lawlex_2 [8s 3d]
Fran_Emm: folds 
tasty_fish90: folds 
lawlex_2: folds 
gavrosh5555: folds 
Vadim755: raises $0.02 to $0.04
UnRRRReal: calls $0.02
*** FLOP *** [Th Jc Kh]
Vadim755: bets $0.04
UnRRRReal: calls $0.04
*** TURN *** [Th Jc Kh] [Ad]
Vadim755: bets $0.04
UnRRRReal: raises $0.23 to $0.27
Vadim755: folds 
Uncalled bet ($0.23) returned to UnRRRReal
UnRRRReal collected $0.23 from pot
*** SUMMARY ***
Total pot $0.24 | Rake $0.01 
Board [Th Jc Kh Ad]
Seat 1: gavrosh5555 (button) folded before Flop (didn't bet)
Seat 2: Vadim755 (small blind) folded on the Turn
Seat 3: UnRRRReal (big blind) collected ($0.23)
Seat 4: Fran_Emm folded before Flop (didn't bet)
Seat 5: tasty_fish90 folded before Flop (didn't bet)
Seat 6: lawlex_2 folded before Flop (didn't bet)



PokerStars Hand #213053577737:  Hold'em No Limit ($0.01/$0.02 USD) - 2020/05/01 12:34:45 MSK [2020/05/01 5:34:45 ET]
Table 'Okavango III' 6-max Seat #2 is the button
Seat 1: gavrosh5555 ($1.48 in chips) 
Seat 2: Vadim755 ($0.80 in chips) 
Seat 3: UnRRRReal ($2.11 in chips) 
Seat 4: Fran_Emm ($2 in chips) 
Seat 5: tasty_fish90 ($3.77 in chips) 
Seat 6: lawlex_2 ($1.24 in chips) 
UnRRRReal: posts small blind $0.01
Fran_Emm: posts big blind $0.02
*** HOLE CARDS ***
Dealt to lawlex_2 [2s Kh]
tasty_fish90: folds 
lawlex_2: folds 
gavrosh5555: calls $0.02
Vadim755: folds 
UnRRRReal: folds 
Fran_Emm: raises $0.08 to $0.10
gavrosh5555: folds 
Uncalled bet ($0.08) returned to Fran_Emm
Fran_Emm collected $0.05 from pot
*** SUMMARY ***
Total pot $0.05 | Rake $0 
Seat 1: gavrosh5555 folded before Flop
Seat 2: Vadim755 (button) folded before Flop (didn't bet)
Seat 3: UnRRRReal (small blind) folded before Flop
Seat 4: Fran_Emm (big blind) collected ($0.05)
Seat 5: tasty_fish90 folded before Flop (didn't bet)
Seat 6: lawlex_2 folded before Flop (didn't bet)



PokerStars Hand #213053588224:  Hold'em No Limit ($0.01/$0.02 USD) - 2020/05/01 12:35:04 MSK [2020/05/01 5:35:04 ET]
Table 'Okavango III' 6-max Seat #3 is the button
Seat 1: gavrosh5555 ($1.46 in chips) 
Seat 2: Vadim755 ($0.80 in chips) 
Seat 3: UnRRRReal ($2.10 in chips) 
Seat 4: Fran_Emm ($2.03 in chips) 
Seat 5: tasty_fish90 ($3.77 in chips) 
Seat 6: lawlex_2 ($1.24 in chips) 
Fran_Emm: posts small blind $0.01
tasty_fish90: posts big blind $0.02
*** HOLE CARDS ***
Dealt to lawlex_2 [3s 8d]
lawlex_2: folds 
gavrosh5555: raises $0.02 to $0.04
Vadim755: folds 
UnRRRReal: folds 
Fran_Emm: calls $0.03
tasty_fish90: calls $0.02
*** FLOP *** [Qd 9d 7s]
Fran_Emm: bets $0.08
tasty_fish90: folds 
gavrosh5555: folds 
Uncalled bet ($0.08) returned to Fran_Emm
Fran_Emm collected $0.12 from pot
*** SUMMARY ***
Total pot $0.12 | Rake $0 
Board [Qd 9d 7s]
Seat 1: gavrosh5555 folded on the Flop
Seat 2: Vadim755 folded before Flop (didn't bet)
Seat 3: UnRRRReal (button) folded before Flop (didn't bet)
Seat 4: Fran_Emm (small blind) collected ($0.12)
Seat 5: tasty_fish90 (big blind) folded on the Flop
Seat 6: lawlex_2 folded before Flop (didn't bet)



PokerStars Hand #213053601286:  Hold'em No Limit ($0.01/$0.02 USD) - 2020/05/01 12:35:29 MSK [2020/05/01 5:35:29 ET]
Table 'Okavango III' 6-max Seat #4 is the button
Seat 1: gavrosh5555 ($1.42 in chips) 
Seat 2: Vadim755 ($0.80 in chips) 
Seat 3: UnRRRReal ($2.10 in chips) 
Seat 4: Fran_Emm ($2.11 in chips) 
Seat 5: tasty_fish90 ($3.73 in chips) 
Seat 6: lawlex_2 ($1.24 in chips) 
tasty_fish90: posts small blind $0.01
lawlex_2: posts big blind $0.02
*** HOLE CARDS ***
Dealt to lawlex_2 [5s Jh]
gavrosh5555: folds 
Vadim755: folds 
UnRRRReal: folds 
Fran_Emm: folds 
tasty_fish90: folds 
Uncalled bet ($0.01) returned to lawlex_2
lawlex_2 collected $0.02 from pot
lawlex_2: doesn't show hand 
*** SUMMARY ***
Total pot $0.02 | Rake $0 
Seat 1: gavrosh5555 folded before Flop (didn't bet)
Seat 2: Vadim755 folded before Flop (didn't bet)
Seat 3: UnRRRReal folded before Flop (didn't bet)
Seat 4: Fran_Emm (button) folded before Flop (didn't bet)
Seat 5: tasty_fish90 (small blind) folded before Flop
Seat 6: lawlex_2 (big blind) collected ($0.02)



PokerStars Hand #213053608519:  Hold'em No Limit ($0.01/$0.02 USD) - 2020/05/01 12:35:42 MSK [2020/05/01 5:35:42 ET]
Table 'Okavango III' 6-max Seat #5 is the button
Seat 1: gavrosh5555 ($1.42 in chips) 
Seat 2: Vadim755 ($0.80 in chips) 
Seat 3: UnRRRReal ($2.10 in chips) 
Seat 4: Fran_Emm ($2.11 in chips) 
Seat 5: tasty_fish90 ($3.72 in chips) 
Seat 6: lawlex_2 ($1.25 in chips) 
lawlex_2: posts small blind $0.01
gavrosh5555: posts big blind $0.02
*** HOLE CARDS ***
Dealt to lawlex_2 [Kd Qs]
Vadim755: raises $0.02 to $0.04
UnRRRReal: folds 
Fran_Emm: folds 
tasty_fish90: folds 
lawlex_2: calls $0.03
gavrosh5555: folds 
*** FLOP *** [4s 6d 8d]
lawlex_2: bets $0.07
Vadim755: calls $0.07
*** TURN *** [4s 6d 8d] [Kc]
lawlex_2: bets $0.15
Vadim755: calls $0.15
*** RIVER *** [4s 6d 8d Kc] [7c]
lawlex_2: checks 
Vadim755: bets $0.26
lawlex_2: calls $0.26
*** SHOW DOWN ***
Vadim755: shows [8c 8h] (three of a kind, Eights)
lawlex_2: mucks hand 
Vadim755 collected $1.02 from pot
*** SUMMARY ***
Total pot $1.06 | Rake $0.04 
Board [4s 6d 8d Kc 7c]
Seat 1: gavrosh5555 (big blind) folded before Flop
Seat 2: Vadim755 showed [8c 8h] and won ($1.02) with three of a kind, Eights
Seat 3: UnRRRReal folded before Flop (didn't bet)
Seat 4: Fran_Emm folded before Flop (didn't bet)
Seat 5: tasty_fish90 (button) folded before Flop (didn't bet)
Seat 6: lawlex_2 (small blind) mucked [Kd Qs]



PokerStars Hand #213053627195:  Hold'em No Limit ($0.01/$0.02 USD) - 2020/05/01 12:36:17 MSK [2020/05/01 5:36:17 ET]
Table 'Okavango III' 6-max Seat #6 is the button
Seat 1: gavrosh5555 ($1.40 in chips) 
Seat 2: Vadim755 ($1.30 in chips) 
Seat 3: UnRRRReal ($2.10 in chips) 
Seat 4: Fran_Emm ($2.11 in chips) 
Seat 5: tasty_fish90 ($3.72 in chips) 
Seat 6: lawlex_2 ($0.73 in chips) 
gavrosh5555: posts small blind $0.01
Vadim755: posts big blind $0.02
*** HOLE CARDS ***
Dealt to lawlex_2 [2h 8s]
UnRRRReal: folds 
Fran_Emm: folds 
tasty_fish90 has timed out
tasty_fish90: folds 
lawlex_2: folds 
gavrosh5555: calls $0.01
Vadim755: checks 
*** FLOP *** [8c 9s 8h]
gavrosh5555: checks 
Vadim755: bets $0.02
gavrosh5555: calls $0.02
*** TURN *** [8c 9s 8h] [Td]
gavrosh5555: checks 
Vadim755: bets $0.04
gavrosh5555: calls $0.04
*** RIVER *** [8c 9s 8h Td] [Kc]
gavrosh5555: bets $0.04
Vadim755: folds 
Uncalled bet ($0.04) returned to gavrosh5555
gavrosh5555 collected $0.15 from pot
*** SUMMARY ***
Total pot $0.16 | Rake $0.01 
Board [8c 9s 8h Td Kc]
Seat 1: gavrosh5555 (small blind) collected ($0.15)
Seat 2: Vadim755 (big blind) folded on the River
Seat 3: UnRRRReal folded before Flop (didn't bet)
Seat 4: Fran_Emm folded before Flop (didn't bet)
Seat 5: tasty_fish90 folded before Flop (didn't bet)
Seat 6: lawlex_2 (button) folded before Flop (didn't bet)



PokerStars Hand #213053650268:  Hold'em No Limit ($0.01/$0.02 USD) - 2020/05/01 12:36:59 MSK [2020/05/01 5:36:59 ET]
Table 'Okavango III' 6-max Seat #1 is the button
Seat 1: gavrosh5555 ($1.47 in chips) 
Seat 2: Vadim755 ($1.22 in chips) 
Seat 3: UnRRRReal ($2.10 in chips) 
Seat 4: Fran_Emm ($2.11 in chips) 
Seat 6: lawlex_2 ($0.73 in chips) 
Vadim755: posts small blind $0.01
UnRRRReal: posts big blind $0.02
*** HOLE CARDS ***
Dealt to lawlex_2 [Ts 5h]
Fran_Emm: raises $0.04 to $0.06
lawlex_2: folds 
gavrosh5555: calls $0.06
Vadim755: folds 
UnRRRReal: calls $0.04
*** FLOP *** [Js 8c 8d]
UnRRRReal: checks 
Fran_Emm: checks 
gavrosh5555: bets $0.06
UnRRRReal: calls $0.06
Fran_Emm: folds 
*** TURN *** [Js 8c 8d] [5c]
UnRRRReal: checks 
gavrosh5555: bets $0.04
UnRRRReal: calls $0.04
*** RIVER *** [Js 8c 8d 5c] [8h]
UnRRRReal: bets $0.38
gavrosh5555: raises $0.93 to $1.31 and is all-in
UnRRRReal: calls $0.93
*** SHOW DOWN ***
gavrosh5555: shows [Jh Kd] (a full house, Eights full of Jacks)
UnRRRReal: shows [4h 4d] (a full house, Eights full of Fours)
gavrosh5555 collected $2.90 from pot
*** SUMMARY ***
Total pot $3.01 | Rake $0.11 
Board [Js 8c 8d 5c 8h]
Seat 1: gavrosh5555 (button) showed [Jh Kd] and won ($2.90) with a full house, Eights full of Jacks
Seat 2: Vadim755 (small blind) folded before Flop
Seat 3: UnRRRReal (big blind) showed [4h 4d] and lost with a full house, Eights full of Fours
Seat 4: Fran_Emm folded on the Flop
Seat 6: lawlex_2 folded before Flop (didn't bet)



PokerStars Hand #213053676001:  Hold'em No Limit ($0.01/$0.02 USD) - 2020/05/01 12:37:47 MSK [2020/05/01 5:37:47 ET]
Table 'Okavango III' 6-max Seat #2 is the button
Seat 1: gavrosh5555 ($2.90 in chips) 
Seat 2: Vadim755 ($1.21 in chips) 
Seat 3: UnRRRReal ($0.80 in chips) 
Seat 4: Fran_Emm ($2.05 in chips) 
Seat 5: tasty_fish90 ($3.72 in chips) 
Seat 6: lawlex_2 ($0.73 in chips) 
UnRRRReal: posts small blind $0.01
Fran_Emm: posts big blind $0.02
*** HOLE CARDS ***
Dealt to lawlex_2 [5s 4s]
tasty_fish90: folds 
lawlex_2: folds 
gavrosh5555: folds 
Vadim755: raises $0.02 to $0.04
UnRRRReal: folds 
gavrosh5555 leaves the table
Fran_Emm: folds 
Uncalled bet ($0.02) returned to Vadim755
Vadim755 collected $0.05 from pot
Vadim755: doesn't show hand 
*** SUMMARY ***
Total pot $0.05 | Rake $0 
Seat 1: gavrosh5555 folded before Flop (didn't bet)
Seat 2: Vadim755 (button) collected ($0.05)
Seat 3: UnRRRReal (small blind) folded before Flop
Seat 4: Fran_Emm (big blind) folded before Flop
Seat 5: tasty_fish90 folded before Flop (didn't bet)
Seat 6: lawlex_2 folded before Flop (didn't bet)



PokerStars Hand #213053684546:  Hold'em No Limit ($0.01/$0.02 USD) - 2020/05/01 12:38:03 MSK [2020/05/01 5:38:03 ET]
Table 'Okavango III' 6-max Seat #3 is the button
Seat 2: Vadim755 ($1.24 in chips) 
Seat 3: UnRRRReal ($1.59 in chips) 
Seat 4: Fran_Emm ($2.03 in chips) 
Seat 5: tasty_fish90 ($3.72 in chips) 
Seat 6: lawlex_2 ($0.73 in chips) 
Fran_Emm: posts small blind $0.01
tasty_fish90: posts big blind $0.02
*** HOLE CARDS ***
Dealt to lawlex_2 [2c 8s]
lawlex_2: folds 
Vadim755: calls $0.02
UnRRRReal: folds 
Fran_Emm: folds 
tasty_fish90: checks 
*** FLOP *** [6s 9d 6c]
tasty_fish90: checks 
Vadim755: bets $0.02
tasty_fish90: calls $0.02
*** TURN *** [6s 9d 6c] [5c]
tasty_fish90: checks 
Vadim755: bets $0.02
tasty_fish90: calls $0.02
*** RIVER *** [6s 9d 6c 5c] [Ks]
tasty_fish90: checks 
Vadim755: checks 
*** SHOW DOWN ***
tasty_fish90: shows [5h 7s] (two pair, Sixes and Fives)
Vadim755: mucks hand 
tasty_fish90 collected $0.13 from pot
*** SUMMARY ***
Total pot $0.13 | Rake $0 
Board [6s 9d 6c 5c Ks]
Seat 2: Vadim755 mucked [Jd 8c]
Seat 3: UnRRRReal (button) folded before Flop (didn't bet)
Seat 4: Fran_Emm (small blind) folded before Flop
Seat 5: tasty_fish90 (big blind) showed [5h 7s] and won ($0.13) with two pair, Sixes and Fives
Seat 6: lawlex_2 folded before Flop (didn't bet)



PokerStars Hand #213053704490:  Hold'em No Limit ($0.01/$0.02 USD) - 2020/05/01 12:38:40 MSK [2020/05/01 5:38:40 ET]
Table 'Okavango III' 6-max Seat #4 is the button
Seat 2: Vadim755 ($1.18 in chips) 
Seat 3: UnRRRReal ($2 in chips) 
Seat 4: Fran_Emm ($2.02 in chips) 
Seat 5: tasty_fish90 ($3.79 in chips) 
Seat 6: lawlex_2 ($0.73 in chips) 
tasty_fish90: posts small blind $0.01
lawlex_2: posts big blind $0.02
*** HOLE CARDS ***
Dealt to lawlex_2 [4h Jh]
Vadim755: raises $0.02 to $0.04
UnRRRReal: folds 
Fran_Emm: folds 
darryl2008 joins the table at seat #1 
Vadim755 is disconnected 
tasty_fish90 has timed out
tasty_fish90: folds 
lawlex_2: folds 
Uncalled bet ($0.02) returned to Vadim755
Vadim755 collected $0.05 from pot
Vadim755: doesn't show hand 
*** SUMMARY ***
Total pot $0.05 | Rake $0 
Seat 2: Vadim755 collected ($0.05)
Seat 3: UnRRRReal folded before Flop (didn't bet)
Seat 4: Fran_Emm (button) folded before Flop (didn't bet)
Seat 5: tasty_fish90 (small blind) folded before Flop
Seat 6: lawlex_2 (big blind) folded before Flop



PokerStars Hand #213053725892:  Hold'em No Limit ($0.01/$0.02 USD) - 2020/05/01 12:39:19 MSK [2020/05/01 5:39:19 ET]
Table 'Okavango III' 6-max Seat #6 is the button
Seat 2: Vadim755 ($1.21 in chips) 
Seat 3: UnRRRReal ($2 in chips) 
Seat 4: Fran_Emm ($2.02 in chips) 
Seat 6: lawlex_2 ($0.71 in chips) 
Vadim755: posts small blind $0.01
UnRRRReal: posts big blind $0.02
*** HOLE CARDS ***
Dealt to lawlex_2 [8h Ks]
Fran_Emm: raises $0.04 to $0.06
lawlex_2: folds 
Vadim755: calls $0.05
UnRRRReal: raises $0.18 to $0.24
Fran_Emm: folds 
Vadim755: folds 
Uncalled bet ($0.18) returned to UnRRRReal
UnRRRReal collected $0.18 from pot
*** SUMMARY ***
Total pot $0.18 | Rake $0 
Seat 2: Vadim755 (small blind) folded before Flop
Seat 3: UnRRRReal (big blind) collected ($0.18)
Seat 4: Fran_Emm folded before Flop
Seat 6: lawlex_2 (button) folded before Flop (didn't bet)



PokerStars Hand #213053737162:  Hold'em No Limit ($0.01/$0.02 USD) - 2020/05/01 12:39:40 MSK [2020/05/01 5:39:40 ET]
Table 'Okavango III' 6-max Seat #2 is the button
Seat 1: darryl2008 ($0.80 in chips) 
Seat 2: Vadim755 ($1.15 in chips) 
Seat 3: UnRRRReal ($2.12 in chips) 
Seat 4: Fran_Emm ($2 in chips) 
Seat 5: tasty_fish90 ($3.78 in chips) 
Seat 6: lawlex_2 ($0.71 in chips) 
UnRRRReal: posts small blind $0.01
Fran_Emm: posts big blind $0.02
darryl2008: posts big blind $0.02
*** HOLE CARDS ***
Dealt to lawlex_2 [Jd 2s]
tasty_fish90 has timed out
tasty_fish90: folds 
lawlex_2: folds 
darryl2008: raises $0.22 to $0.24
Vadim755: folds 
UnRRRReal: folds 
Fran_Emm: folds 
Uncalled bet ($0.22) returned to darryl2008
darryl2008 collected $0.05 from pot
darryl2008: doesn't show hand 
*** SUMMARY ***
Total pot $0.05 | Rake $0 
Seat 1: darryl2008 collected ($0.05)
Seat 2: Vadim755 (button) folded before Flop (didn't bet)
Seat 3: UnRRRReal (small blind) folded before Flop
Seat 4: Fran_Emm (big blind) folded before Flop
Seat 5: tasty_fish90 folded before Flop (didn't bet)
Seat 6: lawlex_2 folded before Flop (didn't bet)



PokerStars Hand #213053753971:  Hold'em No Limit ($0.01/$0.02 USD) - 2020/05/01 12:40:11 MSK [2020/05/01 5:40:11 ET]
Table 'Okavango III' 6-max Seat #3 is the button
Seat 1: darryl2008 ($0.83 in chips) 
Seat 2: Vadim755 ($1.15 in chips) 
Seat 3: UnRRRReal ($2.11 in chips) 
Seat 4: Fran_Emm ($2 in chips) 
Seat 5: tasty_fish90 ($3.78 in chips) 
Seat 6: lawlex_2 ($0.71 in chips) 
Fran_Emm: posts small blind $0.01
tasty_fish90: posts big blind $0.02
*** HOLE CARDS ***
Dealt to lawlex_2 [Ac 3s]
lawlex_2: raises $0.04 to $0.06
darryl2008: folds 
Vadim755: folds 
UnRRRReal: folds 
Fran_Emm: calls $0.05
tasty_fish90: calls $0.04
*** FLOP *** [8d 7s Kh]
Fran_Emm: checks 
tasty_fish90: checks 
lawlex_2: checks 
*** TURN *** [8d 7s Kh] [7h]
Fran_Emm: bets $0.10
tasty_fish90: calls $0.10
lawlex_2: folds 
*** RIVER *** [8d 7s Kh 7h] [6c]
Fran_Emm: bets $0.36
tasty_fish90: folds 
Uncalled bet ($0.36) returned to Fran_Emm
Fran_Emm collected $0.37 from pot
*** SUMMARY ***
Total pot $0.38 | Rake $0.01 
Board [8d 7s Kh 7h 6c]
Seat 1: darryl2008 folded before Flop (didn't bet)
Seat 2: Vadim755 folded before Flop (didn't bet)
Seat 3: UnRRRReal (button) folded before Flop (didn't bet)
Seat 4: Fran_Emm (small blind) collected ($0.37)
Seat 5: tasty_fish90 (big blind) folded on the River
Seat 6: lawlex_2 folded on the Turn



PokerStars Hand #213053776359:  Hold'em No Limit ($0.01/$0.02 USD) - 2020/05/01 12:40:52 MSK [2020/05/01 5:40:52 ET]
Table 'Okavango III' 6-max Seat #4 is the button
Seat 1: darryl2008 ($0.83 in chips) 
Seat 2: Vadim755 ($1.15 in chips) 
Seat 3: UnRRRReal ($2.11 in chips) 
Seat 4: Fran_Emm ($2.21 in chips) 
Seat 5: tasty_fish90 ($3.62 in chips) 
Seat 6: lawlex_2 ($0.65 in chips) 
tasty_fish90: posts small blind $0.01
lawlex_2: posts big blind $0.02
*** HOLE CARDS ***
Dealt to lawlex_2 [6h Ah]
darryl2008: calls $0.02
Vadim755: raises $0.02 to $0.04
UnRRRReal: folds 
Fran_Emm: calls $0.04
tasty_fish90: folds 
lawlex_2: calls $0.02
darryl2008: calls $0.02
*** FLOP *** [2d 6s 4s]
lawlex_2: bets $0.16
darryl2008: raises $0.63 to $0.79 and is all-in
Vadim755: folds 
Fran_Emm: folds 
lawlex_2: calls $0.45 and is all-in
Uncalled bet ($0.18) returned to darryl2008
*** TURN *** [2d 6s 4s] [Kc]
*** RIVER *** [2d 6s 4s Kc] [Js]
*** SHOW DOWN ***
lawlex_2: shows [6h Ah] (a pair of Sixes)
darryl2008: shows [5c 7c] (high card King)
lawlex_2 cashed out the hand for $0.77 | Cash Out Fee $0.01
*** SUMMARY ***
Total pot $1.39 | Rake $0.05 
Board [2d 6s 4s Kc Js]
Seat 1: darryl2008 showed [5c 7c] and lost with high card King
Seat 2: Vadim755 folded on the Flop
Seat 3: UnRRRReal folded before Flop (didn't bet)
Seat 4: Fran_Emm (button) folded on the Flop
Seat 5: tasty_fish90 (small blind) folded before Flop
Seat 6: lawlex_2 (big blind) showed [6h Ah] and won ($1.34) with a pair of Sixes (pot not awarded as player cashed out)



PokerStars Hand #213053798017:  Hold'em No Limit ($0.01/$0.02 USD) - 2020/05/01 12:41:32 MSK [2020/05/01 5:41:32 ET]
Table 'Okavango III' 6-max Seat #5 is the button
Seat 1: darryl2008 ($0.18 in chips) 
Seat 2: Vadim755 ($1.11 in chips) 
Seat 3: UnRRRReal ($2.11 in chips) 
Seat 4: Fran_Emm ($2.17 in chips) 
Seat 5: tasty_fish90 ($3.61 in chips) 
Seat 6: lawlex_2 ($0.77 in chips) 
lawlex_2: posts small blind $0.01
darryl2008: posts big blind $0.02
*** HOLE CARDS ***
Dealt to lawlex_2 [Js 7s]
Vadim755: folds 
UnRRRReal: folds 
Fran_Emm: raises $0.04 to $0.06
tasty_fish90: raises $0.15 to $0.21
lawlex_2: folds 
darryl2008: calls $0.16 and is all-in
Fran_Emm: folds 
Uncalled bet ($0.03) returned to tasty_fish90
*** FLOP *** [Td Qh 3h]
*** TURN *** [Td Qh 3h] [5d]
*** RIVER *** [Td Qh 3h 5d] [6s]
*** SHOW DOWN ***
darryl2008: shows [Kc 2s] (high card King)
tasty_fish90: shows [Th 8h] (a pair of Tens)
tasty_fish90 collected $0.41 from pot
*** SUMMARY ***
Total pot $0.43 | Rake $0.02 
Board [Td Qh 3h 5d 6s]
Seat 1: darryl2008 (big blind) showed [Kc 2s] and lost with high card King
Seat 2: Vadim755 folded before Flop (didn't bet)
Seat 3: UnRRRReal folded before Flop (didn't bet)
Seat 4: Fran_Emm folded before Flop
Seat 5: tasty_fish90 (button) showed [Th 8h] and won ($0.41) with a pair of Tens
Seat 6: lawlex_2 (small blind) folded before Flop



PokerStars Hand #213053815009:  Hold'em No Limit ($0.01/$0.02 USD) - 2020/05/01 12:42:03 MSK [2020/05/01 5:42:03 ET]
Table 'Okavango III' 6-max Seat #6 is the button
Seat 2: Vadim755 ($1.11 in chips) 
Seat 3: UnRRRReal ($2.11 in chips) 
Seat 4: Fran_Emm ($2.11 in chips) 
Seat 5: tasty_fish90 ($3.84 in chips) 
Seat 6: lawlex_2 ($0.76 in chips) 
Vadim755: posts small blind $0.01
UnRRRReal: posts big blind $0.02
*** HOLE CARDS ***
Dealt to lawlex_2 [As 6s]
Fran_Emm: folds 
tasty_fish90: raises $0.04 to $0.06
lawlex_2: calls $0.06
Vadim755: folds 
UnRRRReal: folds 
*** FLOP *** [Qs 7s Qh]
darryl2008 is disconnected 
tasty_fish90: checks 
lawlex_2: bets $0.14
tasty_fish90: calls $0.14
*** TURN *** [Qs 7s Qh] [Qd]
tasty_fish90: checks 
lawlex_2: bets $0.41
tasty_fish90: calls $0.41
*** RIVER *** [Qs 7s Qh Qd] [3s]
tasty_fish90: checks 
lawlex_2: bets $0.15 and is all-in
tasty_fish90: calls $0.15
*** SHOW DOWN ***
lawlex_2: shows [As 6s] (a flush, Ace high)
tasty_fish90: shows [Th Ah] (three of a kind, Queens)
lawlex_2 collected $1.50 from pot
*** SUMMARY ***
Total pot $1.55 | Rake $0.05 
Board [Qs 7s Qh Qd 3s]
Seat 2: Vadim755 (small blind) folded before Flop
Seat 3: UnRRRReal (big blind) folded before Flop
Seat 4: Fran_Emm folded before Flop (didn't bet)
Seat 5: tasty_fish90 showed [Th Ah] and lost with three of a kind, Queens
Seat 6: lawlex_2 (button) showed [As 6s] and won ($1.50) with a flush, Ace high



PokerStars Hand #213053837643:  Hold'em No Limit ($0.01/$0.02 USD) - 2020/05/01 12:42:45 MSK [2020/05/01 5:42:45 ET]
Table 'Okavango III' 6-max Seat #2 is the button
Seat 2: Vadim755 ($1.10 in chips) 
Seat 3: UnRRRReal ($2.09 in chips) 
Seat 4: Fran_Emm ($2.11 in chips) 
Seat 5: tasty_fish90 ($3.08 in chips) 
Seat 6: lawlex_2 ($1.50 in chips) 
UnRRRReal: posts small blind $0.01
Fran_Emm: posts big blind $0.02
*** HOLE CARDS ***
Dealt to lawlex_2 [7c Ks]
tasty_fish90: calls $0.02
lawlex_2: folds 
Vadim755: folds 
UnRRRReal: raises $0.06 to $0.08
Fran_Emm: folds 
tasty_fish90: calls $0.06
*** FLOP *** [4s 5h 3c]
UnRRRReal: bets $0.09
tasty_fish90: raises $0.18 to $0.27
UnRRRReal: calls $0.18
*** TURN *** [4s 5h 3c] [Kc]
UnRRRReal: checks 
tasty_fish90: bets $0.35
UnRRRReal: calls $0.35
*** RIVER *** [4s 5h 3c Kc] [Tc]
UnRRRReal: bets $1.37
tasty_fish90: calls $1.37
*** SHOW DOWN ***
UnRRRReal: shows [Ac 6d] (high card Ace)
tasty_fish90: shows [4h 4c] (three of a kind, Fours)
tasty_fish90 collected $4.01 from pot
*** SUMMARY ***
Total pot $4.16 | Rake $0.15 
Board [4s 5h 3c Kc Tc]
Seat 2: Vadim755 (button) folded before Flop (didn't bet)
Seat 3: UnRRRReal (small blind) showed [Ac 6d] and lost with high card Ace
Seat 4: Fran_Emm (big blind) folded before Flop
Seat 5: tasty_fish90 showed [4h 4c] and won ($4.01) with three of a kind, Fours
Seat 6: lawlex_2 folded before Flop (didn't bet)



PokerStars Hand #213053871437:  Hold'em No Limit ($0.01/$0.02 USD) - 2020/05/01 12:43:46 MSK [2020/05/01 5:43:46 ET]
Table 'Okavango III' 6-max Seat #3 is the button
Seat 2: Vadim755 ($1.10 in chips) 
Seat 3: UnRRRReal ($0.80 in chips) 
Seat 4: Fran_Emm ($2.09 in chips) 
Seat 5: tasty_fish90 ($5.02 in chips) 
Seat 6: lawlex_2 ($1.50 in chips) 
Fran_Emm: posts small blind $0.01
tasty_fish90: posts big blind $0.02
*** HOLE CARDS ***
Dealt to lawlex_2 [Ts Jd]
lawlex_2: raises $0.04 to $0.06
Vadim755: folds 
UnRRRReal: folds 
Fran_Emm: folds 
tasty_fish90: folds 
Uncalled bet ($0.04) returned to lawlex_2
lawlex_2 collected $0.05 from pot
lawlex_2: doesn't show hand 
*** SUMMARY ***
Total pot $0.05 | Rake $0 
Seat 2: Vadim755 folded before Flop (didn't bet)
Seat 3: UnRRRReal (button) folded before Flop (didn't bet)
Seat 4: Fran_Emm (small blind) folded before Flop
Seat 5: tasty_fish90 (big blind) folded before Flop
Seat 6: lawlex_2 collected ($0.05)



PokerStars Hand #213053879526:  Hold'em No Limit ($0.01/$0.02 USD) - 2020/05/01 12:44:02 MSK [2020/05/01 5:44:02 ET]
Table 'Okavango III' 6-max Seat #4 is the button
Seat 2: Vadim755 ($1.10 in chips) 
Seat 3: UnRRRReal ($2 in chips) 
Seat 4: Fran_Emm ($2.08 in chips) 
Seat 5: tasty_fish90 ($5 in chips) 
Seat 6: lawlex_2 ($1.53 in chips) 
tasty_fish90: posts small blind $0.01
lawlex_2: posts big blind $0.02
*** HOLE CARDS ***
Dealt to lawlex_2 [Td 2d]
Vadim755: folds 
UnRRRReal: folds 
Fran_Emm: folds 
tasty_fish90: folds 
Uncalled bet ($0.01) returned to lawlex_2
lawlex_2 collected $0.02 from pot
lawlex_2: doesn't show hand 
*** SUMMARY ***
Total pot $0.02 | Rake $0 
Seat 2: Vadim755 folded before Flop (didn't bet)
Seat 3: UnRRRReal folded before Flop (didn't bet)
Seat 4: Fran_Emm (button) folded before Flop (didn't bet)
Seat 5: tasty_fish90 (small blind) folded before Flop
Seat 6: lawlex_2 (big blind) collected ($0.02)



PokerStars Hand #213053885031:  Hold'em No Limit ($0.01/$0.02 USD) - 2020/05/01 12:44:12 MSK [2020/05/01 5:44:12 ET]
Table 'Okavango III' 6-max Seat #5 is the button
Seat 2: Vadim755 ($1.10 in chips) 
Seat 3: UnRRRReal ($2 in chips) 
Seat 4: Fran_Emm ($2.08 in chips) 
Seat 5: tasty_fish90 ($4.99 in chips) 
Seat 6: lawlex_2 ($1.54 in chips) 
lawlex_2: posts small blind $0.01
Vadim755: posts big blind $0.02
*** HOLE CARDS ***
Dealt to lawlex_2 [Kh 9c]
UnRRRReal: folds 
Fran_Emm: raises $0.04 to $0.06
tasty_fish90: folds 
lawlex_2: folds 
Vadim755: calls $0.04
*** FLOP *** [Jc 3h Qc]
Vadim755: bets $0.04
Fran_Emm: folds 
Uncalled bet ($0.04) returned to Vadim755
Vadim755 collected $0.13 from pot
Vadim755: doesn't show hand 
*** SUMMARY ***
Total pot $0.13 | Rake $0 
Board [Jc 3h Qc]
Seat 2: Vadim755 (big blind) collected ($0.13)
Seat 3: UnRRRReal folded before Flop (didn't bet)
Seat 4: Fran_Emm folded on the Flop
Seat 5: tasty_fish90 (button) folded before Flop (didn't bet)
Seat 6: lawlex_2 (small blind) folded before Flop



PokerStars Hand #213053895757:  Hold'em No Limit ($0.01/$0.02 USD) - 2020/05/01 12:44:32 MSK [2020/05/01 5:44:32 ET]
Table 'Okavango III' 6-max Seat #6 is the button
Seat 2: Vadim755 ($1.17 in chips) 
Seat 3: UnRRRReal ($2 in chips) 
Seat 4: Fran_Emm ($2.02 in chips) 
Seat 5: tasty_fish90 ($4.99 in chips) 
Seat 6: lawlex_2 ($1.53 in chips) 
Vadim755: posts small blind $0.01
UnRRRReal: posts big blind $0.02
*** HOLE CARDS ***
Dealt to lawlex_2 [Ac Th]
Fran_Emm has timed out
Fran_Emm: folds 
tasty_fish90: folds 
lawlex_2: raises $0.04 to $0.06
Vadim755: folds 
UnRRRReal: folds 
Uncalled bet ($0.04) returned to lawlex_2
lawlex_2 collected $0.05 from pot
lawlex_2: doesn't show hand 
*** SUMMARY ***
Total pot $0.05 | Rake $0 
Seat 2: Vadim755 (small blind) folded before Flop
Seat 3: UnRRRReal (big blind) folded before Flop
Seat 4: Fran_Emm folded before Flop (didn't bet)
Seat 5: tasty_fish90 folded before Flop (didn't bet)
Seat 6: lawlex_2 (button) collected ($0.05)



PokerStars Hand #213053913303:  Hold'em No Limit ($0.01/$0.02 USD) - 2020/05/01 12:45:04 MSK [2020/05/01 5:45:04 ET]
Table 'Okavango III' 6-max Seat #2 is the button
Seat 2: Vadim755 ($1.16 in chips) 
Seat 3: UnRRRReal ($1.98 in chips) 
Seat 4: Fran_Emm ($2.02 in chips) 
Seat 5: tasty_fish90 ($4.99 in chips) 
Seat 6: lawlex_2 ($1.56 in chips) 
UnRRRReal: posts small blind $0.01
Fran_Emm: posts big blind $0.02
*** HOLE CARDS ***
Dealt to lawlex_2 [Jh 7d]
tasty_fish90: folds 
lawlex_2: folds 
Vadim755: folds 
UnRRRReal: folds 
Uncalled bet ($0.01) returned to Fran_Emm
Fran_Emm collected $0.02 from pot
*** SUMMARY ***
Total pot $0.02 | Rake $0 
Seat 2: Vadim755 (button) folded before Flop (didn't bet)
Seat 3: UnRRRReal (small blind) folded before Flop
Seat 4: Fran_Emm (big blind) collected ($0.02)
Seat 5: tasty_fish90 folded before Flop (didn't bet)
Seat 6: lawlex_2 folded before Flop (didn't bet)



PokerStars Hand #213053920796:  Hold'em No Limit ($0.01/$0.02 USD) - 2020/05/01 12:45:18 MSK [2020/05/01 5:45:18 ET]
Table 'Okavango III' 6-max Seat #3 is the button
Seat 2: Vadim755 ($1.16 in chips) 
Seat 3: UnRRRReal ($1.97 in chips) 
Seat 4: Fran_Emm ($2.03 in chips) 
Seat 6: lawlex_2 ($1.56 in chips) 
Fran_Emm: posts small blind $0.01
lawlex_2: posts big blind $0.02
*** HOLE CARDS ***
Dealt to lawlex_2 [9c 3d]
Vadim755: folds 
UnRRRReal: folds 
Fran_Emm: folds 
Uncalled bet ($0.01) returned to lawlex_2
lawlex_2 collected $0.02 from pot
lawlex_2: doesn't show hand 
*** SUMMARY ***
Total pot $0.02 | Rake $0 
Seat 2: Vadim755 folded before Flop (didn't bet)
Seat 3: UnRRRReal (button) folded before Flop (didn't bet)
Seat 4: Fran_Emm (small blind) folded before Flop
Seat 6: lawlex_2 (big blind) collected ($0.02)



PokerStars Hand #213053925362:  Hold'em No Limit ($0.01/$0.02 USD) - 2020/05/01 12:45:26 MSK [2020/05/01 5:45:26 ET]
Table 'Okavango III' 6-max Seat #4 is the button
Seat 2: Vadim755 ($1.16 in chips) 
Seat 3: UnRRRReal ($1.97 in chips) 
Seat 4: Fran_Emm ($2.02 in chips) 
Seat 6: lawlex_2 ($1.57 in chips) 
lawlex_2: posts small blind $0.01
Vadim755: posts big blind $0.02
*** HOLE CARDS ***
Dealt to lawlex_2 [Kh 5d]
UnRRRReal: folds 
Fran_Emm: folds 
lawlex_2: calls $0.01
Vadim755: checks 
*** FLOP *** [Ac Tc As]
lawlex_2: checks 
Vadim755: bets $0.02
lawlex_2: folds 
Uncalled bet ($0.02) returned to Vadim755
Vadim755 collected $0.04 from pot
Vadim755: doesn't show hand 
*** SUMMARY ***
Total pot $0.04 | Rake $0 
Board [Ac Tc As]
Seat 2: Vadim755 (big blind) collected ($0.04)
Seat 3: UnRRRReal folded before Flop (didn't bet)
Seat 4: Fran_Emm (button) folded before Flop (didn't bet)
Seat 6: lawlex_2 (small blind) folded on the Flop



PokerStars Hand #213053937710:  Hold'em No Limit ($0.01/$0.02 USD) - 2020/05/01 12:45:49 MSK [2020/05/01 5:45:49 ET]
Table 'Okavango III' 6-max Seat #6 is the button
Seat 2: Vadim755 ($1.18 in chips) 
Seat 3: UnRRRReal ($1.97 in chips) 
Seat 4: Fran_Emm ($2.02 in chips) 
Seat 6: lawlex_2 ($1.55 in chips) 
Vadim755: posts small blind $0.01
UnRRRReal: posts big blind $0.02
*** HOLE CARDS ***
Dealt to lawlex_2 [9d 3s]
Fran_Emm: folds 
lawlex_2: folds 
Vadim755: calls $0.01
UnRRRReal: checks 
*** FLOP *** [As Qc 7d]
Vadim755: bets $0.02
UnRRRReal: folds 
Uncalled bet ($0.02) returned to Vadim755
Vadim755 collected $0.04 from pot
Vadim755: doesn't show hand 
*** SUMMARY ***
Total pot $0.04 | Rake $0 
Board [As Qc 7d]
Seat 2: Vadim755 (small blind) collected ($0.04)
Seat 3: UnRRRReal (big blind) folded on the Flop
Seat 4: Fran_Emm folded before Flop (didn't bet)
Seat 6: lawlex_2 (button) folded before Flop (didn't bet)



PokerStars Hand #213053944658:  Hold'em No Limit ($0.01/$0.02 USD) - 2020/05/01 12:46:02 MSK [2020/05/01 5:46:02 ET]
Table 'Okavango III' 6-max Seat #2 is the button
Seat 2: Vadim755 ($1.20 in chips) 
Seat 3: UnRRRReal ($1.95 in chips) 
Seat 4: Fran_Emm ($2.02 in chips) 
Seat 6: lawlex_2 ($1.55 in chips) 
UnRRRReal: posts small blind $0.01
Fran_Emm: posts big blind $0.02
*** HOLE CARDS ***
Dealt to lawlex_2 [2c Jd]
lawlex_2: folds 
Vadim755: folds 
UnRRRReal: folds 
Uncalled bet ($0.01) returned to Fran_Emm
Fran_Emm collected $0.02 from pot
*** SUMMARY ***
Total pot $0.02 | Rake $0 
Seat 2: Vadim755 (button) folded before Flop (didn't bet)
Seat 3: UnRRRReal (small blind) folded before Flop
Seat 4: Fran_Emm (big blind) collected ($0.02)
Seat 6: lawlex_2 folded before Flop (didn't bet)



PokerStars Hand #213053954398:  Hold'em No Limit ($0.01/$0.02 USD) - 2020/05/01 12:46:20 MSK [2020/05/01 5:46:20 ET]
Table 'Okavango III' 6-max Seat #3 is the button
Seat 2: Vadim755 ($1.20 in chips) 
Seat 3: UnRRRReal ($1.94 in chips) 
Seat 4: Fran_Emm ($2.03 in chips) 
Seat 6: lawlex_2 ($1.55 in chips) 
Fran_Emm: posts small blind $0.01
lawlex_2: posts big blind $0.02
*** HOLE CARDS ***
Dealt to lawlex_2 [5c 4s]
Vadim755: raises $0.02 to $0.04
UnRRRReal: calls $0.04
Fran_Emm: calls $0.03
lawlex_2: folds 
*** FLOP *** [Qh Kc 6d]
Fran_Emm: checks 
Vadim755: bets $0.04
UnRRRReal: calls $0.04
Fran_Emm: calls $0.04
*** TURN *** [Qh Kc 6d] [Ts]
Fran_Emm: checks 
Vadim755: checks 
UnRRRReal: checks 
*** RIVER *** [Qh Kc 6d Ts] [2h]
Fran_Emm: checks 
Vadim755: bets $0.12
UnRRRReal: calls $0.12
Fran_Emm: folds 
*** SHOW DOWN ***
Vadim755: shows [Tc Td] (three of a kind, Tens)
UnRRRReal: mucks hand 
Vadim755 collected $0.48 from pot
*** SUMMARY ***
Total pot $0.50 | Rake $0.02 
Board [Qh Kc 6d Ts 2h]
Seat 2: Vadim755 showed [Tc Td] and won ($0.48) with three of a kind, Tens
Seat 3: UnRRRReal (button) mucked [Jc Qs]
Seat 4: Fran_Emm (small blind) folded on the River
Seat 6: lawlex_2 (big blind) folded before Flop



PokerStars Hand #213053978867:  Hold'em No Limit ($0.01/$0.02 USD) - 2020/05/01 12:47:05 MSK [2020/05/01 5:47:05 ET]
Table 'Okavango III' 6-max Seat #4 is the button
Seat 2: Vadim755 ($1.48 in chips) 
Seat 3: UnRRRReal ($1.74 in chips) 
Seat 4: Fran_Emm ($2 in chips) 
Seat 6: lawlex_2 ($1.53 in chips) 
lawlex_2: posts small blind $0.01
Vadim755: posts big blind $0.02
*** HOLE CARDS ***
Dealt to lawlex_2 [Th Jc]
UnRRRReal: folds 
Fran_Emm: raises $0.04 to $0.06
lawlex_2: calls $0.05
Vadim755: calls $0.04
*** FLOP *** [8d Qs 6d]
lawlex_2: bets $0.11
Vadim755: folds 
Fran_Emm: calls $0.11
*** TURN *** [8d Qs 6d] [3d]
lawlex_2: checks 
Fran_Emm: checks 
*** RIVER *** [8d Qs 6d 3d] [6c]
lawlex_2: checks 
Fran_Emm: checks 
*** SHOW DOWN ***
lawlex_2: shows [Th Jc] (a pair of Sixes)
Fran_Emm: shows [Qh 9h] (two pair, Queens and Sixes)
Fran_Emm collected $0.39 from pot
darryl2008 was removed from the table for failing to post
darryl2008 leaves the table
*** SUMMARY ***
Total pot $0.40 | Rake $0.01 
Board [8d Qs 6d 3d 6c]
Seat 2: Vadim755 (big blind) folded on the Flop
Seat 3: UnRRRReal folded before Flop (didn't bet)
Seat 4: Fran_Emm (button) showed [Qh 9h] and won ($0.39) with two pair, Queens and Sixes
Seat 6: lawlex_2 (small blind) showed [Th Jc] and lost with a pair of Sixes



PokerStars Hand #213053997606:  Hold'em No Limit ($0.01/$0.02 USD) - 2020/05/01 12:47:39 MSK [2020/05/01 5:47:39 ET]
Table 'Okavango III' 6-max Seat #6 is the button
Seat 2: Vadim755 ($1.42 in chips) 
Seat 3: UnRRRReal ($2 in chips) 
Seat 4: Fran_Emm ($2.22 in chips) 
Seat 6: lawlex_2 ($1.36 in chips) 
Vadim755: posts small blind $0.01
UnRRRReal: posts big blind $0.02
*** HOLE CARDS ***
Dealt to lawlex_2 [2h 2c]
Fran_Emm: raises $0.04 to $0.06
lawlex_2: folds 
Vadim755: folds 
fijiwater00 joins the table at seat #1 
UnRRRReal: folds 
Uncalled bet ($0.04) returned to Fran_Emm
Vadim755 leaves the table
Fran_Emm collected $0.05 from pot
*** SUMMARY ***
Total pot $0.05 | Rake $0 
Seat 2: Vadim755 (small blind) folded before Flop
Seat 3: UnRRRReal (big blind) folded before Flop
Seat 4: Fran_Emm collected ($0.05)
Seat 6: lawlex_2 (button) folded before Flop (didn't bet)



PokerStars Hand #213054004905:  Hold'em No Limit ($0.01/$0.02 USD) - 2020/05/01 12:47:52 MSK [2020/05/01 5:47:52 ET]
Table 'Okavango III' 6-max Seat #3 is the button
Seat 3: UnRRRReal ($1.98 in chips) 
Seat 4: Fran_Emm ($2.25 in chips) 
Seat 6: lawlex_2 ($1.36 in chips) 
Fran_Emm: posts small blind $0.01
lawlex_2: posts big blind $0.02
fijiwater00: sits out 
*** HOLE CARDS ***
Dealt to lawlex_2 [4s 7h]
UnRRRReal: raises $0.04 to $0.06
Fran_Emm: folds 
lawlex_2: folds 
Uncalled bet ($0.04) returned to UnRRRReal
UnRRRReal collected $0.05 from pot
*** SUMMARY ***
Total pot $0.05 | Rake $0 
Seat 3: UnRRRReal (button) collected ($0.05)
Seat 4: Fran_Emm (small blind) folded before Flop
Seat 6: lawlex_2 (big blind) folded before Flop



PokerStars Hand #213054010627:  Hold'em No Limit ($0.01/$0.02 USD) - 2020/05/01 12:48:03 MSK [2020/05/01 5:48:03 ET]
Table 'Okavango III' 6-max Seat #4 is the button
Seat 1: fijiwater00 ($2 in chips) 
Seat 3: UnRRRReal ($2.01 in chips) 
Seat 4: Fran_Emm ($2.24 in chips) 
Seat 6: lawlex_2 ($1.34 in chips) 
lawlex_2: posts small blind $0.01
fijiwater00: posts big blind $0.02
*** HOLE CARDS ***
Dealt to lawlex_2 [Qc 9c]
Gevron joins the table at seat #2 
UnRRRReal: folds 
Fran_Emm: folds 
lawlex_2: calls $0.01
fijiwater00: checks 
*** FLOP *** [8s 5s 3c]
lawlex_2: checks 
fijiwater00: checks 
*** TURN *** [8s 5s 3c] [Qd]
lawlex_2: bets $0.03
fijiwater00: calls $0.03
*** RIVER *** [8s 5s 3c Qd] [Ts]
lawlex_2: bets $0.07
fijiwater00: calls $0.07
*** SHOW DOWN ***
lawlex_2: shows [Qc 9c] (a pair of Queens)
fijiwater00: mucks hand 
lawlex_2 collected $0.23 from pot
*** SUMMARY ***
Total pot $0.24 | Rake $0.01 
Board [8s 5s 3c Qd Ts]
Seat 1: fijiwater00 (big blind) mucked [4s Qh]
Seat 3: UnRRRReal folded before Flop (didn't bet)
Seat 4: Fran_Emm (button) folded before Flop (didn't bet)
Seat 6: lawlex_2 (small blind) showed [Qc 9c] and won ($0.23) with a pair of Queens



PokerStars Hand #213054036273:  Hold'em No Limit ($0.01/$0.02 USD) - 2020/05/01 12:48:50 MSK [2020/05/01 5:48:50 ET]
Table 'Okavango III' 6-max Seat #6 is the button
Seat 1: fijiwater00 ($1.88 in chips) 
Seat 2: Gevron ($2 in chips) 
Seat 3: UnRRRReal ($2.01 in chips) 
Seat 4: Fran_Emm ($2.24 in chips) 
Seat 6: lawlex_2 ($1.45 in chips) 
fijiwater00: posts small blind $0.01
Gevron: posts big blind $0.02
*** HOLE CARDS ***
Dealt to lawlex_2 [7c 7d]
UnRRRReal: folds 
Fran_Emm: folds 
lawlex_2: raises $0.04 to $0.06
fijiwater00: calls $0.05
Gevron: folds 
*** FLOP *** [9h Jc 3d]
fijiwater00: bets $0.16
lawlex_2: folds 
Uncalled bet ($0.16) returned to fijiwater00
fijiwater00 collected $0.14 from pot
fijiwater00: doesn't show hand 
*** SUMMARY ***
Total pot $0.14 | Rake $0 
Board [9h Jc 3d]
Seat 1: fijiwater00 (small blind) collected ($0.14)
Seat 2: Gevron (big blind) folded before Flop
Seat 3: UnRRRReal folded before Flop (didn't bet)
Seat 4: Fran_Emm folded before Flop (didn't bet)
Seat 6: lawlex_2 (button) folded on the Flop



PokerStars Hand #213054057914:  Hold'em No Limit ($0.01/$0.02 USD) - 2020/05/01 12:49:30 MSK [2020/05/01 5:49:30 ET]
Table 'Okavango III' 6-max Seat #1 is the button
Seat 1: fijiwater00 ($1.96 in chips) 
Seat 2: Gevron ($2 in chips) 
Seat 3: UnRRRReal ($2.01 in chips) 
Seat 4: Fran_Emm ($2.24 in chips) 
Seat 6: lawlex_2 ($1.39 in chips) 
Gevron: posts small blind $0.01
UnRRRReal: posts big blind $0.02
*** HOLE CARDS ***
Dealt to lawlex_2 [3d 5d]
Fran_Emm: folds 
lawlex_2: folds 
fijiwater00: raises $0.02 to $0.04
Gevron: folds 
UnRRRReal: calls $0.02
*** FLOP *** [6s 3c 7c]
UnRRRReal: checks 
fijiwater00: bets $0.08
UnRRRReal: calls $0.08
*** TURN *** [6s 3c 7c] [6c]
UnRRRReal: checks 
fijiwater00: bets $0.02
UnRRRReal: calls $0.02
*** RIVER *** [6s 3c 7c 6c] [8d]
UnRRRReal: checks 
fijiwater00: checks 
*** SHOW DOWN ***
UnRRRReal: shows [2s 2d] (two pair, Sixes and Deuces)
fijiwater00: shows [Jh Jc] (two pair, Jacks and Sixes)
fijiwater00 collected $0.28 from pot
*** SUMMARY ***
Total pot $0.29 | Rake $0.01 
Board [6s 3c 7c 6c 8d]
Seat 1: fijiwater00 (button) showed [Jh Jc] and won ($0.28) with two pair, Jacks and Sixes
Seat 2: Gevron (small blind) folded before Flop
Seat 3: UnRRRReal (big blind) showed [2s 2d] and lost with two pair, Sixes and Deuces
Seat 4: Fran_Emm folded before Flop (didn't bet)
Seat 6: lawlex_2 folded before Flop (didn't bet)



PokerStars Hand #213054087897:  Hold'em No Limit ($0.01/$0.02 USD) - 2020/05/01 12:50:26 MSK [2020/05/01 5:50:26 ET]
Table 'Okavango III' 6-max Seat #2 is the button
Seat 1: fijiwater00 ($2.10 in chips) 
Seat 2: Gevron ($2 in chips) 
Seat 3: UnRRRReal ($1.87 in chips) 
Seat 4: Fran_Emm ($2.24 in chips) 
Seat 6: lawlex_2 ($1.39 in chips) 
UnRRRReal: posts small blind $0.01
Fran_Emm: posts big blind $0.02
*** HOLE CARDS ***
Dealt to lawlex_2 [2d Kh]
lawlex_2: folds 
fijiwater00: calls $0.02
Gevron: raises $0.06 to $0.08
UnRRRReal: folds 
Fran_Emm: folds 
fijiwater00: calls $0.06
*** FLOP *** [Ks 5c 6c]
fijiwater00: checks 
Gevron: checks 
*** TURN *** [Ks 5c 6c] [5h]
fijiwater00: bets $0.02
Gevron: calls $0.02
*** RIVER *** [Ks 5c 6c 5h] [3h]
fijiwater00: bets $0.02
Gevron: raises $0.52 to $0.54
fijiwater00: folds 
Uncalled bet ($0.52) returned to Gevron
Gevron collected $0.26 from pot
*** SUMMARY ***
Total pot $0.27 | Rake $0.01 
Board [Ks 5c 6c 5h 3h]
Seat 1: fijiwater00 folded on the River
Seat 2: Gevron (button) collected ($0.26)
Seat 3: UnRRRReal (small blind) folded before Flop
Seat 4: Fran_Emm (big blind) folded before Flop
Seat 6: lawlex_2 folded before Flop (didn't bet)



PokerStars Hand #213054128389:  Hold'em No Limit ($0.01/$0.02 USD) - 2020/05/01 12:51:39 MSK [2020/05/01 5:51:39 ET]
Table 'Okavango III' 6-max Seat #3 is the button
Seat 1: fijiwater00 ($1.98 in chips) 
Seat 2: Gevron ($2.14 in chips) 
Seat 3: UnRRRReal ($1.86 in chips) 
Seat 4: Fran_Emm ($2.22 in chips) 
Seat 6: lawlex_2 ($1.39 in chips) 
Fran_Emm: posts small blind $0.01
lawlex_2: posts big blind $0.02
*** HOLE CARDS ***
Dealt to lawlex_2 [Ks 2h]
fijiwater00: calls $0.02
Gevron: raises $0.06 to $0.08
UnRRRReal: folds 
Fran_Emm: folds 
lawlex_2: folds 
fijiwater00: calls $0.06
*** FLOP *** [8d 9d Ts]
fijiwater00: checks 
Gevron: bets $0.14
fijiwater00: calls $0.14
*** TURN *** [8d 9d Ts] [2s]
fijiwater00: checks 
Gevron: bets $0.36
fijiwater00: folds 
Uncalled bet ($0.36) returned to Gevron
Gevron collected $0.45 from pot
*** SUMMARY ***
Total pot $0.47 | Rake $0.02 
Board [8d 9d Ts 2s]
Seat 1: fijiwater00 folded on the Turn
Seat 2: Gevron collected ($0.45)
Seat 3: UnRRRReal (button) folded before Flop (didn't bet)
Seat 4: Fran_Emm (small blind) folded before Flop
Seat 6: lawlex_2 (big blind) folded before Flop



PokerStars Hand #213054153544:  Hold'em No Limit ($0.01/$0.02 USD) - 2020/05/01 12:52:26 MSK [2020/05/01 5:52:26 ET]
Table 'Okavango III' 6-max Seat #4 is the button
Seat 1: fijiwater00 ($1.76 in chips) 
Seat 2: Gevron ($2.37 in chips) 
Seat 3: UnRRRReal ($1.86 in chips) 
Seat 4: Fran_Emm ($2.21 in chips) 
Seat 6: lawlex_2 ($1.37 in chips) 
lawlex_2: posts small blind $0.01
fijiwater00: posts big blind $0.02
*** HOLE CARDS ***
Dealt to lawlex_2 [6s 4d]
Gevron: folds 
UnRRRReal: folds 
tasty_fish90 leaves the table
Fran_Emm: folds 
lawlex_2: folds 
Uncalled bet ($0.01) returned to fijiwater00
fijiwater00 collected $0.02 from pot
fijiwater00: doesn't show hand 
*** SUMMARY ***
Total pot $0.02 | Rake $0 
Seat 1: fijiwater00 (big blind) collected ($0.02)
Seat 2: Gevron folded before Flop (didn't bet)
Seat 3: UnRRRReal folded before Flop (didn't bet)
Seat 4: Fran_Emm (button) folded before Flop (didn't bet)
Seat 6: lawlex_2 (small blind) folded before Flop



PokerStars Hand #213054159549:  Hold'em No Limit ($0.01/$0.02 USD) - 2020/05/01 12:52:37 MSK [2020/05/01 5:52:37 ET]
Table 'Okavango III' 6-max Seat #6 is the button
Seat 1: fijiwater00 ($1.77 in chips) 
Seat 2: Gevron ($2.37 in chips) 
Seat 3: UnRRRReal ($1.86 in chips) 
Seat 4: Fran_Emm ($2.21 in chips) 
Seat 6: lawlex_2 ($1.36 in chips) 
fijiwater00: posts small blind $0.01
Gevron: posts big blind $0.02
*** HOLE CARDS ***
Dealt to lawlex_2 [Jc 7s]
wensihan joins the table at seat #5 
UnRRRReal: folds 
Fran_Emm: folds 
lawlex_2: folds 
fijiwater00: calls $0.01
Gevron: raises $0.08 to $0.10
fijiwater00: calls $0.08
*** FLOP *** [5c 3s 9c]
fijiwater00: checks 
Gevron: bets $0.23
fijiwater00: calls $0.23
*** TURN *** [5c 3s 9c] [9s]
fijiwater00: checks 
Gevron: bets $0.51
fijiwater00: calls $0.51
*** RIVER *** [5c 3s 9c 9s] [Qh]
fijiwater00: checks 
Gevron: bets $1.53 and is all-in
fijiwater00: folds 
Uncalled bet ($1.53) returned to Gevron
Gevron collected $1.62 from pot
Gevron: doesn't show hand 
*** SUMMARY ***
Total pot $1.68 | Rake $0.06 
Board [5c 3s 9c 9s Qh]
Seat 1: fijiwater00 (small blind) folded on the River
Seat 2: Gevron (big blind) collected ($1.62)
Seat 3: UnRRRReal folded before Flop (didn't bet)
Seat 4: Fran_Emm folded before Flop (didn't bet)
Seat 6: lawlex_2 (button) folded before Flop (didn't bet)



PokerStars Hand #213054196688:  Hold'em No Limit ($0.01/$0.02 USD) - 2020/05/01 12:53:45 MSK [2020/05/01 5:53:45 ET]
Table 'Okavango III' 6-max Seat #1 is the button
Seat 1: fijiwater00 ($0.93 in chips) 
Seat 2: Gevron ($3.15 in chips) 
Seat 3: UnRRRReal ($1.86 in chips) 
Seat 4: Fran_Emm ($2.21 in chips) 
Seat 5: wensihan ($2 in chips) 
Seat 6: lawlex_2 ($1.36 in chips) 
Gevron: posts small blind $0.01
UnRRRReal: posts big blind $0.02
wensihan: posts big blind $0.02
*** HOLE CARDS ***
Dealt to lawlex_2 [3c 8s]
Fran_Emm: folds 
wensihan: raises $0.05 to $0.07
lawlex_2: folds 
fijiwater00: folds 
Gevron: folds 
UnRRRReal: folds 
Uncalled bet ($0.05) returned to wensihan
wensihan collected $0.05 from pot
wensihan: doesn't show hand 
*** SUMMARY ***
Total pot $0.05 | Rake $0 
Seat 1: fijiwater00 (button) folded before Flop (didn't bet)
Seat 2: Gevron (small blind) folded before Flop
Seat 3: UnRRRReal (big blind) folded before Flop
Seat 4: Fran_Emm folded before Flop (didn't bet)
Seat 5: wensihan collected ($0.05)
Seat 6: lawlex_2 folded before Flop (didn't bet)



PokerStars Hand #213054210375:  Hold'em No Limit ($0.01/$0.02 USD) - 2020/05/01 12:54:11 MSK [2020/05/01 5:54:11 ET]
Table 'Okavango III' 6-max Seat #2 is the button
Seat 1: fijiwater00 ($0.93 in chips) 
Seat 2: Gevron ($3.14 in chips) 
Seat 3: UnRRRReal ($1.84 in chips) 
Seat 4: Fran_Emm ($2.21 in chips) 
Seat 5: wensihan ($2.03 in chips) 
Seat 6: lawlex_2 ($1.36 in chips) 
UnRRRReal: posts small blind $0.01
Fran_Emm: posts big blind $0.02
*** HOLE CARDS ***
Dealt to lawlex_2 [Qc 4d]
wensihan: raises $0.05 to $0.07
lawlex_2: folds 
fijiwater00: calls $0.07
Gevron: folds 
UnRRRReal: folds 
Fran_Emm: calls $0.05
*** FLOP *** [6h 3s 8d]
Fran_Emm: checks 
wensihan: checks 
fijiwater00: checks 
*** TURN *** [6h 3s 8d] [Jc]
Fran_Emm: bets $0.11
wensihan: folds 
fijiwater00: calls $0.11
*** RIVER *** [6h 3s 8d Jc] [Th]
Fran_Emm: checks 
fijiwater00: checks 
*** SHOW DOWN ***
Fran_Emm: shows [Kc Js] (a pair of Jacks)
fijiwater00: mucks hand 
Fran_Emm collected $0.42 from pot
*** SUMMARY ***
Total pot $0.44 | Rake $0.02 
Board [6h 3s 8d Jc Th]
Seat 1: fijiwater00 mucked [5c 5d]
Seat 2: Gevron (button) folded before Flop (didn't bet)
Seat 3: UnRRRReal (small blind) folded before Flop
Seat 4: Fran_Emm (big blind) showed [Kc Js] and won ($0.42) with a pair of Jacks
Seat 5: wensihan folded on the Turn
Seat 6: lawlex_2 folded before Flop (didn't bet)



PokerStars Hand #213054234062:  Hold'em No Limit ($0.01/$0.02 USD) - 2020/05/01 12:54:54 MSK [2020/05/01 5:54:54 ET]
Table 'Okavango III' 6-max Seat #3 is the button
Seat 1: fijiwater00 ($0.75 in chips) 
Seat 2: Gevron ($3.14 in chips) 
Seat 3: UnRRRReal ($1.83 in chips) 
Seat 4: Fran_Emm ($2.45 in chips) 
Seat 5: wensihan ($1.96 in chips) 
Seat 6: lawlex_2 ($1.36 in chips) 
Fran_Emm: posts small blind $0.01
wensihan: posts big blind $0.02
*** HOLE CARDS ***
Dealt to lawlex_2 [6c 4s]
lawlex_2: folds 
fijiwater00: calls $0.02
Gevron: raises $0.04 to $0.06
UnRRRReal: folds 
Fran_Emm: folds 
wensihan: calls $0.04
fijiwater00: calls $0.04
*** FLOP *** [8s Kc 3d]
wensihan: checks 
fijiwater00: checks 
Gevron: bets $0.02
wensihan: folds 
fijiwater00: calls $0.02
*** TURN *** [8s Kc 3d] [7c]
fijiwater00: checks 
Gevron: checks 
*** RIVER *** [8s Kc 3d 7c] [5s]
fijiwater00: checks 
Gevron: checks 
*** SHOW DOWN ***
fijiwater00: shows [Jh Qd] (high card King)
Gevron: shows [5d Td] (a pair of Fives)
Gevron collected $0.22 from pot
*** SUMMARY ***
Total pot $0.23 | Rake $0.01 
Board [8s Kc 3d 7c 5s]
Seat 1: fijiwater00 showed [Jh Qd] and lost with high card King
Seat 2: Gevron showed [5d Td] and won ($0.22) with a pair of Fives
Seat 3: UnRRRReal (button) folded before Flop (didn't bet)
Seat 4: Fran_Emm (small blind) folded before Flop
Seat 5: wensihan (big blind) folded on the Flop
Seat 6: lawlex_2 folded before Flop (didn't bet)



PokerStars Hand #213054253576:  Hold'em No Limit ($0.01/$0.02 USD) - 2020/05/01 12:55:35 MSK [2020/05/01 5:55:35 ET]
Table 'Okavango III' 6-max Seat #4 is the button
Seat 1: fijiwater00 ($0.67 in chips) 
Seat 2: Gevron ($3.28 in chips) 
Seat 3: UnRRRReal ($1.83 in chips) 
Seat 4: Fran_Emm ($2.44 in chips) 
Seat 5: wensihan ($1.90 in chips) 
Seat 6: lawlex_2 ($1.36 in chips) 
wensihan: posts small blind $0.01
lawlex_2: posts big blind $0.02
*** HOLE CARDS ***
Dealt to lawlex_2 [2h As]
fijiwater00: raises $0.02 to $0.04
Gevron: folds 
UnRRRReal: folds 
Fran_Emm: folds 
wensihan: folds 
lawlex_2: calls $0.02
*** FLOP *** [Qd 8h Ts]
lawlex_2: checks 
fijiwater00: checks 
*** TURN *** [Qd 8h Ts] [Kc]
lawlex_2: checks 
fijiwater00: checks 
*** RIVER *** [Qd 8h Ts Kc] [8c]
lawlex_2: checks 
fijiwater00: checks 
*** SHOW DOWN ***
lawlex_2: shows [2h As] (a pair of Eights)
fijiwater00: shows [5h 5s] (two pair, Eights and Fives)
fijiwater00 collected $0.09 from pot
*** SUMMARY ***
Total pot $0.09 | Rake $0 
Board [Qd 8h Ts Kc 8c]
Seat 1: fijiwater00 showed [5h 5s] and won ($0.09) with two pair, Eights and Fives
Seat 2: Gevron folded before Flop (didn't bet)
Seat 3: UnRRRReal folded before Flop (didn't bet)
Seat 4: Fran_Emm (button) folded before Flop (didn't bet)
Seat 5: wensihan (small blind) folded before Flop
Seat 6: lawlex_2 (big blind) showed [2h As] and lost with a pair of Eights



PokerStars Hand #213054271090:  Hold'em No Limit ($0.01/$0.02 USD) - 2020/05/01 12:56:12 MSK [2020/05/01 5:56:12 ET]
Table 'Okavango III' 6-max Seat #5 is the button
Seat 1: fijiwater00 ($0.72 in chips) 
Seat 2: Gevron ($3.28 in chips) 
Seat 3: UnRRRReal ($1.83 in chips) 
Seat 4: Fran_Emm ($2.44 in chips) 
Seat 5: wensihan ($1.89 in chips) 
Seat 6: lawlex_2 ($1.32 in chips) 
lawlex_2: posts small blind $0.01
fijiwater00: posts big blind $0.02
*** HOLE CARDS ***
Dealt to lawlex_2 [Qs Kd]
Gevron: folds 
UnRRRReal: folds 
Fran_Emm: folds 
wensihan: raises $0.04 to $0.06
lawlex_2: calls $0.05
fijiwater00: calls $0.04
*** FLOP *** [6s 5h Qh]
lawlex_2: bets $0.11
fijiwater00: folds 
wensihan: folds 
Uncalled bet ($0.11) returned to lawlex_2
lawlex_2 collected $0.17 from pot
lawlex_2: doesn't show hand 
*** SUMMARY ***
Total pot $0.18 | Rake $0.01 
Board [6s 5h Qh]
Seat 1: fijiwater00 (big blind) folded on the Flop
Seat 2: Gevron folded before Flop (didn't bet)
Seat 3: UnRRRReal folded before Flop (didn't bet)
Seat 4: Fran_Emm folded before Flop (didn't bet)
Seat 5: wensihan (button) folded on the Flop
Seat 6: lawlex_2 (small blind) collected ($0.17)



PokerStars Hand #213054283251:  Hold'em No Limit ($0.01/$0.02 USD) - 2020/05/01 12:56:38 MSK [2020/05/01 5:56:38 ET]
Table 'Okavango III' 6-max Seat #6 is the button
Seat 1: fijiwater00 ($0.66 in chips) 
Seat 2: Gevron ($3.28 in chips) 
Seat 3: UnRRRReal ($1.83 in chips) 
Seat 4: Fran_Emm ($2.44 in chips) 
Seat 5: wensihan ($1.83 in chips) 
Seat 6: lawlex_2 ($1.43 in chips) 
fijiwater00: posts small blind $0.01
Gevron: posts big blind $0.02
*** HOLE CARDS ***
Dealt to lawlex_2 [7s Tc]
UnRRRReal: folds 
Fran_Emm: raises $0.04 to $0.06
wensihan: calls $0.06
lawlex_2: folds 
fijiwater00: calls $0.05
Gevron: raises $0.12 to $0.18
Fran_Emm: folds 
wensihan: calls $0.12
fijiwater00: calls $0.12
*** FLOP *** [8d Ac 5d]
fijiwater00: checks 
Gevron: bets $0.09
wensihan: raises $0.21 to $0.30
fijiwater00: folds 
Gevron: folds 
Uncalled bet ($0.21) returned to wensihan
wensihan collected $0.75 from pot
wensihan: doesn't show hand 
*** SUMMARY ***
Total pot $0.78 | Rake $0.03 
Board [8d Ac 5d]
Seat 1: fijiwater00 (small blind) folded on the Flop
Seat 2: Gevron (big blind) folded on the Flop
Seat 3: UnRRRReal folded before Flop (didn't bet)
Seat 4: Fran_Emm folded before Flop
Seat 5: wensihan collected ($0.75)
Seat 6: lawlex_2 (button) folded before Flop (didn't bet)



PokerStars Hand #213054310817:  Hold'em No Limit ($0.01/$0.02 USD) - 2020/05/01 12:57:36 MSK [2020/05/01 5:57:36 ET]
Table 'Okavango III' 6-max Seat #1 is the button
Seat 1: fijiwater00 ($0.48 in chips) 
Seat 2: Gevron ($3.01 in chips) 
Seat 3: UnRRRReal ($1.83 in chips) 
Seat 4: Fran_Emm ($2.38 in chips) 
Seat 5: wensihan ($2.31 in chips) 
Seat 6: lawlex_2 ($1.43 in chips) 
Gevron: posts small blind $0.01
UnRRRReal: posts big blind $0.02
*** HOLE CARDS ***
Dealt to lawlex_2 [8s Th]
Fran_Emm: folds 
wensihan: raises $0.05 to $0.07
lawlex_2 has timed out
lawlex_2: folds 
fijiwater00: folds 
Gevron: folds 
UnRRRReal: calls $0.05
*** FLOP *** [3d 2h 3h]
UnRRRReal: checks 
wensihan: bets $0.10
UnRRRReal: calls $0.10
*** TURN *** [3d 2h 3h] [2c]
UnRRRReal: checks 
wensihan: bets $0.14
UnRRRReal: calls $0.14
*** RIVER *** [3d 2h 3h 2c] [7c]
UnRRRReal: checks 
wensihan: checks 
*** SHOW DOWN ***
UnRRRReal: shows [Ac 9c] (two pair, Threes and Deuces)
wensihan: shows [Qh Ah] (two pair, Threes and Deuces)
UnRRRReal collected $0.31 from pot
wensihan collected $0.30 from pot
*** SUMMARY ***
Total pot $0.63 | Rake $0.02 
Board [3d 2h 3h 2c 7c]
Seat 1: fijiwater00 (button) folded before Flop (didn't bet)
Seat 2: Gevron (small blind) folded before Flop
Seat 3: UnRRRReal (big blind) showed [Ac 9c] and won ($0.31) with two pair, Threes and Deuces
Seat 4: Fran_Emm folded before Flop (didn't bet)
Seat 5: wensihan showed [Qh Ah] and won ($0.30) with two pair, Threes and Deuces
Seat 6: lawlex_2 folded before Flop (didn't bet)



PokerStars Hand #213054383979:  Hold'em No Limit ($0.01/$0.02 USD) - 2020/05/01 12:59:55 MSK [2020/05/01 5:59:55 ET]
Table 'Okavango III' 6-max Seat #4 is the button
Seat 1: fijiwater00 ($0.46 in chips) 
Seat 2: Gevron ($2.99 in chips) 
Seat 3: UnRRRReal ($1.82 in chips) 
Seat 4: Fran_Emm ($2.29 in chips) 
Seat 5: wensihan ($2.41 in chips) 
Seat 6: lawlex_2 ($1.43 in chips) 
wensihan: posts small blind $0.01
lawlex_2: posts big blind $0.02
*** HOLE CARDS ***
Dealt to lawlex_2 [9c Qd]
fijiwater00: folds 
Gevron: folds 
UnRRRReal: folds 
Fran_Emm: raises $0.03 to $0.05
wensihan: folds 
lawlex_2: calls $0.03
*** FLOP *** [8s Jd 9s]
lawlex_2: bets $0.07
Fran_Emm: folds 
Uncalled bet ($0.07) returned to lawlex_2
lawlex_2 collected $0.11 from pot
lawlex_2: doesn't show hand 
*** SUMMARY ***
Total pot $0.11 | Rake $0 
Board [8s Jd 9s]
Seat 1: fijiwater00 folded before Flop (didn't bet)
Seat 2: Gevron folded before Flop (didn't bet)
Seat 3: UnRRRReal folded before Flop (didn't bet)
Seat 4: Fran_Emm (button) folded on the Flop
Seat 5: wensihan (small blind) folded before Flop
Seat 6: lawlex_2 (big blind) collected ($0.11)



PokerStars Hand #213054394830:  Hold'em No Limit ($0.01/$0.02 USD) - 2020/05/01 13:00:16 MSK [2020/05/01 6:00:16 ET]
Table 'Okavango III' 6-max Seat #5 is the button
Seat 1: fijiwater00 ($0.46 in chips) 
Seat 2: Gevron ($2.99 in chips) 
Seat 3: UnRRRReal ($1.82 in chips) 
Seat 4: Fran_Emm ($2.24 in chips) 
Seat 5: wensihan ($2.40 in chips) 
Seat 6: lawlex_2 ($1.49 in chips) 
lawlex_2: posts small blind $0.01
fijiwater00: posts big blind $0.02
*** HOLE CARDS ***
Dealt to lawlex_2 [5h 2c]
Gevron: folds 
UnRRRReal: folds 
Fran_Emm: raises $0.04 to $0.06
wensihan: calls $0.06
lawlex_2: folds 
fijiwater00: calls $0.04
*** FLOP *** [3s 4h Js]
fijiwater00: checks 
Fran_Emm: checks 
wensihan: bets $0.10
fijiwater00: calls $0.10
Fran_Emm: folds 
*** TURN *** [3s 4h Js] [8h]
fijiwater00: checks 
wensihan: bets $0.20
fijiwater00: folds 
Uncalled bet ($0.20) returned to wensihan
wensihan collected $0.38 from pot
wensihan: doesn't show hand 
*** SUMMARY ***
Total pot $0.39 | Rake $0.01 
Board [3s 4h Js 8h]
Seat 1: fijiwater00 (big blind) folded on the Turn
Seat 2: Gevron folded before Flop (didn't bet)
Seat 3: UnRRRReal folded before Flop (didn't bet)
Seat 4: Fran_Emm folded on the Flop
Seat 5: wensihan (button) collected ($0.38)
Seat 6: lawlex_2 (small blind) folded before Flop



PokerStars Hand #213054424106:  Hold'em No Limit ($0.01/$0.02 USD) - 2020/05/01 13:01:12 MSK [2020/05/01 6:01:12 ET]
Table 'Okavango III' 6-max Seat #6 is the button
Seat 1: fijiwater00 ($0.30 in chips) 
Seat 2: Gevron ($2.99 in chips) 
Seat 3: UnRRRReal ($1.82 in chips) 
Seat 4: Fran_Emm ($2.18 in chips) 
Seat 5: wensihan ($2.62 in chips) 
Seat 6: lawlex_2 ($1.48 in chips) 
fijiwater00: posts small blind $0.01
Gevron: posts big blind $0.02
*** HOLE CARDS ***
Dealt to lawlex_2 [Td Ac]
UnRRRReal: folds 
Fran_Emm: folds 
wensihan: folds 
lawlex_2: raises $0.04 to $0.06
fijiwater00: folds 
Gevron: folds 
Uncalled bet ($0.04) returned to lawlex_2
lawlex_2 collected $0.05 from pot
lawlex_2: doesn't show hand 
*** SUMMARY ***
Total pot $0.05 | Rake $0 
Seat 1: fijiwater00 (small blind) folded before Flop
Seat 2: Gevron (big blind) folded before Flop
Seat 3: UnRRRReal folded before Flop (didn't bet)
Seat 4: Fran_Emm folded before Flop (didn't bet)
Seat 5: wensihan folded before Flop (didn't bet)
Seat 6: lawlex_2 (button) collected ($0.05)



PokerStars Hand #213054435821:  Hold'em No Limit ($0.01/$0.02 USD) - 2020/05/01 13:01:34 MSK [2020/05/01 6:01:34 ET]
Table 'Okavango III' 6-max Seat #1 is the button
Seat 1: fijiwater00 ($0.29 in chips) 
Seat 2: Gevron ($2.97 in chips) 
Seat 3: UnRRRReal ($1.82 in chips) 
Seat 4: Fran_Emm ($2.18 in chips) 
Seat 5: wensihan ($2.62 in chips) 
Seat 6: lawlex_2 ($1.51 in chips) 
Gevron: posts small blind $0.01
UnRRRReal: posts big blind $0.02
*** HOLE CARDS ***
Dealt to lawlex_2 [Qh 5c]
Fran_Emm: raises $0.04 to $0.06
wensihan: folds 
lawlex_2: folds 
fijiwater00: folds 
Gevron: folds 
UnRRRReal: folds 
Uncalled bet ($0.04) returned to Fran_Emm
Fran_Emm collected $0.05 from pot
*** SUMMARY ***
Total pot $0.05 | Rake $0 
Seat 1: fijiwater00 (button) folded before Flop (didn't bet)
Seat 2: Gevron (small blind) folded before Flop
Seat 3: UnRRRReal (big blind) folded before Flop
Seat 4: Fran_Emm collected ($0.05)
Seat 5: wensihan folded before Flop (didn't bet)
Seat 6: lawlex_2 folded before Flop (didn't bet)



PokerStars Hand #213054446146:  Hold'em No Limit ($0.01/$0.02 USD) - 2020/05/01 13:01:52 MSK [2020/05/01 6:01:52 ET]
Table 'Okavango III' 6-max Seat #2 is the button
Seat 1: fijiwater00 ($0.29 in chips) 
Seat 2: Gevron ($2.96 in chips) 
Seat 3: UnRRRReal ($1.80 in chips) 
Seat 4: Fran_Emm ($2.21 in chips) 
Seat 5: wensihan ($2.62 in chips) 
Seat 6: lawlex_2 ($1.51 in chips) 
UnRRRReal: posts small blind $0.01
Fran_Emm: posts big blind $0.02
*** HOLE CARDS ***
Dealt to lawlex_2 [Kc 6s]
wensihan: folds 
lawlex_2: folds 
fijiwater00: calls $0.02
Gevron: folds 
UnRRRReal: raises $0.06 to $0.08
Fran_Emm: folds 
fijiwater00: calls $0.06
*** FLOP *** [Kd Qd 9c]
UnRRRReal: checks 
fijiwater00: bets $0.02
UnRRRReal: calls $0.02
*** TURN *** [Kd Qd 9c] [Js]
UnRRRReal: checks 
fijiwater00: bets $0.19 and is all-in
UnRRRReal: folds 
Uncalled bet ($0.19) returned to fijiwater00
fijiwater00 collected $0.21 from pot
fijiwater00: doesn't show hand 
*** SUMMARY ***
Total pot $0.22 | Rake $0.01 
Board [Kd Qd 9c Js]
Seat 1: fijiwater00 collected ($0.21)
Seat 2: Gevron (button) folded before Flop (didn't bet)
Seat 3: UnRRRReal (small blind) folded on the Turn
Seat 4: Fran_Emm (big blind) folded before Flop
Seat 5: wensihan folded before Flop (didn't bet)
Seat 6: lawlex_2 folded before Flop (didn't bet)



PokerStars Hand #213054474426:  Hold'em No Limit ($0.01/$0.02 USD) - 2020/05/01 13:02:43 MSK [2020/05/01 6:02:43 ET]
Table 'Okavango III' 6-max Seat #3 is the button
Seat 1: fijiwater00 ($0.40 in chips) 
Seat 2: Gevron ($2.96 in chips) 
Seat 3: UnRRRReal ($1.70 in chips) 
Seat 4: Fran_Emm ($2.19 in chips) 
Seat 5: wensihan ($2.62 in chips) 
Seat 6: lawlex_2 ($1.51 in chips) 
Fran_Emm: posts small blind $0.01
wensihan: posts big blind $0.02
*** HOLE CARDS ***
Dealt to lawlex_2 [6d Ah]
lawlex_2: raises $0.04 to $0.06
fijiwater00: folds 
Gevron: raises $0.08 to $0.14
UnRRRReal: calls $0.14
Fran_Emm: folds 
wensihan: folds 
lawlex_2: calls $0.08
*** FLOP *** [Td Kh As]
lawlex_2: bets $0.43
Gevron: raises $2.39 to $2.82 and is all-in
UnRRRReal: folds 
lawlex_2: calls $0.94 and is all-in
Uncalled bet ($1.45) returned to Gevron
*** TURN *** [Td Kh As] [Qc]
*** RIVER *** [Td Kh As Qc] [4s]
*** SHOW DOWN ***
lawlex_2: shows [6d Ah] (a pair of Aces)
Gevron: shows [Jc Ac] (a straight, Ten to Ace)
Gevron collected $3.08 from pot
lawlex_2 cashed out the hand for $0.54 | Cash Out Fee $0.01
*** SUMMARY ***
Total pot $3.19 | Rake $0.11 
Board [Td Kh As Qc 4s]
Seat 1: fijiwater00 folded before Flop (didn't bet)
Seat 2: Gevron showed [Jc Ac] and won ($3.08) with a straight, Ten to Ace
Seat 3: UnRRRReal (button) folded on the Flop
Seat 4: Fran_Emm (small blind) folded before Flop
Seat 5: wensihan (big blind) folded before Flop
Seat 6: lawlex_2 showed [6d Ah] and lost with a pair of Aces (cashed out).



PokerStars Hand #213054495158:  Hold'em No Limit ($0.01/$0.02 USD) - 2020/05/01 13:03:21 MSK [2020/05/01 6:03:21 ET]
Table 'Okavango III' 6-max Seat #4 is the button
Seat 1: fijiwater00 ($0.40 in chips) 
Seat 3: UnRRRReal ($1.56 in chips) 
Seat 4: Fran_Emm ($2.18 in chips) 
Seat 5: wensihan ($2.60 in chips) 
Seat 6: lawlex_2 ($0.54 in chips) 
wensihan: posts small blind $0.01
lawlex_2: posts big blind $0.02
*** HOLE CARDS ***
Dealt to lawlex_2 [Jh 5d]
Gevron leaves the table
fijiwater00: calls $0.02
UnRRRReal: raises $0.06 to $0.08
Fran_Emm: folds 
TUSS_XXX joins the table at seat #2 
wensihan: raises $0.16 to $0.24
lawlex_2: folds 
fijiwater00: folds 
UnRRRReal: folds 
Uncalled bet ($0.16) returned to wensihan
wensihan collected $0.20 from pot
wensihan: doesn't show hand 
*** SUMMARY ***
Total pot $0.20 | Rake $0 
Seat 1: fijiwater00 folded before Flop
Seat 3: UnRRRReal folded before Flop
Seat 4: Fran_Emm (button) folded before Flop (didn't bet)
Seat 5: wensihan (small blind) collected ($0.20)
Seat 6: lawlex_2 (big blind) folded before Flop



PokerStars Hand #213054508792:  Hold'em No Limit ($0.01/$0.02 USD) - 2020/05/01 13:03:45 MSK [2020/05/01 6:03:45 ET]
Table 'Okavango III' 6-max Seat #5 is the button
Seat 1: fijiwater00 ($0.38 in chips) 
Seat 3: UnRRRReal ($1.92 in chips) 
Seat 4: Fran_Emm ($2.18 in chips) 
Seat 5: wensihan ($2.72 in chips) 
Seat 6: lawlex_2 ($0.52 in chips) 
lawlex_2: posts small blind $0.01
fijiwater00: posts big blind $0.02
TUSS_XXX: sits out 
*** HOLE CARDS ***
Dealt to lawlex_2 [6h 7c]
UnRRRReal: folds 
Fran_Emm: folds 
wensihan: folds 
lawlex_2: folds 
Uncalled bet ($0.01) returned to fijiwater00
fijiwater00 collected $0.02 from pot
fijiwater00: doesn't show hand 
*** SUMMARY ***
Total pot $0.02 | Rake $0 
Seat 1: fijiwater00 (big blind) collected ($0.02)
Seat 3: UnRRRReal folded before Flop (didn't bet)
Seat 4: Fran_Emm folded before Flop (didn't bet)
Seat 5: wensihan (button) folded before Flop (didn't bet)
Seat 6: lawlex_2 (small blind) folded before Flop



PokerStars Hand #213054516161:  Hold'em No Limit ($0.01/$0.02 USD) - 2020/05/01 13:03:58 MSK [2020/05/01 6:03:58 ET]
Table 'Okavango III' 6-max Seat #6 is the button
Seat 1: fijiwater00 ($0.39 in chips) 
Seat 2: TUSS_XXX ($1 in chips) 
Seat 3: UnRRRReal ($2 in chips) 
Seat 4: Fran_Emm ($2.18 in chips) 
Seat 5: wensihan ($2.72 in chips) 
Seat 6: lawlex_2 ($0.51 in chips) 
fijiwater00: posts small blind $0.01
TUSS_XXX: posts big blind $0.02
*** HOLE CARDS ***
Dealt to lawlex_2 [6d 8h]
UnRRRReal: folds 
Fran_Emm: raises $0.04 to $0.06
wensihan: folds 
lawlex_2: folds 
fijiwater00: calls $0.05
TUSS_XXX: folds 
*** FLOP *** [4c Qd 9h]
fijiwater00: checks 
Fran_Emm: bets $0.08
fijiwater00: folds 
Uncalled bet ($0.08) returned to Fran_Emm
Fran_Emm collected $0.14 from pot
*** SUMMARY ***
Total pot $0.14 | Rake $0 
Board [4c Qd 9h]
Seat 1: fijiwater00 (small blind) folded on the Flop
Seat 2: TUSS_XXX (big blind) folded before Flop
Seat 3: UnRRRReal folded before Flop (didn't bet)
Seat 4: Fran_Emm collected ($0.14)
Seat 5: wensihan folded before Flop (didn't bet)
Seat 6: lawlex_2 (button) folded before Flop (didn't bet)



PokerStars Hand #213054531522:  Hold'em No Limit ($0.01/$0.02 USD) - 2020/05/01 13:04:26 MSK [2020/05/01 6:04:26 ET]
Table 'Okavango III' 6-max Seat #1 is the button
Seat 1: fijiwater00 ($0.33 in chips) 
Seat 2: TUSS_XXX ($0.98 in chips) 
Seat 3: UnRRRReal ($2 in chips) 
Seat 4: Fran_Emm ($2.26 in chips) 
Seat 5: wensihan ($2.72 in chips) 
Seat 6: lawlex_2 ($0.51 in chips) 
TUSS_XXX: posts small blind $0.01
UnRRRReal: posts big blind $0.02
*** HOLE CARDS ***
Dealt to lawlex_2 [Ks 5s]
Fran_Emm: folds 
wensihan: folds 
lawlex_2: raises $0.04 to $0.06
fijiwater00: calls $0.06
TUSS_XXX: folds 
UnRRRReal: calls $0.04
*** FLOP *** [4h 6s Td]
UnRRRReal: bets $0.10
lawlex_2: folds 
fijiwater00: folds 
Uncalled bet ($0.10) returned to UnRRRReal
UnRRRReal collected $0.18 from pot
*** SUMMARY ***
Total pot $0.19 | Rake $0.01 
Board [4h 6s Td]
Seat 1: fijiwater00 (button) folded on the Flop
Seat 2: TUSS_XXX (small blind) folded before Flop
Seat 3: UnRRRReal (big blind) collected ($0.18)
Seat 4: Fran_Emm folded before Flop (didn't bet)
Seat 5: wensihan folded before Flop (didn't bet)
Seat 6: lawlex_2 folded on the Flop



PokerStars Hand #213054547334:  Hold'em No Limit ($0.01/$0.02 USD) - 2020/05/01 13:04:54 MSK [2020/05/01 6:04:54 ET]
Table 'Okavango III' 6-max Seat #2 is the button
Seat 1: fijiwater00 ($0.27 in chips) 
Seat 2: TUSS_XXX ($0.97 in chips) 
Seat 3: UnRRRReal ($2.12 in chips) 
Seat 4: Fran_Emm ($2.26 in chips) 
Seat 5: wensihan ($2.72 in chips) 
Seat 6: lawlex_2 ($0.45 in chips) 
UnRRRReal: posts small blind $0.01
Fran_Emm: posts big blind $0.02
*** HOLE CARDS ***
Dealt to lawlex_2 [7c 8d]
wensihan: folds 
lawlex_2: folds 
fijiwater00: calls $0.02
TUSS_XXX: folds 
UnRRRReal: raises $0.06 to $0.08
Fran_Emm: folds 
fijiwater00: calls $0.06
*** FLOP *** [5s 4h 6s]
UnRRRReal: bets $0.09
fijiwater00: calls $0.09
*** TURN *** [5s 4h 6s] [Ks]
UnRRRReal: checks 
fijiwater00: checks 
*** RIVER *** [5s 4h 6s Ks] [Kd]
UnRRRReal: checks 
fijiwater00: checks 
*** SHOW DOWN ***
UnRRRReal: shows [Ac 7h] (a pair of Kings)
fijiwater00: mucks hand 
UnRRRReal collected $0.35 from pot
*** SUMMARY ***
Total pot $0.36 | Rake $0.01 
Board [5s 4h 6s Ks Kd]
Seat 1: fijiwater00 mucked [3c 9c]
Seat 2: TUSS_XXX (button) folded before Flop (didn't bet)
Seat 3: UnRRRReal (small blind) showed [Ac 7h] and won ($0.35) with a pair of Kings
Seat 4: Fran_Emm (big blind) folded before Flop
Seat 5: wensihan folded before Flop (didn't bet)
Seat 6: lawlex_2 folded before Flop (didn't bet)



PokerStars Hand #213054566357:  Hold'em No Limit ($0.01/$0.02 USD) - 2020/05/01 13:05:29 MSK [2020/05/01 6:05:29 ET]
Table 'Okavango III' 6-max Seat #3 is the button
Seat 1: fijiwater00 ($0.10 in chips) 
Seat 2: TUSS_XXX ($0.97 in chips) 
Seat 3: UnRRRReal ($2.30 in chips) 
Seat 4: Fran_Emm ($2.24 in chips) 
Seat 5: wensihan ($2.72 in chips) 
Seat 6: lawlex_2 ($0.45 in chips) 
Fran_Emm: posts small blind $0.01
wensihan: posts big blind $0.02
*** HOLE CARDS ***
Dealt to lawlex_2 [9h 3h]
lawlex_2: folds 
fijiwater00: calls $0.02
TUSS_XXX: folds 
UnRRRReal: raises $0.06 to $0.08
Fran_Emm: folds 
wensihan: folds 
fijiwater00: calls $0.06
*** FLOP *** [4d 3s Jh]
fijiwater00: bets $0.02 and is all-in
UnRRRReal: calls $0.02
*** TURN *** [4d 3s Jh] [Ts]
*** RIVER *** [4d 3s Jh Ts] [Td]
*** SHOW DOWN ***
fijiwater00: shows [9d 7h] (a pair of Tens)
UnRRRReal: shows [Ad Kh] (a pair of Tens - Ace kicker)
UnRRRReal collected $0.22 from pot
*** SUMMARY ***
Total pot $0.23 | Rake $0.01 
Board [4d 3s Jh Ts Td]
Seat 1: fijiwater00 showed [9d 7h] and lost with a pair of Tens
Seat 2: TUSS_XXX folded before Flop (didn't bet)
Seat 3: UnRRRReal (button) showed [Ad Kh] and won ($0.22) with a pair of Tens
Seat 4: Fran_Emm (small blind) folded before Flop
Seat 5: wensihan (big blind) folded before Flop
Seat 6: lawlex_2 folded before Flop (didn't bet)



PokerStars Hand #213054584086:  Hold'em No Limit ($0.01/$0.02 USD) - 2020/05/01 13:06:00 MSK [2020/05/01 6:06:00 ET]
Table 'Okavango III' 6-max Seat #4 is the button
Seat 2: TUSS_XXX ($0.97 in chips) 
Seat 3: UnRRRReal ($2.42 in chips) 
Seat 4: Fran_Emm ($2.23 in chips) 
Seat 5: wensihan ($2.70 in chips) 
Seat 6: lawlex_2 ($0.45 in chips) 
wensihan: posts small blind $0.01
lawlex_2: posts big blind $0.02
*** HOLE CARDS ***
Dealt to lawlex_2 [Tc 5h]
TUSS_XXX: folds 
UnRRRReal: raises $0.04 to $0.06
Fran_Emm: folds 
wensihan: folds 
fijiwater00 leaves the table
lawlex_2: calls $0.04
*** FLOP *** [Qd 4d Jh]
lawlex_2: checks 
UnRRRReal: checks 
*** TURN *** [Qd 4d Jh] [9s]
scorpka joins the table at seat #1 
lawlex_2: bets $0.13
UnRRRReal: calls $0.13
*** RIVER *** [Qd 4d Jh 9s] [Qs]
lawlex_2: bets $0.26 and is all-in
UnRRRReal: folds 
Uncalled bet ($0.26) returned to lawlex_2
lawlex_2 collected $0.38 from pot
lawlex_2: doesn't show hand 
*** SUMMARY ***
Total pot $0.39 | Rake $0.01 
Board [Qd 4d Jh 9s Qs]
Seat 2: TUSS_XXX folded before Flop (didn't bet)
Seat 3: UnRRRReal folded on the River
Seat 4: Fran_Emm (button) folded before Flop (didn't bet)
Seat 5: wensihan (small blind) folded before Flop
Seat 6: lawlex_2 (big blind) collected ($0.38)



PokerStars Hand #213054609600:  Hold'em No Limit ($0.01/$0.02 USD) - 2020/05/01 13:06:45 MSK [2020/05/01 6:06:45 ET]
Table 'Okavango III' 6-max Seat #5 is the button
Seat 1: scorpka ($2 in chips) 
Seat 2: TUSS_XXX ($0.97 in chips) 
Seat 3: UnRRRReal ($2.23 in chips) 
Seat 4: Fran_Emm ($2.23 in chips) 
Seat 5: wensihan ($2.69 in chips) 
Seat 6: lawlex_2 ($0.64 in chips) 
lawlex_2: posts small blind $0.01
scorpka: posts big blind $0.02
*** HOLE CARDS ***
Dealt to lawlex_2 [4s Jc]
TUSS_XXX: folds 
UnRRRReal: folds 
Fran_Emm: folds 
wensihan: folds 
lawlex_2: folds 
Uncalled bet ($0.01) returned to scorpka
scorpka collected $0.02 from pot
scorpka: doesn't show hand 
*** SUMMARY ***
Total pot $0.02 | Rake $0 
Seat 1: scorpka (big blind) collected ($0.02)
Seat 2: TUSS_XXX folded before Flop (didn't bet)
Seat 3: UnRRRReal folded before Flop (didn't bet)
Seat 4: Fran_Emm folded before Flop (didn't bet)
Seat 5: wensihan (button) folded before Flop (didn't bet)
Seat 6: lawlex_2 (small blind) folded before Flop



PokerStars Hand #213054616712:  Hold'em No Limit ($0.01/$0.02 USD) - 2020/05/01 13:06:58 MSK [2020/05/01 6:06:58 ET]
Table 'Okavango III' 6-max Seat #6 is the button
Seat 1: scorpka ($2.01 in chips) 
Seat 2: TUSS_XXX ($0.97 in chips) 
Seat 3: UnRRRReal ($2.23 in chips) 
Seat 4: Fran_Emm ($2.23 in chips) 
Seat 5: wensihan ($2.69 in chips) 
Seat 6: lawlex_2 ($0.63 in chips) 
scorpka: posts small blind $0.01
TUSS_XXX: posts big blind $0.02
*** HOLE CARDS ***
Dealt to lawlex_2 [3c 2h]
UnRRRReal: folds 
Fran_Emm: raises $0.04 to $0.06
wensihan: folds 
lawlex_2: folds 
scorpka: folds 
TUSS_XXX: folds 
Uncalled bet ($0.04) returned to Fran_Emm
Fran_Emm collected $0.05 from pot
*** SUMMARY ***
Total pot $0.05 | Rake $0 
Seat 1: scorpka (small blind) folded before Flop
Seat 2: TUSS_XXX (big blind) folded before Flop
Seat 3: UnRRRReal folded before Flop (didn't bet)
Seat 4: Fran_Emm collected ($0.05)
Seat 5: wensihan folded before Flop (didn't bet)
Seat 6: lawlex_2 (button) folded before Flop (didn't bet)



PokerStars Hand #213054627276:  Hold'em No Limit ($0.01/$0.02 USD) - 2020/05/01 13:07:16 MSK [2020/05/01 6:07:16 ET]
Table 'Okavango III' 6-max Seat #1 is the button
Seat 1: scorpka ($2 in chips) 
Seat 2: TUSS_XXX ($0.95 in chips) 
Seat 3: UnRRRReal ($2.23 in chips) 
Seat 4: Fran_Emm ($2.26 in chips) 
Seat 5: wensihan ($2.69 in chips) 
Seat 6: lawlex_2 ($0.63 in chips) 
TUSS_XXX: posts small blind $0.01
UnRRRReal: posts big blind $0.02
*** HOLE CARDS ***
Dealt to lawlex_2 [7d 3c]
Fran_Emm: raises $0.04 to $0.06
wensihan: folds 
lawlex_2: folds 
scorpka: folds 
TUSS_XXX: folds 
UnRRRReal: folds 
Uncalled bet ($0.04) returned to Fran_Emm
Fran_Emm collected $0.05 from pot
*** SUMMARY ***
Total pot $0.05 | Rake $0 
Seat 1: scorpka (button) folded before Flop (didn't bet)
Seat 2: TUSS_XXX (small blind) folded before Flop
Seat 3: UnRRRReal (big blind) folded before Flop
Seat 4: Fran_Emm collected ($0.05)
Seat 5: wensihan folded before Flop (didn't bet)
Seat 6: lawlex_2 folded before Flop (didn't bet)



PokerStars Hand #213054635154:  Hold'em No Limit ($0.01/$0.02 USD) - 2020/05/01 13:07:30 MSK [2020/05/01 6:07:30 ET]
Table 'Okavango III' 6-max Seat #2 is the button
Seat 1: scorpka ($2 in chips) 
Seat 2: TUSS_XXX ($0.94 in chips) 
Seat 3: UnRRRReal ($2.21 in chips) 
Seat 4: Fran_Emm ($2.29 in chips) 
Seat 5: wensihan ($2.69 in chips) 
Seat 6: lawlex_2 ($0.63 in chips) 
UnRRRReal: posts small blind $0.01
Fran_Emm: posts big blind $0.02
*** HOLE CARDS ***
Dealt to lawlex_2 [5c 5h]
wensihan: raises $0.05 to $0.07
lawlex_2: calls $0.07
scorpka: folds 
TUSS_XXX: folds 
UnRRRReal: folds 
Fran_Emm: folds 
*** FLOP *** [3c Ac 9s]
wensihan: checks 
lawlex_2: bets $0.11
wensihan: calls $0.11
*** TURN *** [3c Ac 9s] [3s]
wensihan: checks 
lawlex_2: checks 
*** RIVER *** [3c Ac 9s 3s] [9h]
wensihan: bets $0.18
lawlex_2: calls $0.18
*** SHOW DOWN ***
wensihan: shows [As Qh] (two pair, Aces and Nines)
lawlex_2: mucks hand 
wensihan collected $0.72 from pot
*** SUMMARY ***
Total pot $0.75 | Rake $0.03 
Board [3c Ac 9s 3s 9h]
Seat 1: scorpka folded before Flop (didn't bet)
Seat 2: TUSS_XXX (button) folded before Flop (didn't bet)
Seat 3: UnRRRReal (small blind) folded before Flop
Seat 4: Fran_Emm (big blind) folded before Flop
Seat 5: wensihan showed [As Qh] and won ($0.72) with two pair, Aces and Nines
Seat 6: lawlex_2 mucked [5c 5h]



PokerStars Hand #213054657477:  Hold'em No Limit ($0.01/$0.02 USD) - 2020/05/01 13:08:10 MSK [2020/05/01 6:08:10 ET]
Table 'Okavango III' 6-max Seat #3 is the button
Seat 1: scorpka ($2 in chips) 
Seat 2: TUSS_XXX ($0.94 in chips) 
Seat 3: UnRRRReal ($2.20 in chips) 
Seat 4: Fran_Emm ($2.27 in chips) 
Seat 5: wensihan ($3.05 in chips) 
Seat 6: lawlex_2 ($0.27 in chips) 
Fran_Emm: posts small blind $0.01
wensihan: posts big blind $0.02
*** HOLE CARDS ***
Dealt to lawlex_2 [Tc Ah]
lawlex_2: raises $0.05 to $0.07
scorpka: folds 
TUSS_XXX: folds 
UnRRRReal: folds 
Fran_Emm: folds 
wensihan: calls $0.05
*** FLOP *** [Kc Th Td]
wensihan: checks 
lawlex_2: bets $0.20 and is all-in
wensihan: folds 
Uncalled bet ($0.20) returned to lawlex_2
lawlex_2 collected $0.14 from pot
lawlex_2: doesn't show hand 
*** SUMMARY ***
Total pot $0.15 | Rake $0.01 
Board [Kc Th Td]
Seat 1: scorpka folded before Flop (didn't bet)
Seat 2: TUSS_XXX folded before Flop (didn't bet)
Seat 3: UnRRRReal (button) folded before Flop (didn't bet)
Seat 4: Fran_Emm (small blind) folded before Flop
Seat 5: wensihan (big blind) folded on the Flop
Seat 6: lawlex_2 collected ($0.14)



PokerStars Hand #213054674709:  Hold'em No Limit ($0.01/$0.02 USD) - 2020/05/01 13:08:41 MSK [2020/05/01 6:08:41 ET]
Table 'Okavango III' 6-max Seat #4 is the button
Seat 1: scorpka ($2 in chips) 
Seat 2: TUSS_XXX ($0.94 in chips) 
Seat 3: UnRRRReal ($2.20 in chips) 
Seat 4: Fran_Emm ($2.26 in chips) 
Seat 5: wensihan ($2.98 in chips) 
Seat 6: lawlex_2 ($0.34 in chips) 
wensihan: posts small blind $0.01
lawlex_2: posts big blind $0.02
*** HOLE CARDS ***
Dealt to lawlex_2 [As 2h]
scorpka: folds 
TUSS_XXX: folds 
UnRRRReal: folds 
Fran_Emm: raises $0.03 to $0.05
wensihan: calls $0.04
lawlex_2: calls $0.03
*** FLOP *** [4s 9c Ah]
wensihan: checks 
lawlex_2: bets $0.02
Fran_Emm: folds 
wensihan: folds 
Uncalled bet ($0.02) returned to lawlex_2
lawlex_2 collected $0.14 from pot
lawlex_2: doesn't show hand 
*** SUMMARY ***
Total pot $0.15 | Rake $0.01 
Board [4s 9c Ah]
Seat 1: scorpka folded before Flop (didn't bet)
Seat 2: TUSS_XXX folded before Flop (didn't bet)
Seat 3: UnRRRReal folded before Flop (didn't bet)
Seat 4: Fran_Emm (button) folded on the Flop
Seat 5: wensihan (small blind) folded on the Flop
Seat 6: lawlex_2 (big blind) collected ($0.14)



PokerStars Hand #213054689323:  Hold'em No Limit ($0.01/$0.02 USD) - 2020/05/01 13:09:07 MSK [2020/05/01 6:09:07 ET]
Table 'Okavango III' 6-max Seat #5 is the button
Seat 1: scorpka ($2 in chips) 
Seat 2: TUSS_XXX ($0.94 in chips) 
Seat 3: UnRRRReal ($2.20 in chips) 
Seat 4: Fran_Emm ($2.21 in chips) 
Seat 5: wensihan ($2.93 in chips) 
Seat 6: lawlex_2 ($0.43 in chips) 
lawlex_2: posts small blind $0.01
scorpka: posts big blind $0.02
*** HOLE CARDS ***
Dealt to lawlex_2 [5c Qd]
TUSS_XXX: folds 
UnRRRReal: folds 
Fran_Emm: folds 
wensihan: raises $0.04 to $0.06
lawlex_2: folds 
scorpka: folds 
Uncalled bet ($0.04) returned to wensihan
wensihan collected $0.05 from pot
wensihan: doesn't show hand 
*** SUMMARY ***
Total pot $0.05 | Rake $0 
Seat 1: scorpka (big blind) folded before Flop
Seat 2: TUSS_XXX folded before Flop (didn't bet)
Seat 3: UnRRRReal folded before Flop (didn't bet)
Seat 4: Fran_Emm folded before Flop (didn't bet)
Seat 5: wensihan (button) collected ($0.05)
Seat 6: lawlex_2 (small blind) folded before Flop



PokerStars Hand #213054700194:  Hold'em No Limit ($0.01/$0.02 USD) - 2020/05/01 13:09:26 MSK [2020/05/01 6:09:26 ET]
Table 'Okavango III' 6-max Seat #6 is the button
Seat 1: scorpka ($1.98 in chips) 
Seat 2: TUSS_XXX ($0.94 in chips) 
Seat 3: UnRRRReal ($2.20 in chips) 
Seat 4: Fran_Emm ($2.21 in chips) 
Seat 5: wensihan ($2.96 in chips) 
Seat 6: lawlex_2 ($0.42 in chips) 
scorpka: posts small blind $0.01
TUSS_XXX: posts big blind $0.02
*** HOLE CARDS ***
Dealt to lawlex_2 [Ac Kh]
UnRRRReal: folds 
Fran_Emm: folds 
wensihan: folds 
lawlex_2: raises $0.04 to $0.06
scorpka: folds 
TUSS_XXX: folds 
Uncalled bet ($0.04) returned to lawlex_2
lawlex_2 collected $0.05 from pot
lawlex_2: doesn't show hand 
*** SUMMARY ***
Total pot $0.05 | Rake $0 
Seat 1: scorpka (small blind) folded before Flop
Seat 2: TUSS_XXX (big blind) folded before Flop
Seat 3: UnRRRReal folded before Flop (didn't bet)
Seat 4: Fran_Emm folded before Flop (didn't bet)
Seat 5: wensihan folded before Flop (didn't bet)
Seat 6: lawlex_2 (button) collected ($0.05)



PokerStars Hand #213054709557:  Hold'em No Limit ($0.01/$0.02 USD) - 2020/05/01 13:09:43 MSK [2020/05/01 6:09:43 ET]
Table 'Okavango III' 6-max Seat #1 is the button
Seat 1: scorpka ($1.97 in chips) 
Seat 2: TUSS_XXX ($0.92 in chips) 
Seat 3: UnRRRReal ($2.20 in chips) 
Seat 4: Fran_Emm ($2.21 in chips) 
Seat 5: wensihan ($2.96 in chips) 
Seat 6: lawlex_2 ($0.45 in chips) 
TUSS_XXX: posts small blind $0.01
UnRRRReal: posts big blind $0.02
*** HOLE CARDS ***
Dealt to lawlex_2 [Qd Qc]
Fran_Emm: folds 
wensihan: folds 
lawlex_2: calls $0.02
scorpka: folds 
TUSS_XXX: calls $0.01
UnRRRReal: raises $0.06 to $0.08
lawlex_2: calls $0.06
TUSS_XXX: calls $0.06
*** FLOP *** [7c Tc Qs]
TUSS_XXX: checks 
UnRRRReal: checks 
lawlex_2: checks 
*** TURN *** [7c Tc Qs] [As]
TUSS_XXX: checks 
UnRRRReal: checks 
lawlex_2: checks 
*** RIVER *** [7c Tc Qs As] [3d]
TUSS_XXX: checks 
UnRRRReal: bets $0.12
lawlex_2: raises $0.25 to $0.37 and is all-in
TUSS_XXX: folds 
UnRRRReal: calls $0.25
*** SHOW DOWN ***
lawlex_2: shows [Qd Qc] (three of a kind, Queens)
UnRRRReal: shows [2h Ad] (a pair of Aces)
lawlex_2 collected $0.95 from pot
*** SUMMARY ***
Total pot $0.98 | Rake $0.03 
Board [7c Tc Qs As 3d]
Seat 1: scorpka (button) folded before Flop (didn't bet)
Seat 2: TUSS_XXX (small blind) folded on the River
Seat 3: UnRRRReal (big blind) showed [2h Ad] and lost with a pair of Aces
Seat 4: Fran_Emm folded before Flop (didn't bet)
Seat 5: wensihan folded before Flop (didn't bet)
Seat 6: lawlex_2 showed [Qd Qc] and won ($0.95) with three of a kind, Queens



PokerStars Hand #213054743516:  Hold'em No Limit ($0.01/$0.02 USD) - 2020/05/01 13:10:43 MSK [2020/05/01 6:10:43 ET]
Table 'Okavango III' 6-max Seat #2 is the button
Seat 1: scorpka ($1.97 in chips) 
Seat 2: TUSS_XXX ($0.84 in chips) 
Seat 3: UnRRRReal ($1.75 in chips) 
Seat 4: Fran_Emm ($2.21 in chips) 
Seat 5: wensihan ($2.96 in chips) 
Seat 6: lawlex_2 ($0.95 in chips) 
UnRRRReal: posts small blind $0.01
Fran_Emm: posts big blind $0.02
*** HOLE CARDS ***
Dealt to lawlex_2 [Jc Qd]
wensihan: folds 
lawlex_2: calls $0.02
scorpka: raises $0.06 to $0.08
TUSS_XXX: folds 
UnRRRReal: folds 
Fran_Emm: folds 
lawlex_2: calls $0.06
*** FLOP *** [Qs 3d 8d]
lawlex_2: bets $0.12
scorpka: calls $0.12
*** TURN *** [Qs 3d 8d] [3h]
lawlex_2: bets $0.27
scorpka: raises $0.27 to $0.54
lawlex_2: calls $0.27
*** RIVER *** [Qs 3d 8d 3h] [4h]
lawlex_2: bets $0.21 and is all-in
scorpka: calls $0.21
*** SHOW DOWN ***
lawlex_2: shows [Jc Qd] (two pair, Queens and Threes)
scorpka: shows [Ks Qh] (two pair, Queens and Threes - King kicker)
scorpka collected $1.86 from pot
*** SUMMARY ***
Total pot $1.93 | Rake $0.07 
Board [Qs 3d 8d 3h 4h]
Seat 1: scorpka showed [Ks Qh] and won ($1.86) with two pair, Queens and Threes
Seat 2: TUSS_XXX (button) folded before Flop (didn't bet)
Seat 3: UnRRRReal (small blind) folded before Flop
Seat 4: Fran_Emm (big blind) folded before Flop
Seat 5: wensihan folded before Flop (didn't bet)
Seat 6: lawlex_2 showed [Jc Qd] and lost with two pair, Queens and Threes



PokerStars Hand #213054790729:  Hold'em No Limit ($0.01/$0.02 USD) - 2020/05/01 13:11:56 MSK [2020/05/01 6:11:56 ET]
Table 'Okavango III' 6-max Seat #4 is the button
Seat 1: scorpka ($2.88 in chips) 
Seat 2: TUSS_XXX ($0.90 in chips) 
Seat 3: UnRRRReal ($1.99 in chips) 
Seat 4: Fran_Emm ($2.18 in chips) 
Seat 5: wensihan ($2.91 in chips) 
Seat 6: lawlex_2 ($2 in chips) 
wensihan: posts small blind $0.01
lawlex_2: posts big blind $0.02
*** HOLE CARDS ***
Dealt to lawlex_2 [2h Qs]
scorpka: folds 
TUSS_XXX: folds 
UnRRRReal: folds 
Fran_Emm: raises $0.03 to $0.05
wensihan: folds 
lawlex_2: folds 
Uncalled bet ($0.03) returned to Fran_Emm
Fran_Emm collected $0.05 from pot
*** SUMMARY ***
Total pot $0.05 | Rake $0 
Seat 1: scorpka folded before Flop (didn't bet)
Seat 2: TUSS_XXX folded before Flop (didn't bet)
Seat 3: UnRRRReal folded before Flop (didn't bet)
Seat 4: Fran_Emm (button) collected ($0.05)
Seat 5: wensihan (small blind) folded before Flop
Seat 6: lawlex_2 (big blind) folded before Flop



PokerStars Hand #213054802488:  Hold'em No Limit ($0.01/$0.02 USD) - 2020/05/01 13:12:17 MSK [2020/05/01 6:12:17 ET]
Table 'Okavango III' 6-max Seat #5 is the button
Seat 1: scorpka ($2.88 in chips) 
Seat 2: TUSS_XXX ($0.90 in chips) 
Seat 3: UnRRRReal ($1.99 in chips) 
Seat 4: Fran_Emm ($2.21 in chips) 
Seat 5: wensihan ($2.90 in chips) 
Seat 6: lawlex_2 ($1.98 in chips) 
lawlex_2: posts small blind $0.01
scorpka: posts big blind $0.02
*** HOLE CARDS ***
Dealt to lawlex_2 [3d 8d]
TUSS_XXX: folds 
UnRRRReal: raises $0.04 to $0.06
Fran_Emm: folds 
wensihan: calls $0.06
lawlex_2: folds 
scorpka: calls $0.04
*** FLOP *** [Jd 4h Qh]
scorpka: checks 
UnRRRReal: checks 
wensihan: bets $0.10
scorpka: folds 
UnRRRReal: calls $0.10
*** TURN *** [Jd 4h Qh] [Ac]
UnRRRReal: bets $0.19
wensihan: folds 
Uncalled bet ($0.19) returned to UnRRRReal
UnRRRReal collected $0.38 from pot
*** SUMMARY ***
Total pot $0.39 | Rake $0.01 
Board [Jd 4h Qh Ac]
Seat 1: scorpka (big blind) folded on the Flop
Seat 2: TUSS_XXX folded before Flop (didn't bet)
Seat 3: UnRRRReal collected ($0.38)
Seat 4: Fran_Emm folded before Flop (didn't bet)
Seat 5: wensihan (button) folded on the Turn
Seat 6: lawlex_2 (small blind) folded before Flop



PokerStars Hand #213054824789:  Hold'em No Limit ($0.01/$0.02 USD) - 2020/05/01 13:12:57 MSK [2020/05/01 6:12:57 ET]
Table 'Okavango III' 6-max Seat #6 is the button
Seat 1: scorpka ($2.82 in chips) 
Seat 2: TUSS_XXX ($0.90 in chips) 
Seat 3: UnRRRReal ($2.21 in chips) 
Seat 4: Fran_Emm ($2.21 in chips) 
Seat 5: wensihan ($2.74 in chips) 
Seat 6: lawlex_2 ($1.97 in chips) 
scorpka: posts small blind $0.01
TUSS_XXX: posts big blind $0.02
*** HOLE CARDS ***
Dealt to lawlex_2 [6d Kh]
UnRRRReal: raises $0.04 to $0.06
Fran_Emm: folds 
wensihan: folds 
lawlex_2: folds 
scorpka: folds 
TUSS_XXX: folds 
Uncalled bet ($0.04) returned to UnRRRReal
UnRRRReal collected $0.05 from pot
*** SUMMARY ***
Total pot $0.05 | Rake $0 
Seat 1: scorpka (small blind) folded before Flop
Seat 2: TUSS_XXX (big blind) folded before Flop
Seat 3: UnRRRReal collected ($0.05)
Seat 4: Fran_Emm folded before Flop (didn't bet)
Seat 5: wensihan folded before Flop (didn't bet)
Seat 6: lawlex_2 (button) folded before Flop (didn't bet)



PokerStars Hand #213054834914:  Hold'em No Limit ($0.01/$0.02 USD) - 2020/05/01 13:13:14 MSK [2020/05/01 6:13:14 ET]
Table 'Okavango III' 6-max Seat #1 is the button
Seat 1: scorpka ($2.81 in chips) 
Seat 2: TUSS_XXX ($0.88 in chips) 
Seat 3: UnRRRReal ($2.24 in chips) 
Seat 4: Fran_Emm ($2.21 in chips) 
Seat 5: wensihan ($2.74 in chips) 
Seat 6: lawlex_2 ($1.97 in chips) 
TUSS_XXX: posts small blind $0.01
UnRRRReal: posts big blind $0.02
*** HOLE CARDS ***
Dealt to lawlex_2 [4s 4h]
Fran_Emm: raises $0.04 to $0.06
wensihan: folds 
lawlex_2: calls $0.06
scorpka: folds 
TUSS_XXX: calls $0.05
UnRRRReal: folds 
*** FLOP *** [8d Qh 8s]
TUSS_XXX: checks 
Fran_Emm: checks 
lawlex_2: bets $0.13
TUSS_XXX: calls $0.13
Fran_Emm: folds 
*** TURN *** [8d Qh 8s] [6s]
TUSS_XXX: checks 
lawlex_2: checks 
*** RIVER *** [8d Qh 8s 6s] [Jc]
TUSS_XXX: checks 
lawlex_2: checks 
*** SHOW DOWN ***
TUSS_XXX: shows [Th Ts] (two pair, Tens and Eights)
lawlex_2: mucks hand 
TUSS_XXX collected $0.44 from pot
*** SUMMARY ***
Total pot $0.46 | Rake $0.02 
Board [8d Qh 8s 6s Jc]
Seat 1: scorpka (button) folded before Flop (didn't bet)
Seat 2: TUSS_XXX (small blind) showed [Th Ts] and won ($0.44) with two pair, Tens and Eights
Seat 3: UnRRRReal (big blind) folded before Flop
Seat 4: Fran_Emm folded on the Flop
Seat 5: wensihan folded before Flop (didn't bet)
Seat 6: lawlex_2 mucked [4s 4h]



PokerStars Hand #213054862072:  Hold'em No Limit ($0.01/$0.02 USD) - 2020/05/01 13:14:03 MSK [2020/05/01 6:14:03 ET]
Table 'Okavango III' 6-max Seat #2 is the button
Seat 1: scorpka ($2.81 in chips) 
Seat 2: TUSS_XXX ($1.13 in chips) 
Seat 3: UnRRRReal ($2.22 in chips) 
Seat 4: Fran_Emm ($2.15 in chips) 
Seat 5: wensihan ($2.74 in chips) 
Seat 6: lawlex_2 ($1.78 in chips) 
UnRRRReal: posts small blind $0.01
Fran_Emm: posts big blind $0.02
*** HOLE CARDS ***
Dealt to lawlex_2 [Ad Jc]
wensihan: folds 
lawlex_2: raises $0.04 to $0.06
scorpka: raises $0.12 to $0.18
TUSS_XXX: folds 
UnRRRReal: folds 
Fran_Emm: folds 
lawlex_2: calls $0.12
*** FLOP *** [Ac 6s 8s]
lawlex_2: checks 
scorpka: bets $0.22
lawlex_2: calls $0.22
*** TURN *** [Ac 6s 8s] [6d]
lawlex_2: checks 
scorpka: checks 
*** RIVER *** [Ac 6s 8s 6d] [2d]
lawlex_2: bets $0.53
scorpka: calls $0.53
*** SHOW DOWN ***
lawlex_2: shows [Ad Jc] (two pair, Aces and Sixes)
scorpka: mucks hand 
lawlex_2 collected $1.82 from pot
*** SUMMARY ***
Total pot $1.89 | Rake $0.07 
Board [Ac 6s 8s 6d 2d]
Seat 1: scorpka mucked [Kd Ks]
Seat 2: TUSS_XXX (button) folded before Flop (didn't bet)
Seat 3: UnRRRReal (small blind) folded before Flop
Seat 4: Fran_Emm (big blind) folded before Flop
Seat 5: wensihan folded before Flop (didn't bet)
Seat 6: lawlex_2 showed [Ad Jc] and won ($1.82) with two pair, Aces and Sixes



PokerStars Hand #213054887775:  Hold'em No Limit ($0.01/$0.02 USD) - 2020/05/01 13:14:48 MSK [2020/05/01 6:14:48 ET]
Table 'Okavango III' 6-max Seat #3 is the button
Seat 1: scorpka ($2 in chips) 
Seat 2: TUSS_XXX ($1.13 in chips) 
Seat 3: UnRRRReal ($2.21 in chips) 
Seat 4: Fran_Emm ($2.13 in chips) 
Seat 5: wensihan ($2.74 in chips) 
Seat 6: lawlex_2 ($2.67 in chips) 
Fran_Emm: posts small blind $0.01
wensihan: posts big blind $0.02
*** HOLE CARDS ***
Dealt to lawlex_2 [Kd 2h]
lawlex_2: folds 
scorpka: folds 
TUSS_XXX: raises $0.03 to $0.05
UnRRRReal: folds 
Fran_Emm: folds 
wensihan: calls $0.03
*** FLOP *** [5d 4s 3d]
wensihan: checks 
TUSS_XXX: bets $0.07
wensihan: calls $0.07
*** TURN *** [5d 4s 3d] [2d]
wensihan: checks 
TUSS_XXX: bets $0.18
wensihan: folds 
Uncalled bet ($0.18) returned to TUSS_XXX
TUSS_XXX collected $0.24 from pot
TUSS_XXX: doesn't show hand 
*** SUMMARY ***
Total pot $0.25 | Rake $0.01 
Board [5d 4s 3d 2d]
Seat 1: scorpka folded before Flop (didn't bet)
Seat 2: TUSS_XXX collected ($0.24)
Seat 3: UnRRRReal (button) folded before Flop (didn't bet)
Seat 4: Fran_Emm (small blind) folded before Flop
Seat 5: wensihan (big blind) folded on the Turn
Seat 6: lawlex_2 folded before Flop (didn't bet)



PokerStars Hand #213054908373:  Hold'em No Limit ($0.01/$0.02 USD) - 2020/05/01 13:15:25 MSK [2020/05/01 6:15:25 ET]
Table 'Okavango III' 6-max Seat #4 is the button
Seat 1: scorpka ($2 in chips) 
Seat 2: TUSS_XXX ($1.25 in chips) 
Seat 3: UnRRRReal ($2.21 in chips) 
Seat 4: Fran_Emm ($2.12 in chips) 
Seat 5: wensihan ($2.62 in chips) 
Seat 6: lawlex_2 ($2.67 in chips) 
wensihan: posts small blind $0.01
lawlex_2: posts big blind $0.02
*** HOLE CARDS ***
Dealt to lawlex_2 [8h Td]
scorpka: folds 
TUSS_XXX: calls $0.02
UnRRRReal: raises $0.06 to $0.08
Fran_Emm: folds 
wensihan: folds 
lawlex_2: folds 
TUSS_XXX: calls $0.06
*** FLOP *** [2h 8c Ad]
TUSS_XXX: checks 
UnRRRReal: checks 
*** TURN *** [2h 8c Ad] [3c]
TUSS_XXX: bets $0.14
UnRRRReal: calls $0.14
*** RIVER *** [2h 8c Ad 3c] [Kd]
TUSS_XXX: bets $0.34
UnRRRReal: folds 
Uncalled bet ($0.34) returned to TUSS_XXX
TUSS_XXX collected $0.45 from pot
TUSS_XXX: doesn't show hand 
*** SUMMARY ***
Total pot $0.47 | Rake $0.02 
Board [2h 8c Ad 3c Kd]
Seat 1: scorpka folded before Flop (didn't bet)
Seat 2: TUSS_XXX collected ($0.45)
Seat 3: UnRRRReal folded on the River
Seat 4: Fran_Emm (button) folded before Flop (didn't bet)
Seat 5: wensihan (small blind) folded before Flop
Seat 6: lawlex_2 (big blind) folded before Flop



PokerStars Hand #213054936659:  Hold'em No Limit ($0.01/$0.02 USD) - 2020/05/01 13:16:15 MSK [2020/05/01 6:16:15 ET]
Table 'Okavango III' 6-max Seat #5 is the button
Seat 1: scorpka ($2 in chips) 
Seat 2: TUSS_XXX ($1.48 in chips) 
Seat 3: UnRRRReal ($1.99 in chips) 
Seat 4: Fran_Emm ($2.12 in chips) 
Seat 5: wensihan ($2.61 in chips) 
Seat 6: lawlex_2 ($2.65 in chips) 
lawlex_2: posts small blind $0.01
scorpka: posts big blind $0.02
*** HOLE CARDS ***
Dealt to lawlex_2 [Jh 6h]
TUSS_XXX: folds 
UnRRRReal: folds 
Fran_Emm: raises $0.04 to $0.06
wensihan: calls $0.06
lawlex_2: folds 
scorpka: folds 
*** FLOP *** [Ac 9s 5c]
Fran_Emm: checks 
wensihan: bets $0.08
Fran_Emm: folds 
Uncalled bet ($0.08) returned to wensihan
wensihan collected $0.14 from pot
wensihan: doesn't show hand 
*** SUMMARY ***
Total pot $0.15 | Rake $0.01 
Board [Ac 9s 5c]
Seat 1: scorpka (big blind) folded before Flop
Seat 2: TUSS_XXX folded before Flop (didn't bet)
Seat 3: UnRRRReal folded before Flop (didn't bet)
Seat 4: Fran_Emm folded on the Flop
Seat 5: wensihan (button) collected ($0.14)
Seat 6: lawlex_2 (small blind) folded before Flop



PokerStars Hand #213054955389:  Hold'em No Limit ($0.01/$0.02 USD) - 2020/05/01 13:16:48 MSK [2020/05/01 6:16:48 ET]
Table 'Okavango III' 6-max Seat #6 is the button
Seat 1: scorpka ($1.98 in chips) 
Seat 2: TUSS_XXX ($1.48 in chips) 
Seat 3: UnRRRReal ($1.99 in chips) 
Seat 4: Fran_Emm ($2.06 in chips) 
Seat 5: wensihan ($2.69 in chips) 
Seat 6: lawlex_2 ($2.64 in chips) 
scorpka: posts small blind $0.01
TUSS_XXX: posts big blind $0.02
*** HOLE CARDS ***
Dealt to lawlex_2 [7d 2h]
UnRRRReal: raises $0.04 to $0.06
Fran_Emm: folds 
wensihan: folds 
lawlex_2: folds 
scorpka: folds 
TUSS_XXX: folds 
Uncalled bet ($0.04) returned to UnRRRReal
UnRRRReal collected $0.05 from pot
*** SUMMARY ***
Total pot $0.05 | Rake $0 
Seat 1: scorpka (small blind) folded before Flop
Seat 2: TUSS_XXX (big blind) folded before Flop
Seat 3: UnRRRReal collected ($0.05)
Seat 4: Fran_Emm folded before Flop (didn't bet)
Seat 5: wensihan folded before Flop (didn't bet)
Seat 6: lawlex_2 (button) folded before Flop (didn't bet)



PokerStars Hand #213054962427:  Hold'em No Limit ($0.01/$0.02 USD) - 2020/05/01 13:17:00 MSK [2020/05/01 6:17:00 ET]
Table 'Okavango III' 6-max Seat #1 is the button
Seat 1: scorpka ($1.97 in chips) 
Seat 2: TUSS_XXX ($1.46 in chips) 
Seat 3: UnRRRReal ($2.02 in chips) 
Seat 4: Fran_Emm ($2.06 in chips) 
Seat 5: wensihan ($2.69 in chips) 
Seat 6: lawlex_2 ($2.64 in chips) 
TUSS_XXX: posts small blind $0.01
UnRRRReal: posts big blind $0.02
*** HOLE CARDS ***
Dealt to lawlex_2 [Qs 9c]
Fran_Emm: folds 
wensihan: folds 
lawlex_2: folds 
scorpka: folds 
TUSS_XXX: calls $0.01
UnRRRReal: raises $0.04 to $0.06
TUSS_XXX: calls $0.04
*** FLOP *** [8d Td Ah]
TUSS_XXX: checks 
UnRRRReal: bets $0.06
TUSS_XXX: calls $0.06
*** TURN *** [8d Td Ah] [Ks]
TUSS_XXX: checks 
UnRRRReal: checks 
*** RIVER *** [8d Td Ah Ks] [8s]
TUSS_XXX: checks 
UnRRRReal: checks 
*** SHOW DOWN ***
TUSS_XXX: shows [3d Qd] (a pair of Eights)
UnRRRReal: shows [Qh 9h] (a pair of Eights)
TUSS_XXX collected $0.12 from pot
UnRRRReal collected $0.11 from pot
*** SUMMARY ***
Total pot $0.24 | Rake $0.01 
Board [8d Td Ah Ks 8s]
Seat 1: scorpka (button) folded before Flop (didn't bet)
Seat 2: TUSS_XXX (small blind) showed [3d Qd] and won ($0.12) with a pair of Eights
Seat 3: UnRRRReal (big blind) showed [Qh 9h] and won ($0.11) with a pair of Eights
Seat 4: Fran_Emm folded before Flop (didn't bet)
Seat 5: wensihan folded before Flop (didn't bet)
Seat 6: lawlex_2 folded before Flop (didn't bet)



PokerStars Hand #213054983467:  Hold'em No Limit ($0.01/$0.02 USD) - 2020/05/01 13:17:37 MSK [2020/05/01 6:17:37 ET]
Table 'Okavango III' 6-max Seat #2 is the button
Seat 1: scorpka ($1.97 in chips) 
Seat 2: TUSS_XXX ($1.46 in chips) 
Seat 3: UnRRRReal ($2.01 in chips) 
Seat 4: Fran_Emm ($2.06 in chips) 
Seat 5: wensihan ($2.69 in chips) 
Seat 6: lawlex_2 ($2.64 in chips) 
UnRRRReal: posts small blind $0.01
Fran_Emm: posts big blind $0.02
*** HOLE CARDS ***
Dealt to lawlex_2 [7s 2s]
wensihan: folds 
lawlex_2: folds 
scorpka: folds 
TUSS_XXX: raises $0.02 to $0.04
UnRRRReal: calls $0.03
Fran_Emm: folds 
*** FLOP *** [7d 7c Kh]
UnRRRReal: checks 
TUSS_XXX: bets $0.07
UnRRRReal: folds 
Uncalled bet ($0.07) returned to TUSS_XXX
TUSS_XXX collected $0.10 from pot
TUSS_XXX: doesn't show hand 
*** SUMMARY ***
Total pot $0.10 | Rake $0 
Board [7d 7c Kh]
Seat 1: scorpka folded before Flop (didn't bet)
Seat 2: TUSS_XXX (button) collected ($0.10)
Seat 3: UnRRRReal (small blind) folded on the Flop
Seat 4: Fran_Emm (big blind) folded before Flop
Seat 5: wensihan folded before Flop (didn't bet)
Seat 6: lawlex_2 folded before Flop (didn't bet)



PokerStars Hand #213054996328:  Hold'em No Limit ($0.01/$0.02 USD) - 2020/05/01 13:18:00 MSK [2020/05/01 6:18:00 ET]
Table 'Okavango III' 6-max Seat #3 is the button
Seat 1: scorpka ($1.97 in chips) 
Seat 2: TUSS_XXX ($1.52 in chips) 
Seat 3: UnRRRReal ($1.97 in chips) 
Seat 4: Fran_Emm ($2.04 in chips) 
Seat 5: wensihan ($2.69 in chips) 
Seat 6: lawlex_2 ($2.64 in chips) 
Fran_Emm: posts small blind $0.01
wensihan: posts big blind $0.02
*** HOLE CARDS ***
Dealt to lawlex_2 [8s As]
lawlex_2: raises $0.04 to $0.06
scorpka: calls $0.06
TUSS_XXX: folds 
UnRRRReal: folds 
Fran_Emm: calls $0.05
wensihan: calls $0.04
*** FLOP *** [5c 4h Th]
Fran_Emm: checks 
wensihan: bets $0.16
lawlex_2: folds 
scorpka: folds 
Fran_Emm: folds 
Uncalled bet ($0.16) returned to wensihan
wensihan collected $0.23 from pot
wensihan: doesn't show hand 
*** SUMMARY ***
Total pot $0.24 | Rake $0.01 
Board [5c 4h Th]
Seat 1: scorpka folded on the Flop
Seat 2: TUSS_XXX folded before Flop (didn't bet)
Seat 3: UnRRRReal (button) folded before Flop (didn't bet)
Seat 4: Fran_Emm (small blind) folded on the Flop
Seat 5: wensihan (big blind) collected ($0.23)
Seat 6: lawlex_2 folded on the Flop



PokerStars Hand #213055014311:  Hold'em No Limit ($0.01/$0.02 USD) - 2020/05/01 13:18:32 MSK [2020/05/01 6:18:32 ET]
Table 'Okavango III' 6-max Seat #4 is the button
Seat 1: scorpka ($2 in chips) 
Seat 2: TUSS_XXX ($1.52 in chips) 
Seat 3: UnRRRReal ($1.97 in chips) 
Seat 4: Fran_Emm ($2 in chips) 
Seat 5: wensihan ($2.86 in chips) 
Seat 6: lawlex_2 ($2.58 in chips) 
wensihan: posts small blind $0.01
lawlex_2: posts big blind $0.02
*** HOLE CARDS ***
Dealt to lawlex_2 [Th Ad]
scorpka: raises $0.04 to $0.06
TUSS_XXX: folds 
UnRRRReal: folds 
Fran_Emm: folds 
wensihan: folds 
lawlex_2: calls $0.04
*** FLOP *** [3s 3h 7c]
wensihan leaves the table
lawlex_2: checks 
scorpka: bets $0.08
lawlex_2: folds 
Uncalled bet ($0.08) returned to scorpka
scorpka collected $0.13 from pot
scorpka: doesn't show hand 
*** SUMMARY ***
Total pot $0.13 | Rake $0 
Board [3s 3h 7c]
Seat 1: scorpka collected ($0.13)
Seat 2: TUSS_XXX folded before Flop (didn't bet)
Seat 3: UnRRRReal folded before Flop (didn't bet)
Seat 4: Fran_Emm (button) folded before Flop (didn't bet)
Seat 5: wensihan (small blind) folded before Flop
Seat 6: lawlex_2 (big blind) folded on the Flop



PokerStars Hand #213055027950:  Hold'em No Limit ($0.01/$0.02 USD) - 2020/05/01 13:18:56 MSK [2020/05/01 6:18:56 ET]
Table 'Okavango III' 6-max Seat #6 is the button
Seat 1: scorpka ($2.07 in chips) 
Seat 2: TUSS_XXX ($1.52 in chips) 
Seat 3: UnRRRReal ($1.97 in chips) 
Seat 4: Fran_Emm ($2 in chips) 
Seat 6: lawlex_2 ($2.52 in chips) 
SBUR999 joins the table at seat #5 
scorpka: posts small blind $0.01
TUSS_XXX: posts big blind $0.02
*** HOLE CARDS ***
Dealt to lawlex_2 [Jc Js]
UnRRRReal: folds 
Fran_Emm: folds 
lawlex_2: calls $0.02
scorpka: folds 
TUSS_XXX: checks 
*** FLOP *** [Kh 6s 2h]
TUSS_XXX: checks 
lawlex_2: bets $0.03
TUSS_XXX: calls $0.03
*** TURN *** [Kh 6s 2h] [Ks]
UnRRRReal leaves the table
TUSS_XXX: checks 
lawlex_2: bets $0.07
TUSS_XXX: calls $0.07
*** RIVER *** [Kh 6s 2h Ks] [3h]
TUSS_XXX: checks 
lawlex_2: bets $0.16
TUSS_XXX: calls $0.16
*** SHOW DOWN ***
lawlex_2: shows [Jc Js] (two pair, Kings and Jacks)
TUSS_XXX: mucks hand 
lawlex_2 collected $0.55 from pot
*** SUMMARY ***
Total pot $0.57 | Rake $0.02 
Board [Kh 6s 2h Ks 3h]
Seat 1: scorpka (small blind) folded before Flop
Seat 2: TUSS_XXX (big blind) mucked [5d 6c]
Seat 3: UnRRRReal folded before Flop (didn't bet)
Seat 4: Fran_Emm folded before Flop (didn't bet)
Seat 6: lawlex_2 (button) showed [Jc Js] and won ($0.55) with two pair, Kings and Jacks



PokerStars Hand #213055054183:  Hold'em No Limit ($0.01/$0.02 USD) - 2020/05/01 13:19:42 MSK [2020/05/01 6:19:42 ET]
Table 'Okavango III' 6-max Seat #1 is the button
Seat 1: scorpka ($2.06 in chips) 
Seat 2: TUSS_XXX ($1.24 in chips) 
Seat 4: Fran_Emm ($2 in chips) 
Seat 5: SBUR999 ($0.80 in chips) 
Seat 6: lawlex_2 ($2.79 in chips) 
TUSS_XXX: posts small blind $0.01
Fran_Emm: posts big blind $0.02
SBUR999: posts big blind $0.02
*** HOLE CARDS ***
Dealt to lawlex_2 [9c 6h]
SBUR999: checks 
lawlex_2: folds 
scorpka: folds 
TUSS_XXX: calls $0.01
Fran_Emm: checks 
*** FLOP *** [9d Jd 4d]
TUSS_XXX: checks 
Fran_Emm: checks 
SBUR999: checks 
*** TURN *** [9d Jd 4d] [3h]
TUSS_XXX: checks 
Fran_Emm: checks 
SBUR999: checks 
*** RIVER *** [9d Jd 4d 3h] [Tc]
TUSS_XXX: checks 
Fran_Emm: checks 
SBUR999: checks 
*** SHOW DOWN ***
TUSS_XXX: shows [5h 5s] (a pair of Fives)
Fran_Emm: mucks hand 
SBUR999: mucks hand 
TUSS_XXX collected $0.06 from pot
*** SUMMARY ***
Total pot $0.06 | Rake $0 
Board [9d Jd 4d 3h Tc]
Seat 1: scorpka (button) folded before Flop (didn't bet)
Seat 2: TUSS_XXX (small blind) showed [5h 5s] and won ($0.06) with a pair of Fives
Seat 4: Fran_Emm (big blind) mucked [4h Qs]
Seat 5: SBUR999 mucked [Ac Qd]
Seat 6: lawlex_2 folded before Flop (didn't bet)



PokerStars Hand #213055072858:  Hold'em No Limit ($0.01/$0.02 USD) - 2020/05/01 13:20:15 MSK [2020/05/01 6:20:15 ET]
Table 'Okavango III' 6-max Seat #2 is the button
Seat 1: scorpka ($2.06 in chips) 
Seat 2: TUSS_XXX ($1.28 in chips) 
Seat 4: Fran_Emm ($2 in chips) 
Seat 5: SBUR999 ($0.78 in chips) 
Seat 6: lawlex_2 ($2.79 in chips) 
Fran_Emm: posts small blind $0.01
SBUR999: posts big blind $0.02
*** HOLE CARDS ***
Dealt to lawlex_2 [6h 3s]
lawlex_2: folds 
scorpka: folds 
TUSS_XXX: raises $0.02 to $0.04
V1smut joins the table at seat #3 
Fran_Emm: folds 
SBUR999: folds 
Uncalled bet ($0.02) returned to TUSS_XXX
TUSS_XXX collected $0.05 from pot
TUSS_XXX: doesn't show hand 
*** SUMMARY ***
Total pot $0.05 | Rake $0 
Seat 1: scorpka folded before Flop (didn't bet)
Seat 2: TUSS_XXX (button) collected ($0.05)
Seat 4: Fran_Emm (small blind) folded before Flop
Seat 5: SBUR999 (big blind) folded before Flop
Seat 6: lawlex_2 folded before Flop (didn't bet)



PokerStars Hand #213055079285:  Hold'em No Limit ($0.01/$0.02 USD) - 2020/05/01 13:20:27 MSK [2020/05/01 6:20:27 ET]
Table 'Okavango III' 6-max Seat #4 is the button
Seat 1: scorpka ($2.06 in chips) 
Seat 2: TUSS_XXX ($1.31 in chips) 
Seat 4: Fran_Emm ($2 in chips) 
Seat 5: SBUR999 ($0.76 in chips) 
Seat 6: lawlex_2 ($2.79 in chips) 
SBUR999: posts small blind $0.01
lawlex_2: posts big blind $0.02
V1smut: sits out 
*** HOLE CARDS ***
Dealt to lawlex_2 [6d 9h]
scorpka: folds 
TUSS_XXX: folds 
Fran_Emm: raises $0.03 to $0.05
SBUR999: calls $0.04
lawlex_2: folds 
*** FLOP *** [8h Qc Jd]
SBUR999: bets $0.06
Fran_Emm: raises $0.12 to $0.18
SBUR999: calls $0.12
*** TURN *** [8h Qc Jd] [9d]
SBUR999: checks 
Fran_Emm: bets $0.23
SBUR999: raises $0.30 to $0.53 and is all-in
Fran_Emm: calls $0.30
*** RIVER *** [8h Qc Jd 9d] [9s]
*** SHOW DOWN ***
SBUR999: shows [Jc Kc] (two pair, Jacks and Nines)
Fran_Emm: shows [Qh Qs] (a full house, Queens full of Nines)
Fran_Emm collected $1.49 from pot
*** SUMMARY ***
Total pot $1.54 | Rake $0.05 
Board [8h Qc Jd 9d 9s]
Seat 1: scorpka folded before Flop (didn't bet)
Seat 2: TUSS_XXX folded before Flop (didn't bet)
Seat 4: Fran_Emm (button) showed [Qh Qs] and won ($1.49) with a full house, Queens full of Nines
Seat 5: SBUR999 (small blind) showed [Jc Kc] and lost with two pair, Jacks and Nines
Seat 6: lawlex_2 (big blind) folded before Flop



PokerStars Hand #213055114418:  Hold'em No Limit ($0.01/$0.02 USD) - 2020/05/01 13:21:28 MSK [2020/05/01 6:21:28 ET]
Table 'Okavango III' 6-max Seat #6 is the button
Seat 1: scorpka ($2.06 in chips) 
Seat 2: TUSS_XXX ($1.31 in chips) 
Seat 4: Fran_Emm ($2.73 in chips) 
Seat 6: lawlex_2 ($2.77 in chips) 
scorpka: posts small blind $0.01
TUSS_XXX: posts big blind $0.02
V1smut: sits out 
*** HOLE CARDS ***
Dealt to lawlex_2 [2d 2h]
Fran_Emm: raises $0.04 to $0.06
lawlex_2: calls $0.06
scorpka: folds 
TUSS_XXX: folds 
*** FLOP *** [4d 4c Ks]
Fran_Emm: checks 
lawlex_2: bets $0.09
Fran_Emm: calls $0.09
*** TURN *** [4d 4c Ks] [As]
Fran_Emm: checks 
lawlex_2: bets $0.21
Fran_Emm: folds 
Uncalled bet ($0.21) returned to lawlex_2
lawlex_2 collected $0.32 from pot
lawlex_2: doesn't show hand 
*** SUMMARY ***
Total pot $0.33 | Rake $0.01 
Board [4d 4c Ks As]
Seat 1: scorpka (small blind) folded before Flop
Seat 2: TUSS_XXX (big blind) folded before Flop
Seat 4: Fran_Emm folded on the Turn
Seat 6: lawlex_2 (button) collected ($0.32)



PokerStars Hand #213055131931:  Hold'em No Limit ($0.01/$0.02 USD) - 2020/05/01 13:21:59 MSK [2020/05/01 6:21:59 ET]
Table 'Okavango III' 6-max Seat #1 is the button
Seat 1: scorpka ($2.05 in chips) 
Seat 2: TUSS_XXX ($1.29 in chips) 
Seat 3: V1smut ($2 in chips) 
Seat 4: Fran_Emm ($2.58 in chips) 
Seat 5: SBUR999 ($1 in chips) 
Seat 6: lawlex_2 ($2.94 in chips) 
TUSS_XXX: posts small blind $0.01
V1smut: posts big blind $0.02
*** HOLE CARDS ***
Dealt to lawlex_2 [8d Js]
Fran_Emm: folds 
SBUR999: folds 
lawlex_2: folds 
scorpka: folds 
TUSS_XXX: calls $0.01
V1smut: checks 
*** FLOP *** [5c 2h Ac]
TUSS_XXX: checks 
V1smut: checks 
*** TURN *** [5c 2h Ac] [7c]
TUSS_XXX: checks 
V1smut: checks 
*** RIVER *** [5c 2h Ac 7c] [Ts]
TUSS_XXX: bets $0.03
V1smut: folds 
Uncalled bet ($0.03) returned to TUSS_XXX
TUSS_XXX collected $0.04 from pot
TUSS_XXX: doesn't show hand 
*** SUMMARY ***
Total pot $0.04 | Rake $0 
Board [5c 2h Ac 7c Ts]
Seat 1: scorpka (button) folded before Flop (didn't bet)
Seat 2: TUSS_XXX (small blind) collected ($0.04)
Seat 3: V1smut (big blind) folded on the River
Seat 4: Fran_Emm folded before Flop (didn't bet)
Seat 5: SBUR999 folded before Flop (didn't bet)
Seat 6: lawlex_2 folded before Flop (didn't bet)



PokerStars Hand #213055151515:  Hold'em No Limit ($0.01/$0.02 USD) - 2020/05/01 13:22:34 MSK [2020/05/01 6:22:34 ET]
Table 'Okavango III' 6-max Seat #2 is the button
Seat 1: scorpka ($2.05 in chips) 
Seat 2: TUSS_XXX ($1.31 in chips) 
Seat 3: V1smut ($2 in chips) 
Seat 4: Fran_Emm ($2.58 in chips) 
Seat 5: SBUR999 ($1 in chips) 
Seat 6: lawlex_2 ($2.94 in chips) 
V1smut: posts small blind $0.01
Fran_Emm: posts big blind $0.02
*** HOLE CARDS ***
Dealt to lawlex_2 [Td 7s]
SBUR999: calls $0.02
lawlex_2: folds 
scorpka: folds 
TUSS_XXX: folds 
V1smut: folds 
Fran_Emm: checks 
*** FLOP *** [Ts 5d 3h]
Fran_Emm: checks 
SBUR999: checks 
*** TURN *** [Ts 5d 3h] [Jh]
Fran_Emm: checks 
SBUR999: checks 
*** RIVER *** [Ts 5d 3h Jh] [8c]
Fran_Emm: checks 
SBUR999: checks 
*** SHOW DOWN ***
Fran_Emm: shows [5s 2s] (a pair of Fives)
SBUR999: mucks hand 
Fran_Emm collected $0.05 from pot
*** SUMMARY ***
Total pot $0.05 | Rake $0 
Board [Ts 5d 3h Jh 8c]
Seat 1: scorpka folded before Flop (didn't bet)
Seat 2: TUSS_XXX (button) folded before Flop (didn't bet)
Seat 3: V1smut (small blind) folded before Flop
Seat 4: Fran_Emm (big blind) showed [5s 2s] and won ($0.05) with a pair of Fives
Seat 5: SBUR999 mucked [7c 6c]
Seat 6: lawlex_2 folded before Flop (didn't bet)



PokerStars Hand #213055174473:  Hold'em No Limit ($0.01/$0.02 USD) - 2020/05/01 13:23:14 MSK [2020/05/01 6:23:14 ET]
Table 'Okavango III' 6-max Seat #3 is the button
Seat 1: scorpka ($2.05 in chips) 
Seat 2: TUSS_XXX ($1.31 in chips) 
Seat 3: V1smut ($2 in chips) 
Seat 4: Fran_Emm ($2.61 in chips) 
Seat 5: SBUR999 ($0.98 in chips) 
Seat 6: lawlex_2 ($2.94 in chips) 
Fran_Emm: posts small blind $0.01
SBUR999: posts big blind $0.02
*** HOLE CARDS ***
Dealt to lawlex_2 [3h 6h]
lawlex_2: folds 
scorpka: folds 
TUSS_XXX: folds 
V1smut: folds 
Fran_Emm: raises $0.04 to $0.06
SBUR999: calls $0.04
*** FLOP *** [5h 8c 6d]
Fran_Emm: bets $0.06
SBUR999: folds 
Uncalled bet ($0.06) returned to Fran_Emm
Fran_Emm collected $0.12 from pot
*** SUMMARY ***
Total pot $0.12 | Rake $0 
Board [5h 8c 6d]
Seat 1: scorpka folded before Flop (didn't bet)
Seat 2: TUSS_XXX folded before Flop (didn't bet)
Seat 3: V1smut (button) folded before Flop (didn't bet)
Seat 4: Fran_Emm (small blind) collected ($0.12)
Seat 5: SBUR999 (big blind) folded on the Flop
Seat 6: lawlex_2 folded before Flop (didn't bet)



PokerStars Hand #213055194581:  Hold'em No Limit ($0.01/$0.02 USD) - 2020/05/01 13:23:49 MSK [2020/05/01 6:23:49 ET]
Table 'Okavango III' 6-max Seat #4 is the button
Seat 1: scorpka ($2.05 in chips) 
Seat 2: TUSS_XXX ($1.31 in chips) 
Seat 3: V1smut ($2 in chips) 
Seat 4: Fran_Emm ($2.67 in chips) 
Seat 5: SBUR999 ($0.92 in chips) 
Seat 6: lawlex_2 ($2.94 in chips) 
SBUR999: posts small blind $0.01
lawlex_2: posts big blind $0.02
*** HOLE CARDS ***
Dealt to lawlex_2 [As 6d]
scorpka: folds 
TUSS_XXX: folds 
V1smut: folds 
Fran_Emm: folds 
SBUR999: calls $0.01
lawlex_2: raises $0.04 to $0.06
SBUR999: calls $0.04
*** FLOP *** [6s Kh Qs]
SBUR999: checks 
lawlex_2: bets $0.08
SBUR999: calls $0.08
*** TURN *** [6s Kh Qs] [6c]
SBUR999: checks 
lawlex_2: checks 
*** RIVER *** [6s Kh Qs 6c] [Ts]
SBUR999: bets $0.14
lawlex_2: raises $0.14 to $0.28
SBUR999: calls $0.14
*** SHOW DOWN ***
lawlex_2: shows [As 6d] (three of a kind, Sixes)
SBUR999: shows [Jc Ah] (a straight, Ten to Ace)
SBUR999 collected $0.81 from pot
*** SUMMARY ***
Total pot $0.84 | Rake $0.03 
Board [6s Kh Qs 6c Ts]
Seat 1: scorpka folded before Flop (didn't bet)
Seat 2: TUSS_XXX folded before Flop (didn't bet)
Seat 3: V1smut folded before Flop (didn't bet)
Seat 4: Fran_Emm (button) folded before Flop (didn't bet)
Seat 5: SBUR999 (small blind) showed [Jc Ah] and won ($0.81) with a straight, Ten to Ace
Seat 6: lawlex_2 (big blind) showed [As 6d] and lost with three of a kind, Sixes



PokerStars Hand #213055227065:  Hold'em No Limit ($0.01/$0.02 USD) - 2020/05/01 13:24:46 MSK [2020/05/01 6:24:46 ET]
Table 'Okavango III' 6-max Seat #5 is the button
Seat 1: scorpka ($2.05 in chips) 
Seat 2: TUSS_XXX ($1.31 in chips) 
Seat 3: V1smut ($2 in chips) 
Seat 4: Fran_Emm ($2.67 in chips) 
Seat 5: SBUR999 ($1.31 in chips) 
Seat 6: lawlex_2 ($2.52 in chips) 
lawlex_2: posts small blind $0.01
scorpka: posts big blind $0.02
*** HOLE CARDS ***
Dealt to lawlex_2 [Th Qs]
TUSS_XXX: raises $0.04 to $0.06
V1smut: folds 
Fran_Emm: folds 
SBUR999: folds 
lawlex_2: calls $0.05
scorpka: folds 
*** FLOP *** [3d Js Kd]
lawlex_2: bets $0.09
TUSS_XXX: folds 
Uncalled bet ($0.09) returned to lawlex_2
lawlex_2 collected $0.14 from pot
lawlex_2: doesn't show hand 
*** SUMMARY ***
Total pot $0.14 | Rake $0 
Board [3d Js Kd]
Seat 1: scorpka (big blind) folded before Flop
Seat 2: TUSS_XXX folded on the Flop
Seat 3: V1smut folded before Flop (didn't bet)
Seat 4: Fran_Emm folded before Flop (didn't bet)
Seat 5: SBUR999 (button) folded before Flop (didn't bet)
Seat 6: lawlex_2 (small blind) collected ($0.14)



PokerStars Hand #213055240857:  Hold'em No Limit ($0.01/$0.02 USD) - 2020/05/01 13:25:11 MSK [2020/05/01 6:25:11 ET]
Table 'Okavango III' 6-max Seat #6 is the button
Seat 1: scorpka ($2.03 in chips) 
Seat 3: V1smut ($2 in chips) 
Seat 4: Fran_Emm ($2.67 in chips) 
Seat 5: SBUR999 ($1.31 in chips) 
Seat 6: lawlex_2 ($2.60 in chips) 
scorpka: posts small blind $0.01
TUSS_XXX: is sitting out 
V1smut: posts big blind $0.02
*** HOLE CARDS ***
Dealt to lawlex_2 [Qc 3d]
Fran_Emm: folds 
SBUR999: raises $0.04 to $0.06
lawlex_2: folds 
TUSS_XXX leaves the table
777buro777 joins the table at seat #2 
scorpka is disconnected 
scorpka has timed out while disconnected
scorpka: folds 
V1smut: folds 
Uncalled bet ($0.04) returned to SBUR999
SBUR999 collected $0.05 from pot
SBUR999: doesn't show hand 
*** SUMMARY ***
Total pot $0.05 | Rake $0 
Seat 1: scorpka (small blind) folded before Flop
Seat 3: V1smut (big blind) folded before Flop
Seat 4: Fran_Emm folded before Flop (didn't bet)
Seat 5: SBUR999 collected ($0.05)
Seat 6: lawlex_2 (button) folded before Flop (didn't bet)



PokerStars Hand #213055273426:  Hold'em No Limit ($0.01/$0.02 USD) - 2020/05/01 13:26:08 MSK [2020/05/01 6:26:08 ET]
Table 'Okavango III' 6-max Seat #3 is the button
Seat 2: 777buro777 ($0.80 in chips) 
Seat 3: V1smut ($2 in chips) 
Seat 4: Fran_Emm ($2.67 in chips) 
Seat 5: SBUR999 ($1.34 in chips) 
Seat 6: lawlex_2 ($2.60 in chips) 
Fran_Emm: posts small blind $0.01
SBUR999: posts big blind $0.02
777buro777: posts big blind $0.02
*** HOLE CARDS ***
Dealt to lawlex_2 [4h Jc]
lawlex_2: folds 
777buro777: checks 
V1smut: folds 
Fran_Emm: folds 
SBUR999: checks 
*** FLOP *** [5d 3c 5c]
SBUR999: checks 
777buro777: checks 
*** TURN *** [5d 3c 5c] [4s]
SBUR999: bets $0.04
777buro777: raises $0.04 to $0.08
SBUR999: calls $0.04
*** RIVER *** [5d 3c 5c 4s] [As]
SBUR999: checks 
777buro777: bets $0.70 and is all-in
SBUR999: calls $0.70
*** SHOW DOWN ***
777buro777: shows [3h 2c] (a straight, Ace to Five)
SBUR999: shows [6c 2d] (a straight, Deuce to Six)
SBUR999 collected $1.55 from pot
*** SUMMARY ***
Total pot $1.61 | Rake $0.06 
Board [5d 3c 5c 4s As]
Seat 2: 777buro777 showed [3h 2c] and lost with a straight, Ace to Five
Seat 3: V1smut (button) folded before Flop (didn't bet)
Seat 4: Fran_Emm (small blind) folded before Flop
Seat 5: SBUR999 (big blind) showed [6c 2d] and won ($1.55) with a straight, Deuce to Six
Seat 6: lawlex_2 folded before Flop (didn't bet)



PokerStars Hand #213055305398:  Hold'em No Limit ($0.01/$0.02 USD) - 2020/05/01 13:27:04 MSK [2020/05/01 6:27:04 ET]
Table 'Okavango III' 6-max Seat #4 is the button
Seat 3: V1smut ($2 in chips) 
Seat 4: Fran_Emm ($2.66 in chips) 
Seat 5: SBUR999 ($2.09 in chips) 
Seat 6: lawlex_2 ($2.60 in chips) 
SBUR999: posts small blind $0.01
lawlex_2: posts big blind $0.02
*** HOLE CARDS ***
Dealt to lawlex_2 [9c 8c]
V1smut: folds 
777buro777 leaves the table
Fran_Emm: raises $0.03 to $0.05
SBUR999: folds 
lawlex_2: calls $0.03
*** FLOP *** [Td 7s 2c]
lawlex_2: bets $0.07
Fran_Emm: folds 
Uncalled bet ($0.07) returned to lawlex_2
lawlex_2 collected $0.11 from pot
lawlex_2: doesn't show hand 
*** SUMMARY ***
Total pot $0.11 | Rake $0 
Board [Td 7s 2c]
Seat 3: V1smut folded before Flop (didn't bet)
Seat 4: Fran_Emm (button) folded on the Flop
Seat 5: SBUR999 (small blind) folded before Flop
Seat 6: lawlex_2 (big blind) collected ($0.11)



PokerStars Hand #213055323606:  Hold'em No Limit ($0.01/$0.02 USD) - 2020/05/01 13:27:36 MSK [2020/05/01 6:27:36 ET]
Table 'Okavango III' 6-max Seat #5 is the button
Seat 3: V1smut ($2 in chips) 
Seat 4: Fran_Emm ($2.61 in chips) 
Seat 5: SBUR999 ($2.08 in chips) 
Seat 6: lawlex_2 ($2.66 in chips) 
lawlex_2: posts small blind $0.01
V1smut: posts big blind $0.02
*** HOLE CARDS ***
Dealt to lawlex_2 [8d 3d]
Fran_Emm: folds 
SBUR999: folds 
lawlex_2: folds 
Uncalled bet ($0.01) returned to V1smut
V1smut collected $0.02 from pot
V1smut: doesn't show hand 
*** SUMMARY ***
Total pot $0.02 | Rake $0 
Seat 3: V1smut (big blind) collected ($0.02)
Seat 4: Fran_Emm folded before Flop (didn't bet)
Seat 5: SBUR999 (button) folded before Flop (didn't bet)
Seat 6: lawlex_2 (small blind) folded before Flop



PokerStars Hand #213055327709:  Hold'em No Limit ($0.01/$0.02 USD) - 2020/05/01 13:27:44 MSK [2020/05/01 6:27:44 ET]
Table 'Okavango III' 6-max Seat #6 is the button
Seat 3: V1smut ($2.01 in chips) 
Seat 4: Fran_Emm ($2.61 in chips) 
Seat 5: SBUR999 ($2.08 in chips) 
Seat 6: lawlex_2 ($2.65 in chips) 
V1smut: posts small blind $0.01
Fran_Emm: posts big blind $0.02
*** HOLE CARDS ***
Dealt to lawlex_2 [5s 9s]
SBUR999: calls $0.02
lawlex_2: folds 
V1smut: folds 
Fran_Emm: checks 
*** FLOP *** [Ac 3d 8d]
Fran_Emm: checks 
SBUR999: checks 
*** TURN *** [Ac 3d 8d] [3h]
Fran_Emm: checks 
SBUR999: checks 
*** RIVER *** [Ac 3d 8d 3h] [5c]
Fran_Emm: checks 
SBUR999: checks 
*** SHOW DOWN ***
Fran_Emm: shows [7h Kc] (a pair of Threes)
SBUR999: mucks hand 
Fran_Emm collected $0.05 from pot
*** SUMMARY ***
Total pot $0.05 | Rake $0 
Board [Ac 3d 8d 3h 5c]
Seat 3: V1smut (small blind) folded before Flop
Seat 4: Fran_Emm (big blind) showed [7h Kc] and won ($0.05) with a pair of Threes
Seat 5: SBUR999 mucked [9c 7c]
Seat 6: lawlex_2 (button) folded before Flop (didn't bet)



PokerStars Hand #213055341258:  Hold'em No Limit ($0.01/$0.02 USD) - 2020/05/01 13:28:07 MSK [2020/05/01 6:28:07 ET]
Table 'Okavango III' 6-max Seat #3 is the button
Seat 3: V1smut ($2 in chips) 
Seat 4: Fran_Emm ($2.64 in chips) 
Seat 5: SBUR999 ($2.06 in chips) 
Seat 6: lawlex_2 ($2.65 in chips) 
Fran_Emm: posts small blind $0.01
SBUR999: posts big blind $0.02
*** HOLE CARDS ***
Dealt to lawlex_2 [2c Ts]
lawlex_2: folds 
V1smut: folds 
a7236 joins the table at seat #2 
Fran_Emm: folds 
Uncalled bet ($0.01) returned to SBUR999
SBUR999 collected $0.02 from pot
SBUR999: doesn't show hand 
*** SUMMARY ***
Total pot $0.02 | Rake $0 
Seat 3: V1smut (button) folded before Flop (didn't bet)
Seat 4: Fran_Emm (small blind) folded before Flop
Seat 5: SBUR999 (big blind) collected ($0.02)
Seat 6: lawlex_2 folded before Flop (didn't bet)



PokerStars Hand #213055353681:  Hold'em No Limit ($0.01/$0.02 USD) - 2020/05/01 13:28:29 MSK [2020/05/01 6:28:29 ET]
Table 'Okavango III' 6-max Seat #4 is the button
Seat 3: V1smut ($2 in chips) 
Seat 4: Fran_Emm ($2.63 in chips) 
Seat 5: SBUR999 ($2.07 in chips) 
Seat 6: lawlex_2 ($2.65 in chips) 
SBUR999: posts small blind $0.01
lawlex_2: posts big blind $0.02
a7236: sits out 
*** HOLE CARDS ***
Dealt to lawlex_2 [Jc 5s]
V1smut: raises $0.04 to $0.06
Fran_Emm: folds 
SBUR999: folds 
lawlex_2: folds 
Uncalled bet ($0.04) returned to V1smut
V1smut collected $0.05 from pot
V1smut: doesn't show hand 
*** SUMMARY ***
Total pot $0.05 | Rake $0 
Seat 3: V1smut collected ($0.05)
Seat 4: Fran_Emm (button) folded before Flop (didn't bet)
Seat 5: SBUR999 (small blind) folded before Flop
Seat 6: lawlex_2 (big blind) folded before Flop



PokerStars Hand #213055360614:  Hold'em No Limit ($0.01/$0.02 USD) - 2020/05/01 13:28:42 MSK [2020/05/01 6:28:42 ET]
Table 'Okavango III' 6-max Seat #5 is the button
Seat 2: a7236 ($2 in chips) 
Seat 3: V1smut ($2.03 in chips) 
Seat 4: Fran_Emm ($2.63 in chips) 
Seat 5: SBUR999 ($2.06 in chips) 
Seat 6: lawlex_2 ($2.63 in chips) 
lawlex_2: posts small blind $0.01
a7236: posts big blind $0.02
*** HOLE CARDS ***
Dealt to lawlex_2 [4d Ah]
V1smut: folds 
Fran_Emm: folds 
SBUR999: raises $0.02 to $0.04
lawlex_2: calls $0.03
a7236: folds 
*** FLOP *** [5d Kh 8s]
lawlex_2: checks 
SBUR999: checks 
*** TURN *** [5d Kh 8s] [2s]
lawlex_2: checks 
SBUR999: checks 
*** RIVER *** [5d Kh 8s 2s] [Jh]
lawlex_2: checks 
SBUR999: bets $0.02
lawlex_2: calls $0.02
*** SHOW DOWN ***
SBUR999: shows [Qs Qh] (a pair of Queens)
lawlex_2: mucks hand 
SBUR999 collected $0.14 from pot
*** SUMMARY ***
Total pot $0.14 | Rake $0 
Board [5d Kh 8s 2s Jh]
Seat 2: a7236 (big blind) folded before Flop
Seat 3: V1smut folded before Flop (didn't bet)
Seat 4: Fran_Emm folded before Flop (didn't bet)
Seat 5: SBUR999 (button) showed [Qs Qh] and won ($0.14) with a pair of Queens
Seat 6: lawlex_2 (small blind) mucked [4d Ah]



PokerStars Hand #213055381432:  Hold'em No Limit ($0.01/$0.02 USD) - 2020/05/01 13:29:18 MSK [2020/05/01 6:29:18 ET]
Table 'Okavango III' 6-max Seat #6 is the button
Seat 2: a7236 ($2 in chips) 
Seat 3: V1smut ($2.03 in chips) 
Seat 4: Fran_Emm ($2.63 in chips) 
Seat 5: SBUR999 ($2.14 in chips) 
Seat 6: lawlex_2 ($2.57 in chips) 
a7236: posts small blind $0.01
V1smut: posts big blind $0.02
*** HOLE CARDS ***
Dealt to lawlex_2 [7d 4h]
Fran_Emm: folds 
SBUR999: calls $0.02
lawlex_2: folds 
a7236: folds 
V1smut: checks 
*** FLOP *** [4c Ad 3d]
V1smut: checks 
SBUR999: checks 
*** TURN *** [4c Ad 3d] [7s]
V1smut: checks 
SBUR999: checks 
*** RIVER *** [4c Ad 3d 7s] [2s]
V1smut: checks 
SBUR999: checks 
*** SHOW DOWN ***
V1smut: shows [2d Tc] (a pair of Deuces)
SBUR999: mucks hand 
V1smut collected $0.05 from pot
*** SUMMARY ***
Total pot $0.05 | Rake $0 
Board [4c Ad 3d 7s 2s]
Seat 2: a7236 (small blind) folded before Flop
Seat 3: V1smut (big blind) showed [2d Tc] and won ($0.05) with a pair of Deuces
Seat 4: Fran_Emm folded before Flop (didn't bet)
Seat 5: SBUR999 mucked [Jc 9c]
Seat 6: lawlex_2 (button) folded before Flop (didn't bet)



PokerStars Hand #213055401069:  Hold'em No Limit ($0.01/$0.02 USD) - 2020/05/01 13:29:53 MSK [2020/05/01 6:29:53 ET]
Table 'Okavango III' 6-max Seat #2 is the button
Seat 2: a7236 ($2 in chips) 
Seat 3: V1smut ($2.06 in chips) 
Seat 4: Fran_Emm ($2.63 in chips) 
Seat 5: SBUR999 ($2.12 in chips) 
Seat 6: lawlex_2 ($2.57 in chips) 
V1smut: posts small blind $0.01
Fran_Emm: posts big blind $0.02
*** HOLE CARDS ***
Dealt to lawlex_2 [Jh 2d]
SBUR999: folds 
lawlex_2: folds 
a7236: folds 
V1smut: raises $0.04 to $0.06
Fran_Emm: calls $0.04
*** FLOP *** [9d Kh Td]
V1smut: bets $0.08
Fran_Emm: calls $0.08
*** TURN *** [9d Kh Td] [6s]
V1smut: checks 
Fran_Emm: bets $0.14
V1smut: folds 
Uncalled bet ($0.14) returned to Fran_Emm
Fran_Emm collected $0.27 from pot
*** SUMMARY ***
Total pot $0.28 | Rake $0.01 
Board [9d Kh Td 6s]
Seat 2: a7236 (button) folded before Flop (didn't bet)
Seat 3: V1smut (small blind) folded on the Turn
Seat 4: Fran_Emm (big blind) collected ($0.27)
Seat 5: SBUR999 folded before Flop (didn't bet)
Seat 6: lawlex_2 folded before Flop (didn't bet)



PokerStars Hand #213055424870:  Hold'em No Limit ($0.01/$0.02 USD) - 2020/05/01 13:30:34 MSK [2020/05/01 6:30:34 ET]
Table 'Okavango III' 6-max Seat #3 is the button
Seat 2: a7236 ($2 in chips) 
Seat 3: V1smut ($2 in chips) 
Seat 4: Fran_Emm ($2.76 in chips) 
Seat 5: SBUR999 ($2.12 in chips) 
Seat 6: lawlex_2 ($2.57 in chips) 
Fran_Emm: posts small blind $0.01
SBUR999: posts big blind $0.02
*** HOLE CARDS ***
Dealt to lawlex_2 [Tc Qc]
lawlex_2: raises $0.04 to $0.06
a7236: folds 
V1smut: folds 
Fran_Emm: calls $0.05
SBUR999: folds 
*** FLOP *** [5c 9c 6h]
Fran_Emm: checks 
lawlex_2: bets $0.09
Fran_Emm: calls $0.09
*** TURN *** [5c 9c 6h] [Jd]
Fran_Emm: checks 
lawlex_2: bets $0.21
Fran_Emm: folds 
Uncalled bet ($0.21) returned to lawlex_2
lawlex_2 collected $0.31 from pot
lawlex_2: doesn't show hand 
*** SUMMARY ***
Total pot $0.32 | Rake $0.01 
Board [5c 9c 6h Jd]
Seat 2: a7236 folded before Flop (didn't bet)
Seat 3: V1smut (button) folded before Flop (didn't bet)
Seat 4: Fran_Emm (small blind) folded on the Turn
Seat 5: SBUR999 (big blind) folded before Flop
Seat 6: lawlex_2 collected ($0.31)



PokerStars Hand #213055441631:  Hold'em No Limit ($0.01/$0.02 USD) - 2020/05/01 13:31:04 MSK [2020/05/01 6:31:04 ET]
Table 'Okavango III' 6-max Seat #4 is the button
Seat 2: a7236 ($2 in chips) 
Seat 3: V1smut ($2 in chips) 
Seat 4: Fran_Emm ($2.61 in chips) 
Seat 5: SBUR999 ($2.10 in chips) 
Seat 6: lawlex_2 ($2.73 in chips) 
SBUR999: posts small blind $0.01
lawlex_2: posts big blind $0.02
*** HOLE CARDS ***
Dealt to lawlex_2 [Ah 9c]
a7236: folds 
V1smut: folds 
Fran_Emm: folds 
SBUR999: calls $0.01
lawlex_2: raises $0.04 to $0.06
SBUR999: calls $0.04
*** FLOP *** [3h 3c 6c]
SBUR999: checks 
lawlex_2: checks 
*** TURN *** [3h 3c 6c] [Js]
SBUR999: checks 
lawlex_2: checks 
*** RIVER *** [3h 3c 6c Js] [Tc]
SBUR999: checks 
lawlex_2: bets $0.08
SBUR999: folds 
Uncalled bet ($0.08) returned to lawlex_2
lawlex_2 collected $0.12 from pot
lawlex_2: doesn't show hand 
*** SUMMARY ***
Total pot $0.12 | Rake $0 
Board [3h 3c 6c Js Tc]
Seat 2: a7236 folded before Flop (didn't bet)
Seat 3: V1smut folded before Flop (didn't bet)
Seat 4: Fran_Emm (button) folded before Flop (didn't bet)
Seat 5: SBUR999 (small blind) folded on the River
Seat 6: lawlex_2 (big blind) collected ($0.12)



PokerStars Hand #213055484462:  Hold'em No Limit ($0.01/$0.02 USD) - 2020/05/01 13:32:19 MSK [2020/05/01 6:32:19 ET]
Table 'Okavango III' 6-max Seat #5 is the button
Seat 2: a7236 ($2 in chips) 
Seat 3: V1smut ($2 in chips) 
Seat 4: Fran_Emm ($2.61 in chips) 
Seat 5: SBUR999 ($2.04 in chips) 
Seat 6: lawlex_2 ($2.79 in chips) 
lawlex_2: posts small blind $0.01
a7236: posts big blind $0.02
*** HOLE CARDS ***
Dealt to lawlex_2 [9c 5h]
V1smut: folds 
Fran_Emm: folds 
SBUR999: calls $0.02
lawlex_2: folds 
a7236: checks 
*** FLOP *** [7d Kd 8c]
a7236: checks 
SBUR999: bets $0.02
a7236: folds 
Uncalled bet ($0.02) returned to SBUR999
SBUR999 collected $0.05 from pot
SBUR999: doesn't show hand 
*** SUMMARY ***
Total pot $0.05 | Rake $0 
Board [7d Kd 8c]
Seat 2: a7236 (big blind) folded on the Flop
Seat 3: V1smut folded before Flop (didn't bet)
Seat 4: Fran_Emm folded before Flop (didn't bet)
Seat 5: SBUR999 (button) collected ($0.05)
Seat 6: lawlex_2 (small blind) folded before Flop



PokerStars Hand #213055503430:  Hold'em No Limit ($0.01/$0.02 USD) - 2020/05/01 13:32:52 MSK [2020/05/01 6:32:52 ET]
Table 'Okavango III' 6-max Seat #6 is the button
Seat 2: a7236 ($2 in chips) 
Seat 3: V1smut ($2 in chips) 
Seat 4: Fran_Emm ($2.61 in chips) 
Seat 5: SBUR999 ($2.07 in chips) 
Seat 6: lawlex_2 ($2.78 in chips) 
a7236: posts small blind $0.01
V1smut: posts big blind $0.02
*** HOLE CARDS ***
Dealt to lawlex_2 [7c 7h]
Fran_Emm: raises $0.04 to $0.06
SBUR999: folds 
lawlex_2: calls $0.06
a7236: folds 
V1smut: folds 
*** FLOP *** [Ks 8h Td]
Fran_Emm: checks 
lawlex_2: checks 
*** TURN *** [Ks 8h Td] [6d]
Fran_Emm: checks 
lawlex_2: checks 
*** RIVER *** [Ks 8h Td 6d] [8c]
Fran_Emm: checks 
lawlex_2: checks 
*** SHOW DOWN ***
Fran_Emm: shows [Ah 9d] (a pair of Eights)
lawlex_2: shows [7c 7h] (two pair, Eights and Sevens)
lawlex_2 collected $0.14 from pot
*** SUMMARY ***
Total pot $0.15 | Rake $0.01 
Board [Ks 8h Td 6d 8c]
Seat 2: a7236 (small blind) folded before Flop
Seat 3: V1smut (big blind) folded before Flop
Seat 4: Fran_Emm showed [Ah 9d] and lost with a pair of Eights
Seat 5: SBUR999 folded before Flop (didn't bet)
Seat 6: lawlex_2 (button) showed [7c 7h] and won ($0.14) with two pair, Eights and Sevens



PokerStars Hand #213055534165:  Hold'em No Limit ($0.01/$0.02 USD) - 2020/05/01 13:33:47 MSK [2020/05/01 6:33:47 ET]
Table 'Okavango III' 6-max Seat #2 is the button
Seat 2: a7236 ($2 in chips) 
Seat 3: V1smut ($2 in chips) 
Seat 4: Fran_Emm ($2.55 in chips) 
Seat 5: SBUR999 ($2.07 in chips) 
Seat 6: lawlex_2 ($2.86 in chips) 
V1smut: posts small blind $0.01
Fran_Emm: posts big blind $0.02
*** HOLE CARDS ***
Dealt to lawlex_2 [Jd 5s]
SBUR999: folds 
lawlex_2 has timed out
lawlex_2: folds 
a7236: calls $0.02
V1smut: folds 
Fran_Emm: raises $0.08 to $0.10
a7236: calls $0.08
*** FLOP *** [Td Ts 7h]
Fran_Emm: bets $0.12
a7236: raises $0.12 to $0.24
Fran_Emm: calls $0.12
*** TURN *** [Td Ts 7h] [Js]
Fran_Emm: checks 
a7236: bets $0.54
Fran_Emm: calls $0.54
*** RIVER *** [Td Ts 7h Js] [6c]
Fran_Emm: checks 
a7236: bets $1.12 and is all-in
Fran_Emm: calls $1.12
*** SHOW DOWN ***
a7236: shows [7s 7d] (a full house, Sevens full of Tens)
Fran_Emm: shows [Th Ah] (three of a kind, Tens)
a7236 collected $3.87 from pot
*** SUMMARY ***
Total pot $4.01 | Rake $0.14 
Board [Td Ts 7h Js 6c]
Seat 2: a7236 (button) showed [7s 7d] and won ($3.87) with a full house, Sevens full of Tens
Seat 3: V1smut (small blind) folded before Flop
Seat 4: Fran_Emm (big blind) showed [Th Ah] and lost with three of a kind, Tens
Seat 5: SBUR999 folded before Flop (didn't bet)
Seat 6: lawlex_2 folded before Flop (didn't bet)



PokerStars Hand #213055569060:  Hold'em No Limit ($0.01/$0.02 USD) - 2020/05/01 13:34:48 MSK [2020/05/01 6:34:48 ET]
Table 'Okavango III' 6-max Seat #3 is the button
Seat 2: a7236 ($3.87 in chips) 
Seat 3: V1smut ($2 in chips) 
Seat 4: Fran_Emm ($2 in chips) 
Seat 5: SBUR999 ($2.07 in chips) 
Seat 6: lawlex_2 ($2.86 in chips) 
Fran_Emm: posts small blind $0.01
SBUR999: posts big blind $0.02
*** HOLE CARDS ***
Dealt to lawlex_2 [3d Ac]
lawlex_2: calls $0.02
a7236: folds 
V1smut: folds 
Fran_Emm: raises $0.06 to $0.08
SBUR999: calls $0.06
lawlex_2: calls $0.06
*** FLOP *** [6h 3h Ah]
Fran_Emm: checks 
SBUR999: checks 
lawlex_2: bets $0.15
Fran_Emm: folds 
SBUR999: folds 
Uncalled bet ($0.15) returned to lawlex_2
lawlex_2 collected $0.23 from pot
lawlex_2: doesn't show hand 
*** SUMMARY ***
Total pot $0.24 | Rake $0.01 
Board [6h 3h Ah]
Seat 2: a7236 folded before Flop (didn't bet)
Seat 3: V1smut (button) folded before Flop (didn't bet)
Seat 4: Fran_Emm (small blind) folded on the Flop
Seat 5: SBUR999 (big blind) folded on the Flop
Seat 6: lawlex_2 collected ($0.23)



PokerStars Hand #213055593034:  Hold'em No Limit ($0.01/$0.02 USD) - 2020/05/01 13:35:30 MSK [2020/05/01 6:35:30 ET]
Table 'Okavango III' 6-max Seat #4 is the button
Seat 2: a7236 ($3.87 in chips) 
Seat 3: V1smut ($2 in chips) 
Seat 4: Fran_Emm ($2 in chips) 
Seat 5: SBUR999 ($1.99 in chips) 
Seat 6: lawlex_2 ($3.01 in chips) 
SBUR999: posts small blind $0.01
lawlex_2: posts big blind $0.02
*** HOLE CARDS ***
Dealt to lawlex_2 [3d 3c]
a7236: folds 
V1smut: folds 
Fran_Emm: folds 
SBUR999: calls $0.01
lawlex_2: checks 
*** FLOP *** [Kd 3h Th]
SBUR999: checks 
lawlex_2: bets $0.03
SBUR999: calls $0.03
*** TURN *** [Kd 3h Th] [6h]
SBUR999: checks 
lawlex_2: bets $0.07
SBUR999: calls $0.07
*** RIVER *** [Kd 3h Th 6h] [2s]
SBUR999: checks 
scorpka was removed from the table for failing to post
scorpka leaves the table
lawlex_2: checks 
*** SHOW DOWN ***
SBUR999: shows [Ah Jd] (high card Ace)
lawlex_2: shows [3d 3c] (three of a kind, Threes)
lawlex_2 collected $0.23 from pot
*** SUMMARY ***
Total pot $0.24 | Rake $0.01 
Board [Kd 3h Th 6h 2s]
Seat 2: a7236 folded before Flop (didn't bet)
Seat 3: V1smut folded before Flop (didn't bet)
Seat 4: Fran_Emm (button) folded before Flop (didn't bet)
Seat 5: SBUR999 (small blind) showed [Ah Jd] and lost with high card Ace
Seat 6: lawlex_2 (big blind) showed [3d 3c] and won ($0.23) with three of a kind, Threes



