PokerStars Hand #213571318555:  Hold'em No Limit ($0.01/$0.02 USD) - 2020/05/09 20:09:13 MSK [2020/05/09 13:09:13 ET]
Table 'Antiphos II' 6-max Seat #6 is the button
Seat 1: HitmanHenoir ($1.31 in chips) 
Seat 2: lawlex_2 ($2 in chips) 
Seat 3: FHZ12358 ($1.70 in chips) 
Seat 5: Gustave1967 ($3.06 in chips) 
Seat 6: Bonch241 ($3.08 in chips) 
HitmanHenoir: posts small blind $0.01
lawlex_2: posts big blind $0.02
*** HOLE CARDS ***
Dealt to lawlex_2 [9d 5s]
FHZ12358: calls $0.02
Gustave1967: folds 
Bonch241: raises $0.04 to $0.06
HitmanHenoir: raises $0.06 to $0.12
lawlex_2: folds 
FHZ12358: calls $0.10
Bonch241: calls $0.06
*** FLOP *** [3c Ks Kd]
HitmanHenoir: checks 
FHZ12358: bets $0.19
Bonch241: folds 
HitmanHenoir: folds 
Uncalled bet ($0.19) returned to FHZ12358
FHZ12358 collected $0.37 from pot
FHZ12358: doesn't show hand 
*** SUMMARY ***
Total pot $0.38 | Rake $0.01 
Board [3c Ks Kd]
Seat 1: HitmanHenoir (small blind) folded on the Flop
Seat 2: lawlex_2 (big blind) folded before Flop
Seat 3: FHZ12358 collected ($0.37)
Seat 5: Gustave1967 folded before Flop (didn't bet)
Seat 6: Bonch241 (button) folded on the Flop



PokerStars Hand #213571391503:  Hold'em No Limit ($0.01/$0.02 USD) - 2020/05/09 20:10:23 MSK [2020/05/09 13:10:23 ET]
Table 'Antiphos II' 6-max Seat #1 is the button
Seat 1: HitmanHenoir ($1.19 in chips) 
Seat 2: lawlex_2 ($1.98 in chips) 
Seat 3: FHZ12358 ($1.95 in chips) 
Seat 4: LocoU 10 ($0.80 in chips) 
Seat 5: Gustave1967 ($3.06 in chips) 
Seat 6: Bonch241 ($2.96 in chips) 
lawlex_2: posts small blind $0.01
FHZ12358: posts big blind $0.02
*** HOLE CARDS ***
Dealt to lawlex_2 [9h Jd]
LocoU 10 has timed out
LocoU 10: folds 
Gustave1967: calls $0.02
Bonch241: folds 
HitmanHenoir: folds 
lawlex_2: raises $0.04 to $0.06
FHZ12358: folds 
Gustave1967: calls $0.04
*** FLOP *** [Qh 7h Qc]
lawlex_2: checks 
Gustave1967: checks 
*** TURN *** [Qh 7h Qc] [Ah]
lawlex_2: bets $0.09
Gustave1967: raises $0.09 to $0.18
lawlex_2: calls $0.09
*** RIVER *** [Qh 7h Qc Ah] [8h]
lawlex_2: bets $0.32
Gustave1967: calls $0.32
*** SHOW DOWN ***
lawlex_2: shows [9h Jd] (a flush, Ace high)
Gustave1967: mucks hand 
lawlex_2 collected $1.10 from pot
*** SUMMARY ***
Total pot $1.14 | Rake $0.04 
Board [Qh 7h Qc Ah 8h]
Seat 1: HitmanHenoir (button) folded before Flop (didn't bet)
Seat 2: lawlex_2 (small blind) showed [9h Jd] and won ($1.10) with a flush, Ace high
Seat 3: FHZ12358 (big blind) folded before Flop
Seat 4: LocoU 10 folded before Flop (didn't bet)
Seat 5: Gustave1967 mucked [Qd Td]
Seat 6: Bonch241 folded before Flop (didn't bet)



PokerStars Hand #213571438267:  Hold'em No Limit ($0.01/$0.02 USD) - 2020/05/09 20:11:14 MSK [2020/05/09 13:11:14 ET]
Table 'Antiphos II' 6-max Seat #2 is the button
Seat 1: HitmanHenoir ($1.19 in chips) 
Seat 2: lawlex_2 ($2.52 in chips) 
Seat 3: FHZ12358 ($1.93 in chips) 
Seat 5: Gustave1967 ($2.50 in chips) 
Seat 6: Bonch241 ($2.96 in chips) 
FHZ12358: posts small blind $0.01
Gustave1967: posts big blind $0.02
*** HOLE CARDS ***
Dealt to lawlex_2 [Td 3h]
Bonch241: raises $0.04 to $0.06
HitmanHenoir: folds 
lawlex_2: folds 
FHZ12358: calls $0.05
Gustave1967: calls $0.04
*** FLOP *** [Ad 3c 6h]
FHZ12358: checks 
Gustave1967: checks 
Bonch241: bets $0.11
FHZ12358: folds 
Gustave1967: folds 
Uncalled bet ($0.11) returned to Bonch241
Bonch241 collected $0.17 from pot
*** SUMMARY ***
Total pot $0.18 | Rake $0.01 
Board [Ad 3c 6h]
Seat 1: HitmanHenoir folded before Flop (didn't bet)
Seat 2: lawlex_2 (button) folded before Flop (didn't bet)
Seat 3: FHZ12358 (small blind) folded on the Flop
Seat 5: Gustave1967 (big blind) folded on the Flop
Seat 6: Bonch241 collected ($0.17)



PokerStars Hand #213571467950:  Hold'em No Limit ($0.01/$0.02 USD) - 2020/05/09 20:11:46 MSK [2020/05/09 13:11:46 ET]
Table 'Antiphos II' 6-max Seat #3 is the button
Seat 1: HitmanHenoir ($1.19 in chips) 
Seat 2: lawlex_2 ($2.52 in chips) 
Seat 3: FHZ12358 ($1.87 in chips) 
Seat 5: Gustave1967 ($2.44 in chips) 
Seat 6: Bonch241 ($3.07 in chips) 
Gustave1967: posts small blind $0.01
Bonch241: posts big blind $0.02
*** HOLE CARDS ***
Dealt to lawlex_2 [3d Ad]
HitmanHenoir: folds 
lawlex_2 has timed out
lawlex_2: folds 
FHZ12358: folds 
Gustave1967: calls $0.01
Bonch241: checks 
*** FLOP *** [Td 2h 2s]
Gustave1967: checks 
Bonch241: checks 
*** TURN *** [Td 2h 2s] [4c]
Gustave1967: bets $0.02
Bonch241: calls $0.02
*** RIVER *** [Td 2h 2s 4c] [5c]
Gustave1967: bets $0.12
Bonch241: raises $0.28 to $0.40
Gustave1967: raises $0.36 to $0.76
Bonch241: calls $0.36
*** SHOW DOWN ***
Gustave1967: shows [2d 4h] (a full house, Deuces full of Fours)
Bonch241: mucks hand 
Gustave1967 collected $1.54 from pot
*** SUMMARY ***
Total pot $1.60 | Rake $0.06 
Board [Td 2h 2s 4c 5c]
Seat 1: HitmanHenoir folded before Flop (didn't bet)
Seat 2: lawlex_2 folded before Flop (didn't bet)
Seat 3: FHZ12358 (button) folded before Flop (didn't bet)
Seat 5: Gustave1967 (small blind) showed [2d 4h] and won ($1.54) with a full house, Deuces full of Fours
Seat 6: Bonch241 (big blind) mucked [3s Ac]



PokerStars Hand #213571520093:  Hold'em No Limit ($0.01/$0.02 USD) - 2020/05/09 20:12:43 MSK [2020/05/09 13:12:43 ET]
Table 'Antiphos II' 6-max Seat #5 is the button
Seat 1: HitmanHenoir ($1.19 in chips) 
Seat 2: lawlex_2 ($2.52 in chips) 
Seat 3: FHZ12358 ($1.87 in chips) 
Seat 4: LocoU 10 ($0.80 in chips) 
Seat 5: Gustave1967 ($3.18 in chips) 
Seat 6: Bonch241 ($2.27 in chips) 
Bonch241: posts small blind $0.01
HitmanHenoir: posts big blind $0.02
LocoU 10: posts small & big blinds $0.03
*** HOLE CARDS ***
Dealt to lawlex_2 [3h Qc]
lawlex_2: folds 
FHZ12358: folds 
LocoU 10: checks 
Gustave1967: folds 
Bonch241: calls $0.01
HitmanHenoir: checks 
*** FLOP *** [Ad 9h 8h]
Bonch241: checks 
HitmanHenoir: checks 
LocoU 10: checks 
*** TURN *** [Ad 9h 8h] [3c]
Bonch241: checks 
HitmanHenoir: checks 
LocoU 10: checks 
*** RIVER *** [Ad 9h 8h 3c] [3s]
Bonch241: checks 
HitmanHenoir: bets $0.07
LocoU 10: folds 
Bonch241: folds 
Uncalled bet ($0.07) returned to HitmanHenoir
HitmanHenoir collected $0.07 from pot
HitmanHenoir: doesn't show hand 
*** SUMMARY ***
Total pot $0.07 | Rake $0 
Board [Ad 9h 8h 3c 3s]
Seat 1: HitmanHenoir (big blind) collected ($0.07)
Seat 2: lawlex_2 folded before Flop (didn't bet)
Seat 3: FHZ12358 folded before Flop (didn't bet)
Seat 4: LocoU 10 folded on the River (didn't bet)
Seat 5: Gustave1967 (button) folded before Flop (didn't bet)
Seat 6: Bonch241 (small blind) folded on the River



PokerStars Hand #213571556249:  Hold'em No Limit ($0.01/$0.02 USD) - 2020/05/09 20:13:23 MSK [2020/05/09 13:13:23 ET]
Table 'Antiphos II' 6-max Seat #6 is the button
Seat 1: HitmanHenoir ($1.24 in chips) 
Seat 2: lawlex_2 ($2.52 in chips) 
Seat 3: FHZ12358 ($1.87 in chips) 
Seat 4: LocoU 10 ($0.77 in chips) 
Seat 5: Gustave1967 ($3.18 in chips) 
Seat 6: Bonch241 ($2.25 in chips) 
HitmanHenoir: posts small blind $0.01
lawlex_2: posts big blind $0.02
*** HOLE CARDS ***
Dealt to lawlex_2 [Jc 7s]
FHZ12358: raises $0.02 to $0.04
LocoU 10: raises $0.08 to $0.12
Gustave1967: folds 
Bonch241: folds 
HitmanHenoir: folds 
lawlex_2 has timed out
lawlex_2: folds 
FHZ12358: calls $0.08
*** FLOP *** [6c 2h Qd]
FHZ12358: checks 
LocoU 10: bets $0.08
FHZ12358: calls $0.08
*** TURN *** [6c 2h Qd] [Jd]
FHZ12358: checks 
LocoU 10: checks 
*** RIVER *** [6c 2h Qd Jd] [Ad]
FHZ12358: bets $0.21
Gustave1967 leaves the table
LocoU 10: folds 
Uncalled bet ($0.21) returned to FHZ12358
FHZ12358 collected $0.41 from pot
FHZ12358: doesn't show hand 
*** SUMMARY ***
Total pot $0.43 | Rake $0.02 
Board [6c 2h Qd Jd Ad]
Seat 1: HitmanHenoir (small blind) folded before Flop
Seat 2: lawlex_2 (big blind) folded before Flop
Seat 3: FHZ12358 collected ($0.41)
Seat 4: LocoU 10 folded on the River
Seat 5: Gustave1967 folded before Flop (didn't bet)
Seat 6: Bonch241 (button) folded before Flop (didn't bet)



PokerStars Hand #213571636136:  Hold'em No Limit ($0.01/$0.02 USD) - 2020/05/09 20:14:51 MSK [2020/05/09 13:14:51 ET]
Table 'Antiphos II' 6-max Seat #1 is the button
Seat 1: HitmanHenoir ($1.23 in chips) 
Seat 2: lawlex_2 ($2.50 in chips) 
Seat 3: FHZ12358 ($2.08 in chips) 
Seat 4: LocoU 10 ($0.57 in chips) 
Seat 6: Bonch241 ($2.25 in chips) 
lawlex_2: posts small blind $0.01
FHZ12358: posts big blind $0.02
*** HOLE CARDS ***
Dealt to lawlex_2 [6s Ac]
LocoU 10: folds 
Bonch241: folds 
HitmanHenoir: folds 
lawlex_2: raises $0.04 to $0.06
Bahonya Taraz joins the table at seat #5 
FHZ12358: calls $0.04
*** FLOP *** [9c Qh As]
lawlex_2: bets $0.08
FHZ12358: folds 
Uncalled bet ($0.08) returned to lawlex_2
lawlex_2 collected $0.12 from pot
lawlex_2: doesn't show hand 
*** SUMMARY ***
Total pot $0.12 | Rake $0 
Board [9c Qh As]
Seat 1: HitmanHenoir (button) folded before Flop (didn't bet)
Seat 2: lawlex_2 (small blind) collected ($0.12)
Seat 3: FHZ12358 (big blind) folded on the Flop
Seat 4: LocoU 10 folded before Flop (didn't bet)
Seat 6: Bonch241 folded before Flop (didn't bet)



PokerStars Hand #213571664308:  Hold'em No Limit ($0.01/$0.02 USD) - 2020/05/09 20:15:19 MSK [2020/05/09 13:15:19 ET]
Table 'Antiphos II' 6-max Seat #2 is the button
Seat 1: HitmanHenoir ($1.23 in chips) 
Seat 2: lawlex_2 ($2.56 in chips) 
Seat 3: FHZ12358 ($2.02 in chips) 
Seat 4: LocoU 10 ($0.57 in chips) 
Seat 5: Bahonya Taraz ($2 in chips) 
Seat 6: Bonch241 ($2.25 in chips) 
FHZ12358: posts small blind $0.01
LocoU 10: posts big blind $0.02
Bahonya Taraz: posts big blind $0.02
*** HOLE CARDS ***
Dealt to lawlex_2 [Kc Ks]
Bahonya Taraz: checks 
Bonch241: folds 
HitmanHenoir: calls $0.02
lawlex_2: calls $0.02
FHZ12358: folds 
LocoU 10: raises $0.09 to $0.11
Bahonya Taraz: folds 
HitmanHenoir: calls $0.09
lawlex_2: calls $0.09
*** FLOP *** [4s 9d Qh]
LocoU 10: checks 
HitmanHenoir: bets $0.16
lawlex_2: calls $0.16
LocoU 10: folds 
*** TURN *** [4s 9d Qh] [6d]
HitmanHenoir: checks 
lawlex_2: bets $0.44
HitmanHenoir: raises $0.52 to $0.96 and is all-in
lawlex_2: calls $0.52
*** RIVER *** [4s 9d Qh 6d] [5s]
*** SHOW DOWN ***
HitmanHenoir: shows [Qd Td] (a pair of Queens)
lawlex_2: shows [Kc Ks] (a pair of Kings)
lawlex_2 collected $2.51 from pot
*** SUMMARY ***
Total pot $2.60 | Rake $0.09 
Board [4s 9d Qh 6d 5s]
Seat 1: HitmanHenoir showed [Qd Td] and lost with a pair of Queens
Seat 2: lawlex_2 (button) showed [Kc Ks] and won ($2.51) with a pair of Kings
Seat 3: FHZ12358 (small blind) folded before Flop
Seat 4: LocoU 10 (big blind) folded on the Flop
Seat 5: Bahonya Taraz folded before Flop (didn't bet)
Seat 6: Bonch241 folded before Flop (didn't bet)



PokerStars Hand #213571728932:  Hold'em No Limit ($0.01/$0.02 USD) - 2020/05/09 20:16:25 MSK [2020/05/09 13:16:25 ET]
Table 'Antiphos II' 6-max Seat #3 is the button
Seat 2: lawlex_2 ($3.84 in chips) 
Seat 3: FHZ12358 ($2.01 in chips) 
Seat 4: LocoU 10 ($0.46 in chips) 
Seat 5: Bahonya Taraz ($1.98 in chips) 
Seat 6: Bonch241 ($2.25 in chips) 
LocoU 10: posts small blind $0.01
Bahonya Taraz: posts big blind $0.02
*** HOLE CARDS ***
Dealt to lawlex_2 [Ah 7d]
HitmanHenoir leaves the table
Bonch241: folds 
lawlex_2: raises $0.04 to $0.06
HaG1BaT0R joins the table at seat #1 
FHZ12358: calls $0.06
LocoU 10: calls $0.05
Bahonya Taraz: calls $0.04
*** FLOP *** [8c 5s 9s]
LocoU 10: bets $0.40 and is all-in
Bahonya Taraz: calls $0.40
lawlex_2: folds 
FHZ12358: folds 
*** TURN *** [8c 5s 9s] [3c]
*** RIVER *** [8c 5s 9s 3c] [7c]
*** SHOW DOWN ***
LocoU 10: shows [Js 9c] (a pair of Nines)
Bahonya Taraz: shows [6c 5d] (a straight, Five to Nine)
LocoU 10 cashed out the hand for $0.70 | Cash Out Fee $0.01
Bahonya Taraz cashed out the hand for $0.29
*** SUMMARY ***
Total pot $1.04 | Rake $0.04 
Board [8c 5s 9s 3c 7c]
Seat 2: lawlex_2 folded on the Flop
Seat 3: FHZ12358 (button) folded on the Flop
Seat 4: LocoU 10 (small blind) showed [Js 9c] and lost with a pair of Nines (cashed out).
Seat 5: Bahonya Taraz (big blind) showed [6c 5d] and won ($1) with a straight, Five to Nine (pot not awarded as player cashed out)
Seat 6: Bonch241 folded before Flop (didn't bet)



PokerStars Hand #213571768908:  Hold'em No Limit ($0.01/$0.02 USD) - 2020/05/09 20:17:06 MSK [2020/05/09 13:17:06 ET]
Table 'Antiphos II' 6-max Seat #4 is the button
Seat 2: lawlex_2 ($3.78 in chips) 
Seat 3: FHZ12358 ($1.95 in chips) 
Seat 4: LocoU 10 ($0.70 in chips) 
Seat 5: Bahonya Taraz ($1.81 in chips) 
Seat 6: Bonch241 ($2.25 in chips) 
Bahonya Taraz: posts small blind $0.01
Bonch241: posts big blind $0.02
HaG1BaT0R: sits out 
*** HOLE CARDS ***
Dealt to lawlex_2 [5h Tc]
lawlex_2: folds 
FHZ12358: calls $0.02
LocoU 10: calls $0.02
Bahonya Taraz: calls $0.01
Bonch241: raises $0.18 to $0.20
FHZ12358: folds 
LocoU 10: folds 
Bahonya Taraz: calls $0.18
*** FLOP *** [Ts 4s Ad]
Bahonya Taraz: bets $0.02
Bonch241: raises $0.23 to $0.25
Bahonya Taraz: calls $0.23
*** TURN *** [Ts 4s Ad] [Kd]
Bahonya Taraz: checks 
Bonch241: bets $1.80 and is all-in
Bahonya Taraz: folds 
Uncalled bet ($1.80) returned to Bonch241
Bonch241 collected $0.91 from pot
*** SUMMARY ***
Total pot $0.94 | Rake $0.03 
Board [Ts 4s Ad Kd]
Seat 2: lawlex_2 folded before Flop (didn't bet)
Seat 3: FHZ12358 folded before Flop
Seat 4: LocoU 10 (button) folded before Flop
Seat 5: Bahonya Taraz (small blind) folded on the Turn
Seat 6: Bonch241 (big blind) collected ($0.91)



PokerStars Hand #213571819274:  Hold'em No Limit ($0.01/$0.02 USD) - 2020/05/09 20:17:56 MSK [2020/05/09 13:17:56 ET]
Table 'Antiphos II' 6-max Seat #5 is the button
Seat 1: HaG1BaT0R ($2 in chips) 
Seat 2: lawlex_2 ($3.78 in chips) 
Seat 3: FHZ12358 ($1.93 in chips) 
Seat 4: LocoU 10 ($0.68 in chips) 
Seat 5: Bahonya Taraz ($1.36 in chips) 
Seat 6: Bonch241 ($2.71 in chips) 
Bonch241: posts small blind $0.01
HaG1BaT0R: posts big blind $0.02
*** HOLE CARDS ***
Dealt to lawlex_2 [4d Jd]
lawlex_2: folds 
FHZ12358: calls $0.02
LocoU 10: folds 
Bahonya Taraz: calls $0.02
Bonch241: folds 
HaG1BaT0R: checks 
*** FLOP *** [Kh 5s Tc]
HaG1BaT0R: checks 
FHZ12358: bets $0.07
Bahonya Taraz: folds 
HaG1BaT0R: folds 
Uncalled bet ($0.07) returned to FHZ12358
FHZ12358 collected $0.07 from pot
*** SUMMARY ***
Total pot $0.07 | Rake $0 
Board [Kh 5s Tc]
Seat 1: HaG1BaT0R (big blind) folded on the Flop
Seat 2: lawlex_2 folded before Flop (didn't bet)
Seat 3: FHZ12358 collected ($0.07)
Seat 4: LocoU 10 folded before Flop (didn't bet)
Seat 5: Bahonya Taraz (button) folded on the Flop
Seat 6: Bonch241 (small blind) folded before Flop



PokerStars Hand #213571848086:  Hold'em No Limit ($0.01/$0.02 USD) - 2020/05/09 20:18:25 MSK [2020/05/09 13:18:25 ET]
Table 'Antiphos II' 6-max Seat #6 is the button
Seat 1: HaG1BaT0R ($2 in chips) 
Seat 2: lawlex_2 ($3.78 in chips) 
Seat 3: FHZ12358 ($1.98 in chips) 
Seat 4: LocoU 10 ($0.68 in chips) 
Seat 5: Bahonya Taraz ($1.34 in chips) 
Seat 6: Bonch241 ($2.70 in chips) 
HaG1BaT0R: posts small blind $0.01
lawlex_2: posts big blind $0.02
*** HOLE CARDS ***
Dealt to lawlex_2 [7h Kh]
FHZ12358: folds 
LocoU 10: folds 
Bahonya Taraz: calls $0.02
Bonch241: folds 
HaG1BaT0R: calls $0.01
lawlex_2: raises $0.04 to $0.06
Bahonya Taraz: calls $0.04
HaG1BaT0R: folds 
*** FLOP *** [Th Jc Qc]
lawlex_2: bets $0.09
Bahonya Taraz: folds 
Uncalled bet ($0.09) returned to lawlex_2
lawlex_2 collected $0.14 from pot
lawlex_2: doesn't show hand 
*** SUMMARY ***
Total pot $0.14 | Rake $0 
Board [Th Jc Qc]
Seat 1: HaG1BaT0R (small blind) folded before Flop
Seat 2: lawlex_2 (big blind) collected ($0.14)
Seat 3: FHZ12358 folded before Flop (didn't bet)
Seat 4: LocoU 10 folded before Flop (didn't bet)
Seat 5: Bahonya Taraz folded on the Flop
Seat 6: Bonch241 (button) folded before Flop (didn't bet)



PokerStars Hand #213571885039:  Hold'em No Limit ($0.01/$0.02 USD) - 2020/05/09 20:19:03 MSK [2020/05/09 13:19:03 ET]
Table 'Antiphos II' 6-max Seat #1 is the button
Seat 1: HaG1BaT0R ($2 in chips) 
Seat 2: lawlex_2 ($3.86 in chips) 
Seat 3: FHZ12358 ($1.98 in chips) 
Seat 4: LocoU 10 ($0.68 in chips) 
Seat 5: Bahonya Taraz ($1.28 in chips) 
Seat 6: Bonch241 ($2.70 in chips) 
lawlex_2: posts small blind $0.01
FHZ12358: posts big blind $0.02
*** HOLE CARDS ***
Dealt to lawlex_2 [7s 4s]
LocoU 10: raises $0.15 to $0.17
Bahonya Taraz: folds 
Bonch241: folds 
HaG1BaT0R: folds 
lawlex_2: folds 
FHZ12358: calls $0.15
*** FLOP *** [Ts 4c 3d]
FHZ12358: checks 
LocoU 10: bets $0.18
FHZ12358: calls $0.18
*** TURN *** [Ts 4c 3d] [3s]
FHZ12358: bets $1.63 and is all-in
LocoU 10: calls $0.33 and is all-in
Uncalled bet ($1.30) returned to FHZ12358
*** RIVER *** [Ts 4c 3d 3s] [9s]
*** SHOW DOWN ***
FHZ12358: shows [2h 2d] (two pair, Threes and Deuces)
LocoU 10: shows [Ad Td] (two pair, Tens and Threes)
LocoU 10 cashed out the hand for $1.24 | Cash Out Fee $0.01
*** SUMMARY ***
Total pot $1.37 | Rake $0.05 
Board [Ts 4c 3d 3s 9s]
Seat 1: HaG1BaT0R (button) folded before Flop (didn't bet)
Seat 2: lawlex_2 (small blind) folded before Flop
Seat 3: FHZ12358 (big blind) showed [2h 2d] and lost with two pair, Threes and Deuces
Seat 4: LocoU 10 showed [Ad Td] and won ($1.32) with two pair, Tens and Threes (pot not awarded as player cashed out)
Seat 5: Bahonya Taraz folded before Flop (didn't bet)
Seat 6: Bonch241 folded before Flop (didn't bet)



PokerStars Hand #213571937709:  Hold'em No Limit ($0.01/$0.02 USD) - 2020/05/09 20:19:55 MSK [2020/05/09 13:19:55 ET]
Table 'Antiphos II' 6-max Seat #2 is the button
Seat 1: HaG1BaT0R ($2 in chips) 
Seat 2: lawlex_2 ($3.85 in chips) 
Seat 3: FHZ12358 ($1.30 in chips) 
Seat 4: LocoU 10 ($1.24 in chips) 
Seat 5: Bahonya Taraz ($1.28 in chips) 
Seat 6: Bonch241 ($2.70 in chips) 
FHZ12358: posts small blind $0.01
LocoU 10: posts big blind $0.02
*** HOLE CARDS ***
Dealt to lawlex_2 [8d 2c]
Bahonya Taraz: calls $0.02
Bonch241: folds 
HaG1BaT0R: folds 
lawlex_2: folds 
FHZ12358: calls $0.01
LocoU 10: checks 
*** FLOP *** [9c Kh Td]
FHZ12358: checks 
LocoU 10: checks 
Bahonya Taraz: checks 
*** TURN *** [9c Kh Td] [6h]
FHZ12358: checks 
LocoU 10: checks 
Bahonya Taraz: checks 
*** RIVER *** [9c Kh Td 6h] [8s]
FHZ12358: checks 
LocoU 10: checks 
Bahonya Taraz: checks 
*** SHOW DOWN ***
FHZ12358: shows [4s Js] (high card King)
LocoU 10: shows [3c 6s] (a pair of Sixes)
Bahonya Taraz: mucks hand 
LocoU 10 collected $0.06 from pot
*** SUMMARY ***
Total pot $0.06 | Rake $0 
Board [9c Kh Td 6h 8s]
Seat 1: HaG1BaT0R folded before Flop (didn't bet)
Seat 2: lawlex_2 (button) folded before Flop (didn't bet)
Seat 3: FHZ12358 (small blind) showed [4s Js] and lost with high card King
Seat 4: LocoU 10 (big blind) showed [3c 6s] and won ($0.06) with a pair of Sixes
Seat 5: Bahonya Taraz mucked [4d 3d]
Seat 6: Bonch241 folded before Flop (didn't bet)



PokerStars Hand #213571989991:  Hold'em No Limit ($0.01/$0.02 USD) - 2020/05/09 20:20:48 MSK [2020/05/09 13:20:48 ET]
Table 'Antiphos II' 6-max Seat #3 is the button
Seat 1: HaG1BaT0R ($2 in chips) 
Seat 2: lawlex_2 ($3.85 in chips) 
Seat 3: FHZ12358 ($1.28 in chips) 
Seat 4: LocoU 10 ($1.28 in chips) 
Seat 5: Bahonya Taraz ($1.26 in chips) 
Seat 6: Bonch241 ($2.70 in chips) 
LocoU 10: posts small blind $0.01
Bahonya Taraz: posts big blind $0.02
*** HOLE CARDS ***
Dealt to lawlex_2 [2c Qd]
Bonch241: folds 
HaG1BaT0R: raises $0.04 to $0.06
lawlex_2: folds 
FHZ12358: calls $0.06
LocoU 10: folds 
Bahonya Taraz: calls $0.04
*** FLOP *** [5d 6s 2d]
Bahonya Taraz: checks 
HaG1BaT0R: checks 
FHZ12358: checks 
*** TURN *** [5d 6s 2d] [3h]
Bahonya Taraz: checks 
HaG1BaT0R: checks 
FHZ12358: checks 
*** RIVER *** [5d 6s 2d 3h] [3s]
Bahonya Taraz: checks 
HaG1BaT0R: checks 
FHZ12358: checks 
*** SHOW DOWN ***
Bahonya Taraz: shows [8s 9h] (a pair of Threes)
HaG1BaT0R: shows [Ad Kc] (a pair of Threes - Ace kicker)
FHZ12358: mucks hand 
HaG1BaT0R collected $0.18 from pot
*** SUMMARY ***
Total pot $0.19 | Rake $0.01 
Board [5d 6s 2d 3h 3s]
Seat 1: HaG1BaT0R showed [Ad Kc] and won ($0.18) with a pair of Threes
Seat 2: lawlex_2 folded before Flop (didn't bet)
Seat 3: FHZ12358 (button) mucked [8d Qh]
Seat 4: LocoU 10 (small blind) folded before Flop
Seat 5: Bahonya Taraz (big blind) showed [8s 9h] and lost with a pair of Threes
Seat 6: Bonch241 folded before Flop (didn't bet)



PokerStars Hand #213572040807:  Hold'em No Limit ($0.01/$0.02 USD) - 2020/05/09 20:21:38 MSK [2020/05/09 13:21:38 ET]
Table 'Antiphos II' 6-max Seat #4 is the button
Seat 1: HaG1BaT0R ($2.12 in chips) 
Seat 2: lawlex_2 ($3.85 in chips) 
Seat 3: FHZ12358 ($1.22 in chips) 
Seat 4: LocoU 10 ($1.27 in chips) 
Seat 5: Bahonya Taraz ($1.20 in chips) 
Seat 6: Bonch241 ($2.70 in chips) 
Bahonya Taraz: posts small blind $0.01
Bonch241: posts big blind $0.02
*** HOLE CARDS ***
Dealt to lawlex_2 [3c Ks]
HaG1BaT0R: folds 
lawlex_2: folds 
FHZ12358: folds 
LocoU 10: folds 
Bahonya Taraz: raises $0.02 to $0.04
Bonch241: folds 
Uncalled bet ($0.02) returned to Bahonya Taraz
Bahonya Taraz collected $0.04 from pot
Bahonya Taraz: doesn't show hand 
*** SUMMARY ***
Total pot $0.04 | Rake $0 
Seat 1: HaG1BaT0R folded before Flop (didn't bet)
Seat 2: lawlex_2 folded before Flop (didn't bet)
Seat 3: FHZ12358 folded before Flop (didn't bet)
Seat 4: LocoU 10 (button) folded before Flop (didn't bet)
Seat 5: Bahonya Taraz (small blind) collected ($0.04)
Seat 6: Bonch241 (big blind) folded before Flop



PokerStars Hand #213572056147:  Hold'em No Limit ($0.01/$0.02 USD) - 2020/05/09 20:21:54 MSK [2020/05/09 13:21:54 ET]
Table 'Antiphos II' 6-max Seat #5 is the button
Seat 1: HaG1BaT0R ($2.12 in chips) 
Seat 2: lawlex_2 ($3.85 in chips) 
Seat 3: FHZ12358 ($1.22 in chips) 
Seat 4: LocoU 10 ($1.27 in chips) 
Seat 5: Bahonya Taraz ($1.22 in chips) 
Seat 6: Bonch241 ($2.68 in chips) 
Bonch241: posts small blind $0.01
HaG1BaT0R: posts big blind $0.02
*** HOLE CARDS ***
Dealt to lawlex_2 [Td As]
lawlex_2: raises $0.04 to $0.06
FHZ12358: calls $0.06
LocoU 10: folds 
Bahonya Taraz: calls $0.06
Bonch241: calls $0.05
HaG1BaT0R: raises $0.30 to $0.36
lawlex_2: folds 
FHZ12358: calls $0.30
Bahonya Taraz: calls $0.30
Bonch241: calls $0.30
*** FLOP *** [3s 3c Ac]
Bonch241: bets $2.32 and is all-in
HaG1BaT0R: calls $1.76 and is all-in
FHZ12358: folds 
Bahonya Taraz: folds 
Uncalled bet ($0.56) returned to Bonch241
*** FIRST TURN *** [3s 3c Ac] [4h]
*** FIRST RIVER *** [3s 3c Ac 4h] [6c]
*** SECOND TURN *** [3s 3c Ac] [8c]
*** SECOND RIVER *** [3s 3c Ac 8c] [Th]
*** FIRST SHOW DOWN ***
Bonch241: shows [Kc Jc] (a flush, Ace high)
HaG1BaT0R: shows [Kh Ad] (two pair, Aces and Threes)
Bonch241 collected $2.42 from pot
*** SECOND SHOW DOWN ***
Bonch241: shows [Kc Jc] (a flush, Ace high)
HaG1BaT0R: shows [Kh Ad] (two pair, Aces and Threes)
Bonch241 collected $2.42 from pot
*** SUMMARY ***
Total pot $5.02 | Rake $0.18 
Hand was run twice
FIRST Board [3s 3c Ac 4h 6c]
SECOND Board [3s 3c Ac 8c Th]
Seat 1: HaG1BaT0R (big blind) showed [Kh Ad] and lost with two pair, Aces and Threes, and lost with two pair, Aces and Threes
Seat 2: lawlex_2 folded before Flop
Seat 3: FHZ12358 folded on the Flop
Seat 4: LocoU 10 folded before Flop (didn't bet)
Seat 5: Bahonya Taraz (button) folded on the Flop
Seat 6: Bonch241 (small blind) showed [Kc Jc] and won ($2.42) with a flush, Ace high, and won ($2.42) with a flush, Ace high



PokerStars Hand #213572123899:  Hold'em No Limit ($0.01/$0.02 USD) - 2020/05/09 20:22:52 MSK [2020/05/09 13:22:52 ET]
Table 'Antiphos II' 6-max Seat #1 is the button
Seat 1: HaG1BaT0R ($2 in chips) 
Seat 2: lawlex_2 ($3.79 in chips) 
Seat 3: FHZ12358 ($0.86 in chips) 
Seat 4: LocoU 10 ($1.27 in chips) 
Seat 5: Bahonya Taraz ($0.86 in chips) 
lawlex_2: posts small blind $0.01
FHZ12358: posts big blind $0.02
*** HOLE CARDS ***
Dealt to lawlex_2 [4c Jd]
LocoU 10: folds 
Bahonya Taraz: raises $0.02 to $0.04
HaG1BaT0R: raises $0.02 to $0.06
lawlex_2: folds 
FHZ12358: raises $0.02 to $0.08
Bahonya Taraz: calls $0.04
HaG1BaT0R: calls $0.02
*** FLOP *** [8d 5c 3h]
FHZ12358: bets $0.24
Bahonya Taraz: folds 
HaG1BaT0R: folds 
Uncalled bet ($0.24) returned to FHZ12358
FHZ12358 collected $0.24 from pot
*** SUMMARY ***
Total pot $0.25 | Rake $0.01 
Board [8d 5c 3h]
Seat 1: HaG1BaT0R (button) folded on the Flop
Seat 2: lawlex_2 (small blind) folded before Flop
Seat 3: FHZ12358 (big blind) collected ($0.24)
Seat 4: LocoU 10 folded before Flop (didn't bet)
Seat 5: Bahonya Taraz folded on the Flop



PokerStars Hand #213572161368:  Hold'em No Limit ($0.01/$0.02 USD) - 2020/05/09 20:23:30 MSK [2020/05/09 13:23:30 ET]
Table 'Antiphos II' 6-max Seat #2 is the button
Seat 1: HaG1BaT0R ($2 in chips) 
Seat 2: lawlex_2 ($3.78 in chips) 
Seat 3: FHZ12358 ($1.02 in chips) 
Seat 4: LocoU 10 ($1.27 in chips) 
Seat 5: Bahonya Taraz ($0.78 in chips) 
FHZ12358: posts small blind $0.01
LocoU 10: posts big blind $0.02
*** HOLE CARDS ***
Dealt to lawlex_2 [Ad 2s]
Bahonya Taraz: folds 
HaG1BaT0R: folds 
lawlex_2: raises $0.04 to $0.06
FHZ12358: folds 
LocoU 10: calls $0.04
*** FLOP *** [6c 9c 6d]
LocoU 10: checks 
lawlex_2: bets $0.09
LocoU 10: folds 
Uncalled bet ($0.09) returned to lawlex_2
lawlex_2 collected $0.13 from pot
lawlex_2: doesn't show hand 
*** SUMMARY ***
Total pot $0.13 | Rake $0 
Board [6c 9c 6d]
Seat 1: HaG1BaT0R folded before Flop (didn't bet)
Seat 2: lawlex_2 (button) collected ($0.13)
Seat 3: FHZ12358 (small blind) folded before Flop
Seat 4: LocoU 10 (big blind) folded on the Flop
Seat 5: Bahonya Taraz folded before Flop (didn't bet)



PokerStars Hand #213572194899:  Hold'em No Limit ($0.01/$0.02 USD) - 2020/05/09 20:24:03 MSK [2020/05/09 13:24:03 ET]
Table 'Antiphos II' 6-max Seat #3 is the button
Seat 1: HaG1BaT0R ($2 in chips) 
Seat 2: lawlex_2 ($3.85 in chips) 
Seat 3: FHZ12358 ($1.01 in chips) 
Seat 4: LocoU 10 ($1.21 in chips) 
Seat 5: Bahonya Taraz ($0.78 in chips) 
LocoU 10: posts small blind $0.01
Bahonya Taraz: posts big blind $0.02
*** HOLE CARDS ***
Dealt to lawlex_2 [3d Qh]
HaG1BaT0R: calls $0.02
lawlex_2: folds 
FHZ12358: folds 
LocoU 10: folds 
Bahonya Taraz: raises $0.02 to $0.04
HaG1BaT0R: calls $0.02
*** FLOP *** [9s 5c Qs]
Bahonya Taraz: bets $0.02
HaG1BaT0R: calls $0.02
*** TURN *** [9s 5c Qs] [Ah]
Bahonya Taraz: bets $0.02
HaG1BaT0R: raises $0.06 to $0.08
Bahonya Taraz: calls $0.06
*** RIVER *** [9s 5c Qs Ah] [4c]
Bahonya Taraz: checks 
HaG1BaT0R: bets $0.15
Bahonya Taraz: folds 
Uncalled bet ($0.15) returned to HaG1BaT0R
HaG1BaT0R collected $0.28 from pot
HaG1BaT0R: doesn't show hand 
*** SUMMARY ***
Total pot $0.29 | Rake $0.01 
Board [9s 5c Qs Ah 4c]
Seat 1: HaG1BaT0R collected ($0.28)
Seat 2: lawlex_2 folded before Flop (didn't bet)
Seat 3: FHZ12358 (button) folded before Flop (didn't bet)
Seat 4: LocoU 10 (small blind) folded before Flop
Seat 5: Bahonya Taraz (big blind) folded on the River



PokerStars Hand #213572228398:  Hold'em No Limit ($0.01/$0.02 USD) - 2020/05/09 20:24:36 MSK [2020/05/09 13:24:36 ET]
Table 'Antiphos II' 6-max Seat #4 is the button
Seat 1: HaG1BaT0R ($2.14 in chips) 
Seat 2: lawlex_2 ($3.85 in chips) 
Seat 3: FHZ12358 ($1.01 in chips) 
Seat 4: LocoU 10 ($1.20 in chips) 
Seat 5: Bahonya Taraz ($0.64 in chips) 
Bahonya Taraz: posts small blind $0.01
HaG1BaT0R: posts big blind $0.02
*** HOLE CARDS ***
Dealt to lawlex_2 [9d 9s]
lawlex_2: raises $0.04 to $0.06
FHZ12358: calls $0.06
LocoU 10: folds 
Bahonya Taraz: raises $0.58 to $0.64 and is all-in
HaG1BaT0R: folds 
lawlex_2: folds 
FHZ12358: calls $0.58
*** FLOP *** [7c 6s Ac]
*** TURN *** [7c 6s Ac] [7s]
*** RIVER *** [7c 6s Ac 7s] [6c]
*** SHOW DOWN ***
Bahonya Taraz: shows [Qd 8c] (two pair, Sevens and Sixes)
FHZ12358: shows [8s Ks] (two pair, Sevens and Sixes)
Bahonya Taraz collected $0.66 from pot
FHZ12358 collected $0.65 from pot
*** SUMMARY ***
Total pot $1.36 | Rake $0.05 
Board [7c 6s Ac 7s 6c]
Seat 1: HaG1BaT0R (big blind) folded before Flop
Seat 2: lawlex_2 folded before Flop
Seat 3: FHZ12358 showed [8s Ks] and won ($0.65) with two pair, Sevens and Sixes
Seat 4: LocoU 10 (button) folded before Flop (didn't bet)
Seat 5: Bahonya Taraz (small blind) showed [Qd 8c] and won ($0.66) with two pair, Sevens and Sixes



PokerStars Hand #213572263092:  Hold'em No Limit ($0.01/$0.02 USD) - 2020/05/09 20:25:11 MSK [2020/05/09 13:25:11 ET]
Table 'Antiphos II' 6-max Seat #5 is the button
Seat 1: HaG1BaT0R ($2.12 in chips) 
Seat 2: lawlex_2 ($3.79 in chips) 
Seat 3: FHZ12358 ($1.02 in chips) 
Seat 4: LocoU 10 ($1.20 in chips) 
Seat 5: Bahonya Taraz ($0.66 in chips) 
HaG1BaT0R: posts small blind $0.01
lawlex_2: posts big blind $0.02
*** HOLE CARDS ***
Dealt to lawlex_2 [Ts 2s]
FHZ12358: folds 
LocoU 10: folds 
Bahonya Taraz: raises $0.64 to $0.66 and is all-in
HaG1BaT0R: calls $0.65
lawlex_2: folds 
*** FLOP *** [Jc 8d 7s]
*** TURN *** [Jc 8d 7s] [2h]
*** RIVER *** [Jc 8d 7s 2h] [4c]
*** SHOW DOWN ***
HaG1BaT0R: shows [9d 9s] (a pair of Nines)
Bahonya Taraz: shows [Ac Kd] (high card Ace)
HaG1BaT0R collected $1.29 from pot
*** SUMMARY ***
Total pot $1.34 | Rake $0.05 
Board [Jc 8d 7s 2h 4c]
Seat 1: HaG1BaT0R (small blind) showed [9d 9s] and won ($1.29) with a pair of Nines
Seat 2: lawlex_2 (big blind) folded before Flop
Seat 3: FHZ12358 folded before Flop (didn't bet)
Seat 4: LocoU 10 folded before Flop (didn't bet)
Seat 5: Bahonya Taraz (button) showed [Ac Kd] and lost with high card Ace



PokerStars Hand #213572287929:  Hold'em No Limit ($0.01/$0.02 USD) - 2020/05/09 20:25:36 MSK [2020/05/09 13:25:36 ET]
Table 'Antiphos II' 6-max Seat #1 is the button
Seat 1: HaG1BaT0R ($2.75 in chips) 
Seat 2: lawlex_2 ($3.77 in chips) 
Seat 3: FHZ12358 ($1.02 in chips) 
Seat 4: LocoU 10 ($1.20 in chips) 
lawlex_2: posts small blind $0.01
FHZ12358: posts big blind $0.02
Bonch241: sits out 
*** HOLE CARDS ***
Dealt to lawlex_2 [8h 9h]
LocoU 10: folds 
HaG1BaT0R: folds 
lawlex_2: raises $0.04 to $0.06
FHZ12358: folds 
Uncalled bet ($0.04) returned to lawlex_2
lawlex_2 collected $0.04 from pot
lawlex_2: doesn't show hand 
*** SUMMARY ***
Total pot $0.04 | Rake $0 
Seat 1: HaG1BaT0R (button) folded before Flop (didn't bet)
Seat 2: lawlex_2 (small blind) collected ($0.04)
Seat 3: FHZ12358 (big blind) folded before Flop
Seat 4: LocoU 10 folded before Flop (didn't bet)



PokerStars Hand #213572302898:  Hold'em No Limit ($0.01/$0.02 USD) - 2020/05/09 20:25:51 MSK [2020/05/09 13:25:51 ET]
Table 'Antiphos II' 6-max Seat #2 is the button
Seat 1: HaG1BaT0R ($2.75 in chips) 
Seat 2: lawlex_2 ($3.79 in chips) 
Seat 3: FHZ12358 ($1 in chips) 
Seat 4: LocoU 10 ($1.20 in chips) 
FHZ12358: posts small blind $0.01
LocoU 10: posts big blind $0.02
Bonch241: sits out 
*** HOLE CARDS ***
Dealt to lawlex_2 [Qh Ks]
HaG1BaT0R: folds 
Bahonya Taraz leaves the table
lawlex_2: raises $0.04 to $0.06
FHZ12358: folds 
LocoU 10: calls $0.04
*** FLOP *** [2c 4s 6h]
Joaquín 74 joins the table at seat #5 
LocoU 10: checks 
lawlex_2: bets $0.09
LocoU 10: folds 
Uncalled bet ($0.09) returned to lawlex_2
lawlex_2 collected $0.13 from pot
lawlex_2: doesn't show hand 
*** SUMMARY ***
Total pot $0.13 | Rake $0 
Board [2c 4s 6h]
Seat 1: HaG1BaT0R folded before Flop (didn't bet)
Seat 2: lawlex_2 (button) collected ($0.13)
Seat 3: FHZ12358 (small blind) folded before Flop
Seat 4: LocoU 10 (big blind) folded on the Flop



PokerStars Hand #213572335182:  Hold'em No Limit ($0.01/$0.02 USD) - 2020/05/09 20:26:23 MSK [2020/05/09 13:26:23 ET]
Table 'Antiphos II' 6-max Seat #3 is the button
Seat 1: HaG1BaT0R ($2.75 in chips) 
Seat 2: lawlex_2 ($3.86 in chips) 
Seat 3: FHZ12358 ($0.99 in chips) 
Seat 4: LocoU 10 ($1.14 in chips) 
Seat 5: Joaquín 74 ($2 in chips) 
LocoU 10: posts small blind $0.01
Joaquín 74: posts big blind $0.02
Bonch241: sits out 
*** HOLE CARDS ***
Dealt to lawlex_2 [Jh Ks]
HaG1BaT0R: folds 
lawlex_2: raises $0.04 to $0.06
FHZ12358: folds 
LocoU 10: folds 
Joaquín 74: folds 
Uncalled bet ($0.04) returned to lawlex_2
lawlex_2 collected $0.05 from pot
lawlex_2: doesn't show hand 
*** SUMMARY ***
Total pot $0.05 | Rake $0 
Seat 1: HaG1BaT0R folded before Flop (didn't bet)
Seat 2: lawlex_2 collected ($0.05)
Seat 3: FHZ12358 (button) folded before Flop (didn't bet)
Seat 4: LocoU 10 (small blind) folded before Flop
Seat 5: Joaquín 74 (big blind) folded before Flop



PokerStars Hand #213572360434:  Hold'em No Limit ($0.01/$0.02 USD) - 2020/05/09 20:26:48 MSK [2020/05/09 13:26:48 ET]
Table 'Antiphos II' 6-max Seat #4 is the button
Seat 1: HaG1BaT0R ($2.75 in chips) 
Seat 2: lawlex_2 ($3.89 in chips) 
Seat 3: FHZ12358 ($0.99 in chips) 
Seat 4: LocoU 10 ($1.13 in chips) 
Seat 5: Joaquín 74 ($2 in chips) 
Seat 6: Bonch241 ($5.40 in chips) 
Joaquín 74: posts small blind $0.01
Bonch241: posts big blind $0.02
*** HOLE CARDS ***
Dealt to lawlex_2 [Tc 8h]
HaG1BaT0R: folds 
lawlex_2: folds 
FHZ12358: calls $0.02
LocoU 10: calls $0.02
Joaquín 74: raises $0.10 to $0.12
Bonch241: folds 
FHZ12358: raises $0.87 to $0.99 and is all-in
LocoU 10: folds 
Joaquín 74: calls $0.87
*** FLOP *** [8c 2c 4d]
*** TURN *** [8c 2c 4d] [2h]
*** RIVER *** [8c 2c 4d 2h] [Jc]
*** SHOW DOWN ***
Joaquín 74: shows [Ac Kh] (a pair of Deuces)
FHZ12358: shows [Qc Jd] (two pair, Jacks and Deuces)
FHZ12358 collected $1.95 from pot
*** SUMMARY ***
Total pot $2.02 | Rake $0.07 
Board [8c 2c 4d 2h Jc]
Seat 1: HaG1BaT0R folded before Flop (didn't bet)
Seat 2: lawlex_2 folded before Flop (didn't bet)
Seat 3: FHZ12358 showed [Qc Jd] and won ($1.95) with two pair, Jacks and Deuces
Seat 4: LocoU 10 (button) folded before Flop
Seat 5: Joaquín 74 (small blind) showed [Ac Kh] and lost with a pair of Deuces
Seat 6: Bonch241 (big blind) folded before Flop



PokerStars Hand #213572401014:  Hold'em No Limit ($0.01/$0.02 USD) - 2020/05/09 20:27:28 MSK [2020/05/09 13:27:28 ET]
Table 'Antiphos II' 6-max Seat #5 is the button
Seat 1: HaG1BaT0R ($2.75 in chips) 
Seat 2: lawlex_2 ($3.89 in chips) 
Seat 3: FHZ12358 ($1.95 in chips) 
Seat 4: LocoU 10 ($1.11 in chips) 
Seat 5: Joaquín 74 ($2 in chips) 
Seat 6: Bonch241 ($5.38 in chips) 
Bonch241: posts small blind $0.01
HaG1BaT0R: posts big blind $0.02
*** HOLE CARDS ***
Dealt to lawlex_2 [Js Kd]
lawlex_2: raises $0.04 to $0.06
FHZ12358: folds 
LocoU 10: calls $0.06
Joaquín 74: calls $0.06
Bonch241: folds 
HaG1BaT0R: folds 
*** FLOP *** [7d Qd 6d]
lawlex_2: bets $0.13
LocoU 10: folds 
Joaquín 74: folds 
Uncalled bet ($0.13) returned to lawlex_2
lawlex_2 collected $0.20 from pot
lawlex_2: doesn't show hand 
*** SUMMARY ***
Total pot $0.21 | Rake $0.01 
Board [7d Qd 6d]
Seat 1: HaG1BaT0R (big blind) folded before Flop
Seat 2: lawlex_2 collected ($0.20)
Seat 3: FHZ12358 folded before Flop (didn't bet)
Seat 4: LocoU 10 folded on the Flop
Seat 5: Joaquín 74 (button) folded on the Flop
Seat 6: Bonch241 (small blind) folded before Flop



PokerStars Hand #213572426560:  Hold'em No Limit ($0.01/$0.02 USD) - 2020/05/09 20:27:53 MSK [2020/05/09 13:27:53 ET]
Table 'Antiphos II' 6-max Seat #6 is the button
Seat 1: HaG1BaT0R ($2.73 in chips) 
Seat 2: lawlex_2 ($4.03 in chips) 
Seat 3: FHZ12358 ($1.95 in chips) 
Seat 4: LocoU 10 ($1.05 in chips) 
Seat 5: Joaquín 74 ($2 in chips) 
Seat 6: Bonch241 ($5.37 in chips) 
HaG1BaT0R: posts small blind $0.01
lawlex_2: posts big blind $0.02
*** HOLE CARDS ***
Dealt to lawlex_2 [9h 7d]
FHZ12358: calls $0.02
LocoU 10: folds 
Joaquín 74: folds 
Bonch241: folds 
HaG1BaT0R: folds 
lawlex_2: checks 
*** FLOP *** [6d 4h 2c]
lawlex_2: checks 
FHZ12358: bets $0.03
lawlex_2: folds 
Uncalled bet ($0.03) returned to FHZ12358
Bonch241 leaves the table
FHZ12358 collected $0.05 from pot
FHZ12358: doesn't show hand 
*** SUMMARY ***
Total pot $0.05 | Rake $0 
Board [6d 4h 2c]
Seat 1: HaG1BaT0R (small blind) folded before Flop
Seat 2: lawlex_2 (big blind) folded on the Flop
Seat 3: FHZ12358 collected ($0.05)
Seat 4: LocoU 10 folded before Flop (didn't bet)
Seat 5: Joaquín 74 folded before Flop (didn't bet)
Seat 6: Bonch241 (button) folded before Flop (didn't bet)



PokerStars Hand #213572454050:  Hold'em No Limit ($0.01/$0.02 USD) - 2020/05/09 20:28:20 MSK [2020/05/09 13:28:20 ET]
Table 'Antiphos II' 6-max Seat #1 is the button
Seat 1: HaG1BaT0R ($2.72 in chips) 
Seat 2: lawlex_2 ($4.01 in chips) 
Seat 3: FHZ12358 ($1.98 in chips) 
Seat 4: LocoU 10 ($1.05 in chips) 
Seat 5: Joaquín 74 ($2 in chips) 
lawlex_2: posts small blind $0.01
FHZ12358: posts big blind $0.02
*** HOLE CARDS ***
Dealt to lawlex_2 [Qc Js]
Karbew joins the table at seat #6 
LocoU 10: folds 
Joaquín 74: folds 
HaG1BaT0R: folds 
lawlex_2: raises $0.04 to $0.06
FHZ12358: calls $0.04
*** FLOP *** [Td 5c 6d]
lawlex_2: bets $0.08
FHZ12358: raises $0.08 to $0.16
lawlex_2: folds 
Uncalled bet ($0.08) returned to FHZ12358
FHZ12358 collected $0.27 from pot
FHZ12358: doesn't show hand 
*** SUMMARY ***
Total pot $0.28 | Rake $0.01 
Board [Td 5c 6d]
Seat 1: HaG1BaT0R (button) folded before Flop (didn't bet)
Seat 2: lawlex_2 (small blind) folded on the Flop
Seat 3: FHZ12358 (big blind) collected ($0.27)
Seat 4: LocoU 10 folded before Flop (didn't bet)
Seat 5: Joaquín 74 folded before Flop (didn't bet)



PokerStars Hand #213572485623:  Hold'em No Limit ($0.01/$0.02 USD) - 2020/05/09 20:28:51 MSK [2020/05/09 13:28:51 ET]
Table 'Antiphos II' 6-max Seat #2 is the button
Seat 1: HaG1BaT0R ($2.72 in chips) 
Seat 2: lawlex_2 ($3.87 in chips) 
Seat 3: FHZ12358 ($2.11 in chips) 
Seat 4: LocoU 10 ($1.05 in chips) 
Seat 5: Joaquín 74 ($2 in chips) 
FHZ12358: posts small blind $0.01
LocoU 10: posts big blind $0.02
Karbew: sits out 
*** HOLE CARDS ***
Dealt to lawlex_2 [Qc Qh]
Joaquín 74: folds 
HaG1BaT0R: folds 
lawlex_2: raises $0.04 to $0.06
FHZ12358: folds 
LocoU 10: folds 
Uncalled bet ($0.04) returned to lawlex_2
lawlex_2 collected $0.05 from pot
lawlex_2: doesn't show hand 
*** SUMMARY ***
Total pot $0.05 | Rake $0 
Seat 1: HaG1BaT0R folded before Flop (didn't bet)
Seat 2: lawlex_2 (button) collected ($0.05)
Seat 3: FHZ12358 (small blind) folded before Flop
Seat 4: LocoU 10 (big blind) folded before Flop
Seat 5: Joaquín 74 folded before Flop (didn't bet)



PokerStars Hand #213572503869:  Hold'em No Limit ($0.01/$0.02 USD) - 2020/05/09 20:29:09 MSK [2020/05/09 13:29:09 ET]
Table 'Antiphos II' 6-max Seat #3 is the button
Seat 1: HaG1BaT0R ($2.72 in chips) 
Seat 2: lawlex_2 ($3.90 in chips) 
Seat 3: FHZ12358 ($2.10 in chips) 
Seat 4: LocoU 10 ($1.03 in chips) 
Seat 5: Joaquín 74 ($2 in chips) 
LocoU 10: posts small blind $0.01
Joaquín 74: posts big blind $0.02
Karbew: sits out 
*** HOLE CARDS ***
Dealt to lawlex_2 [6s 7d]
HaG1BaT0R: folds 
lawlex_2: folds 
FHZ12358: folds 
LocoU 10: raises $0.04 to $0.06
Joaquín 74: calls $0.04
*** FLOP *** [Jd Td 3d]
LocoU 10: checks 
Joaquín 74: bets $0.06
LocoU 10: calls $0.06
*** TURN *** [Jd Td 3d] [2s]
LocoU 10: checks 
Joaquín 74: checks 
*** RIVER *** [Jd Td 3d 2s] [8d]
LocoU 10: checks 
Joaquín 74: bets $0.16
LocoU 10: folds 
Uncalled bet ($0.16) returned to Joaquín 74
Joaquín 74 collected $0.23 from pot
Joaquín 74: doesn't show hand 
*** SUMMARY ***
Total pot $0.24 | Rake $0.01 
Board [Jd Td 3d 2s 8d]
Seat 1: HaG1BaT0R folded before Flop (didn't bet)
Seat 2: lawlex_2 folded before Flop (didn't bet)
Seat 3: FHZ12358 (button) folded before Flop (didn't bet)
Seat 4: LocoU 10 (small blind) folded on the River
Seat 5: Joaquín 74 (big blind) collected ($0.23)



PokerStars Hand #213572558039:  Hold'em No Limit ($0.01/$0.02 USD) - 2020/05/09 20:29:59 MSK [2020/05/09 13:29:59 ET]
Table 'Antiphos II' 6-max Seat #4 is the button
Seat 1: HaG1BaT0R ($2.72 in chips) 
Seat 2: lawlex_2 ($3.90 in chips) 
Seat 3: FHZ12358 ($2.10 in chips) 
Seat 4: LocoU 10 ($0.91 in chips) 
Seat 5: Joaquín 74 ($2.11 in chips) 
Seat 6: Karbew ($2 in chips) 
Joaquín 74: posts small blind $0.01
Karbew: posts big blind $0.02
*** HOLE CARDS ***
Dealt to lawlex_2 [As 7c]
HaG1BaT0R: raises $0.04 to $0.06
lawlex_2: folds 
FHZ12358: calls $0.06
LocoU 10: folds 
Joaquín 74: folds 
Karbew: folds 
*** FLOP *** [7h 3c 2s]
HaG1BaT0R: checks 
FHZ12358: checks 
*** TURN *** [7h 3c 2s] [Qd]
HaG1BaT0R: bets $0.08
FHZ12358: calls $0.08
*** RIVER *** [7h 3c 2s Qd] [Qc]
HaG1BaT0R: bets $0.33
FHZ12358: raises $0.33 to $0.66
HaG1BaT0R: folds 
Uncalled bet ($0.33) returned to FHZ12358
FHZ12358 collected $0.94 from pot
FHZ12358: doesn't show hand 
*** SUMMARY ***
Total pot $0.97 | Rake $0.03 
Board [7h 3c 2s Qd Qc]
Seat 1: HaG1BaT0R folded on the River
Seat 2: lawlex_2 folded before Flop (didn't bet)
Seat 3: FHZ12358 collected ($0.94)
Seat 4: LocoU 10 (button) folded before Flop (didn't bet)
Seat 5: Joaquín 74 (small blind) folded before Flop
Seat 6: Karbew (big blind) folded before Flop



PokerStars Hand #213572593686:  Hold'em No Limit ($0.01/$0.02 USD) - 2020/05/09 20:30:33 MSK [2020/05/09 13:30:33 ET]
Table 'Antiphos II' 6-max Seat #5 is the button
Seat 1: HaG1BaT0R ($2.25 in chips) 
Seat 2: lawlex_2 ($3.90 in chips) 
Seat 3: FHZ12358 ($2.57 in chips) 
Seat 4: LocoU 10 ($0.91 in chips) 
Seat 5: Joaquín 74 ($2.10 in chips) 
Seat 6: Karbew ($1.98 in chips) 
Karbew: posts small blind $0.01
HaG1BaT0R: posts big blind $0.02
*** HOLE CARDS ***
Dealt to lawlex_2 [As Ks]
lawlex_2: raises $0.04 to $0.06
FHZ12358: calls $0.06
LocoU 10: folds 
Joaquín 74: folds 
Karbew: folds 
HaG1BaT0R: raises $0.19 to $0.25
lawlex_2: calls $0.19
FHZ12358: calls $0.19
*** FLOP *** [9s Jh 9h]
HaG1BaT0R: bets $0.55
lawlex_2: folds 
FHZ12358: folds 
Uncalled bet ($0.55) returned to HaG1BaT0R
HaG1BaT0R collected $0.73 from pot
HaG1BaT0R: doesn't show hand 
*** SUMMARY ***
Total pot $0.76 | Rake $0.03 
Board [9s Jh 9h]
Seat 1: HaG1BaT0R (big blind) collected ($0.73)
Seat 2: lawlex_2 folded on the Flop
Seat 3: FHZ12358 folded on the Flop
Seat 4: LocoU 10 folded before Flop (didn't bet)
Seat 5: Joaquín 74 (button) folded before Flop (didn't bet)
Seat 6: Karbew (small blind) folded before Flop



PokerStars Hand #213572631678:  Hold'em No Limit ($0.01/$0.02 USD) - 2020/05/09 20:31:10 MSK [2020/05/09 13:31:10 ET]
Table 'Antiphos II' 6-max Seat #6 is the button
Seat 1: HaG1BaT0R ($2.73 in chips) 
Seat 2: lawlex_2 ($3.65 in chips) 
Seat 3: FHZ12358 ($2.32 in chips) 
Seat 4: LocoU 10 ($0.91 in chips) 
Seat 5: Joaquín 74 ($2.10 in chips) 
Seat 6: Karbew ($1.97 in chips) 
HaG1BaT0R: posts small blind $0.01
lawlex_2: posts big blind $0.02
*** HOLE CARDS ***
Dealt to lawlex_2 [2c 2h]
FHZ12358: raises $0.02 to $0.04
LocoU 10: calls $0.04
Joaquín 74: raises $0.08 to $0.12
Karbew: folds 
HaG1BaT0R: raises $0.34 to $0.46
lawlex_2: folds 
FHZ12358: raises $1.86 to $2.32 and is all-in
LocoU 10: folds 
Joaquín 74: folds 
HaG1BaT0R: calls $1.86
*** FLOP *** [Jc 9d Qh]
*** TURN *** [Jc 9d Qh] [4h]
*** RIVER *** [Jc 9d Qh 4h] [6h]
*** SHOW DOWN ***
HaG1BaT0R: shows [Ac Ah] (a pair of Aces)
FHZ12358: shows [Qc As] (a pair of Queens)
HaG1BaT0R collected $4.65 from pot
*** SUMMARY ***
Total pot $4.82 | Rake $0.17 
Board [Jc 9d Qh 4h 6h]
Seat 1: HaG1BaT0R (small blind) showed [Ac Ah] and won ($4.65) with a pair of Aces
Seat 2: lawlex_2 (big blind) folded before Flop
Seat 3: FHZ12358 showed [Qc As] and lost with a pair of Queens
Seat 4: LocoU 10 folded before Flop
Seat 5: Joaquín 74 folded before Flop
Seat 6: Karbew (button) folded before Flop (didn't bet)



PokerStars Hand #213572676675:  Hold'em No Limit ($0.01/$0.02 USD) - 2020/05/09 20:31:53 MSK [2020/05/09 13:31:53 ET]
Table 'Antiphos II' 6-max Seat #1 is the button
Seat 1: HaG1BaT0R ($5.06 in chips) 
Seat 2: lawlex_2 ($3.63 in chips) 
Seat 4: LocoU 10 ($0.87 in chips) 
Seat 5: Joaquín 74 ($2 in chips) 
Seat 6: Karbew ($1.97 in chips) 
lawlex_2: posts small blind $0.01
LocoU 10: posts big blind $0.02
*** HOLE CARDS ***
Dealt to lawlex_2 [9c 9d]
Joaquín 74: folds 
Karbew: folds 
HaG1BaT0R: folds 
lawlex_2: raises $0.04 to $0.06
LocoU 10: calls $0.04
*** FLOP *** [Tc Ah 3h]
lawlex_2: bets $0.08
LocoU 10: folds 
Uncalled bet ($0.08) returned to lawlex_2
lawlex_2 collected $0.12 from pot
lawlex_2: doesn't show hand 
*** SUMMARY ***
Total pot $0.12 | Rake $0 
Board [Tc Ah 3h]
Seat 1: HaG1BaT0R (button) folded before Flop (didn't bet)
Seat 2: lawlex_2 (small blind) collected ($0.12)
Seat 4: LocoU 10 (big blind) folded on the Flop
Seat 5: Joaquín 74 folded before Flop (didn't bet)
Seat 6: Karbew folded before Flop (didn't bet)



PokerStars Hand #213572707385:  Hold'em No Limit ($0.01/$0.02 USD) - 2020/05/09 20:32:22 MSK [2020/05/09 13:32:22 ET]
Table 'Antiphos II' 6-max Seat #2 is the button
Seat 1: HaG1BaT0R ($5.06 in chips) 
Seat 2: lawlex_2 ($3.69 in chips) 
Seat 4: LocoU 10 ($0.81 in chips) 
Seat 5: Joaquín 74 ($2 in chips) 
Seat 6: Karbew ($1.97 in chips) 
LocoU 10: posts small blind $0.01
Joaquín 74: posts big blind $0.02
*** HOLE CARDS ***
Dealt to lawlex_2 [5s 2s]
Karbew: raises $0.04 to $0.06
HaG1BaT0R: folds 
lawlex_2: folds 
LocoU 10: folds 
Joaquín 74: folds 
Uncalled bet ($0.04) returned to Karbew
Joaquín 74 leaves the table
Karbew collected $0.05 from pot
*** SUMMARY ***
Total pot $0.05 | Rake $0 
Seat 1: HaG1BaT0R folded before Flop (didn't bet)
Seat 2: lawlex_2 (button) folded before Flop (didn't bet)
Seat 4: LocoU 10 (small blind) folded before Flop
Seat 5: Joaquín 74 (big blind) folded before Flop
Seat 6: Karbew collected ($0.05)



PokerStars Hand #213572726997:  Hold'em No Limit ($0.01/$0.02 USD) - 2020/05/09 20:32:41 MSK [2020/05/09 13:32:41 ET]
Table 'Antiphos II' 6-max Seat #4 is the button
Seat 1: HaG1BaT0R ($5.06 in chips) 
Seat 2: lawlex_2 ($3.69 in chips) 
Seat 4: LocoU 10 ($0.80 in chips) 
Seat 6: Karbew ($2 in chips) 
Karbew: posts small blind $0.01
HaG1BaT0R: posts big blind $0.02
*** HOLE CARDS ***
Dealt to lawlex_2 [8s 9h]
lawlex_2: folds 
LocoU 10: calls $0.02
Karbew: folds 
FUWI joins the table at seat #5 
HaG1BaT0R: raises $0.05 to $0.07
LocoU 10: calls $0.05
*** FLOP *** [Ac 7c Ts]
HaG1BaT0R: bets $0.08
LocoU 10: folds 
Uncalled bet ($0.08) returned to HaG1BaT0R
HaG1BaT0R collected $0.14 from pot
HaG1BaT0R: doesn't show hand 
*** SUMMARY ***
Total pot $0.15 | Rake $0.01 
Board [Ac 7c Ts]
Seat 1: HaG1BaT0R (big blind) collected ($0.14)
Seat 2: lawlex_2 folded before Flop (didn't bet)
Seat 4: LocoU 10 (button) folded on the Flop
Seat 6: Karbew (small blind) folded before Flop



PokerStars Hand #213572764336:  Hold'em No Limit ($0.01/$0.02 USD) - 2020/05/09 20:33:16 MSK [2020/05/09 13:33:16 ET]
Table 'Antiphos II' 6-max Seat #6 is the button
Seat 1: HaG1BaT0R ($5.13 in chips) 
Seat 2: lawlex_2 ($3.69 in chips) 
Seat 4: LocoU 10 ($0.73 in chips) 
Seat 5: FUWI ($1.60 in chips) 
Seat 6: Karbew ($1.99 in chips) 
HaG1BaT0R: posts small blind $0.01
lawlex_2: posts big blind $0.02
FUWI: posts big blind $0.02
*** HOLE CARDS ***
Dealt to lawlex_2 [Jd Ad]
LocoU 10: calls $0.02
FUWI: checks 
Karbew: folds 
FHZ12358 leaves the table
HaG1BaT0R: raises $0.04 to $0.06
lawlex_2: calls $0.04
LocoU 10: calls $0.04
FUWI: folds 
*** FLOP *** [9h 2h 4d]
bello4820 joins the table at seat #3 
HaG1BaT0R: checks 
lawlex_2: checks 
LocoU 10: checks 
*** TURN *** [9h 2h 4d] [Kh]
HaG1BaT0R: bets $0.10
lawlex_2: calls $0.10
LocoU 10: folds 
*** RIVER *** [9h 2h 4d Kh] [7s]
HaG1BaT0R: bets $0.14
lawlex_2: folds 
Uncalled bet ($0.14) returned to HaG1BaT0R
HaG1BaT0R collected $0.39 from pot
HaG1BaT0R: doesn't show hand 
*** SUMMARY ***
Total pot $0.40 | Rake $0.01 
Board [9h 2h 4d Kh 7s]
Seat 1: HaG1BaT0R (small blind) collected ($0.39)
Seat 2: lawlex_2 (big blind) folded on the River
Seat 4: LocoU 10 folded on the Turn
Seat 5: FUWI folded before Flop (didn't bet)
Seat 6: Karbew (button) folded before Flop (didn't bet)



PokerStars Hand #213572816303:  Hold'em No Limit ($0.01/$0.02 USD) - 2020/05/09 20:34:06 MSK [2020/05/09 13:34:06 ET]
Table 'Antiphos II' 6-max Seat #1 is the button
Seat 1: HaG1BaT0R ($5.36 in chips) 
Seat 2: lawlex_2 ($3.53 in chips) 
Seat 3: bello4820 ($1.60 in chips) 
Seat 4: LocoU 10 ($0.67 in chips) 
Seat 5: FUWI ($1.58 in chips) 
Seat 6: Karbew ($1.99 in chips) 
lawlex_2: posts small blind $0.01
bello4820: posts big blind $0.02
*** HOLE CARDS ***
Dealt to lawlex_2 [Kc 8c]
LocoU 10: folds 
FUWI: folds 
Karbew: folds 
HaG1BaT0R: raises $0.04 to $0.06
lawlex_2: calls $0.05
bello4820: folds 
*** FLOP *** [4h Js 3h]
lawlex_2: checks 
HaG1BaT0R: checks 
*** TURN *** [4h Js 3h] [2s]
lawlex_2: bets $0.09
HaG1BaT0R: folds 
Uncalled bet ($0.09) returned to lawlex_2
lawlex_2 collected $0.14 from pot
lawlex_2: doesn't show hand 
*** SUMMARY ***
Total pot $0.14 | Rake $0 
Board [4h Js 3h 2s]
Seat 1: HaG1BaT0R (button) folded on the Turn
Seat 2: lawlex_2 (small blind) collected ($0.14)
Seat 3: bello4820 (big blind) folded before Flop
Seat 4: LocoU 10 folded before Flop (didn't bet)
Seat 5: FUWI folded before Flop (didn't bet)
Seat 6: Karbew folded before Flop (didn't bet)



PokerStars Hand #213572851580:  Hold'em No Limit ($0.01/$0.02 USD) - 2020/05/09 20:34:40 MSK [2020/05/09 13:34:40 ET]
Table 'Antiphos II' 6-max Seat #2 is the button
Seat 1: HaG1BaT0R ($5.30 in chips) 
Seat 2: lawlex_2 ($3.61 in chips) 
Seat 3: bello4820 ($1.58 in chips) 
Seat 4: LocoU 10 ($0.67 in chips) 
Seat 5: FUWI ($1.58 in chips) 
Seat 6: Karbew ($1.99 in chips) 
bello4820: posts small blind $0.01
LocoU 10: posts big blind $0.02
*** HOLE CARDS ***
Dealt to lawlex_2 [Tc 4d]
FUWI: raises $0.02 to $0.04
Karbew: folds 
HaG1BaT0R: folds 
lawlex_2: folds 
bello4820: raises $0.02 to $0.06
LocoU 10: folds 
FUWI: calls $0.02
*** FLOP *** [3h Td 9s]
bello4820: bets $0.07
FUWI: calls $0.07
*** TURN *** [3h Td 9s] [7c]
bello4820: bets $0.14
FUWI: calls $0.14
*** RIVER *** [3h Td 9s 7c] [7h]
bello4820: checks 
FUWI: bets $1.31 and is all-in
bello4820: folds 
Uncalled bet ($1.31) returned to FUWI
FUWI collected $0.54 from pot
FUWI: doesn't show hand 
*** SUMMARY ***
Total pot $0.56 | Rake $0.02 
Board [3h Td 9s 7c 7h]
Seat 1: HaG1BaT0R folded before Flop (didn't bet)
Seat 2: lawlex_2 (button) folded before Flop (didn't bet)
Seat 3: bello4820 (small blind) folded on the River
Seat 4: LocoU 10 (big blind) folded before Flop
Seat 5: FUWI collected ($0.54)
Seat 6: Karbew folded before Flop (didn't bet)



PokerStars Hand #213572909985:  Hold'em No Limit ($0.01/$0.02 USD) - 2020/05/09 20:35:31 MSK [2020/05/09 13:35:31 ET]
Table 'Antiphos II' 6-max Seat #3 is the button
Seat 1: HaG1BaT0R ($5.30 in chips) 
Seat 2: lawlex_2 ($3.61 in chips) 
Seat 3: bello4820 ($1.31 in chips) 
Seat 4: LocoU 10 ($0.65 in chips) 
Seat 5: FUWI ($1.85 in chips) 
Seat 6: Karbew ($1.99 in chips) 
LocoU 10: posts small blind $0.01
FUWI: posts big blind $0.02
*** HOLE CARDS ***
Dealt to lawlex_2 [Kd 7d]
Karbew: folds 
HaG1BaT0R: folds 
lawlex_2: raises $0.04 to $0.06
bello4820: folds 
LocoU 10: calls $0.05
FUWI: raises $0.18 to $0.24
lawlex_2: folds 
LocoU 10: calls $0.18
*** FLOP *** [Ks 9c Jh]
LocoU 10: checks 
FUWI: bets $1.61 and is all-in
LocoU 10: folds 
Uncalled bet ($1.61) returned to FUWI
FUWI collected $0.52 from pot
FUWI: doesn't show hand 
*** SUMMARY ***
Total pot $0.54 | Rake $0.02 
Board [Ks 9c Jh]
Seat 1: HaG1BaT0R folded before Flop (didn't bet)
Seat 2: lawlex_2 folded before Flop
Seat 3: bello4820 (button) folded before Flop (didn't bet)
Seat 4: LocoU 10 (small blind) folded on the Flop
Seat 5: FUWI (big blind) collected ($0.52)
Seat 6: Karbew folded before Flop (didn't bet)



PokerStars Hand #213572952880:  Hold'em No Limit ($0.01/$0.02 USD) - 2020/05/09 20:36:12 MSK [2020/05/09 13:36:12 ET]
Table 'Antiphos II' 6-max Seat #4 is the button
Seat 1: HaG1BaT0R ($5.30 in chips) 
Seat 2: lawlex_2 ($3.55 in chips) 
Seat 3: bello4820 ($1.31 in chips) 
Seat 4: LocoU 10 ($0.41 in chips) 
Seat 5: FUWI ($2.13 in chips) 
Seat 6: Karbew ($1.99 in chips) 
FUWI: posts small blind $0.01
Karbew: posts big blind $0.02
*** HOLE CARDS ***
Dealt to lawlex_2 [Jd Qh]
HaG1BaT0R: folds 
lawlex_2: raises $0.04 to $0.06
bello4820: folds 
LocoU 10: folds 
FUWI: folds 
Karbew: folds 
Uncalled bet ($0.04) returned to lawlex_2
lawlex_2 collected $0.05 from pot
lawlex_2: doesn't show hand 
*** SUMMARY ***
Total pot $0.05 | Rake $0 
Seat 1: HaG1BaT0R folded before Flop (didn't bet)
Seat 2: lawlex_2 collected ($0.05)
Seat 3: bello4820 folded before Flop (didn't bet)
Seat 4: LocoU 10 (button) folded before Flop (didn't bet)
Seat 5: FUWI (small blind) folded before Flop
Seat 6: Karbew (big blind) folded before Flop



PokerStars Hand #213572967603:  Hold'em No Limit ($0.01/$0.02 USD) - 2020/05/09 20:36:26 MSK [2020/05/09 13:36:26 ET]
Table 'Antiphos II' 6-max Seat #5 is the button
Seat 1: HaG1BaT0R ($5.30 in chips) 
Seat 2: lawlex_2 ($3.58 in chips) 
Seat 3: bello4820 ($1.31 in chips) 
Seat 4: LocoU 10 ($0.41 in chips) 
Seat 5: FUWI ($2.12 in chips) 
Seat 6: Karbew ($1.97 in chips) 
Karbew: posts small blind $0.01
HaG1BaT0R: posts big blind $0.02
*** HOLE CARDS ***
Dealt to lawlex_2 [7h 2h]
lawlex_2: folds 
bello4820 has timed out
bello4820: folds 
LocoU 10: folds 
FUWI: folds 
Karbew: folds 
Uncalled bet ($0.01) returned to HaG1BaT0R
HaG1BaT0R collected $0.02 from pot
HaG1BaT0R: doesn't show hand 
*** SUMMARY ***
Total pot $0.02 | Rake $0 
Seat 1: HaG1BaT0R (big blind) collected ($0.02)
Seat 2: lawlex_2 folded before Flop (didn't bet)
Seat 3: bello4820 folded before Flop (didn't bet)
Seat 4: LocoU 10 folded before Flop (didn't bet)
Seat 5: FUWI (button) folded before Flop (didn't bet)
Seat 6: Karbew (small blind) folded before Flop



PokerStars Hand #213572995939:  Hold'em No Limit ($0.01/$0.02 USD) - 2020/05/09 20:36:53 MSK [2020/05/09 13:36:53 ET]
Table 'Antiphos II' 6-max Seat #6 is the button
Seat 1: HaG1BaT0R ($5.31 in chips) 
Seat 2: lawlex_2 ($3.58 in chips) 
Seat 4: LocoU 10 ($0.41 in chips) 
Seat 5: FUWI ($2.12 in chips) 
Seat 6: Karbew ($1.96 in chips) 
HaG1BaT0R: posts small blind $0.01
lawlex_2: posts big blind $0.02
*** HOLE CARDS ***
Dealt to lawlex_2 [3h Kc]
LocoU 10: calls $0.02
FUWI: calls $0.02
Karbew: folds 
HaG1BaT0R: folds 
lawlex_2: checks 
*** FLOP *** [Ac 9d Js]
lawlex_2: checks 
LocoU 10: checks 
FUWI: checks 
*** TURN *** [Ac 9d Js] [7h]
lawlex_2: checks 
LocoU 10: checks 
FUWI: checks 
*** RIVER *** [Ac 9d Js 7h] [Ah]
lawlex_2: checks 
LocoU 10: checks 
FUWI: checks 
*** SHOW DOWN ***
lawlex_2: shows [3h Kc] (a pair of Aces)
LocoU 10: shows [7d Qc] (two pair, Aces and Sevens)
FUWI: mucks hand 
LocoU 10 collected $0.07 from pot
*** SUMMARY ***
Total pot $0.07 | Rake $0 
Board [Ac 9d Js 7h Ah]
Seat 1: HaG1BaT0R (small blind) folded before Flop
Seat 2: lawlex_2 (big blind) showed [3h Kc] and lost with a pair of Aces
Seat 4: LocoU 10 showed [7d Qc] and won ($0.07) with two pair, Aces and Sevens
Seat 5: FUWI mucked [3d 3s]
Seat 6: Karbew (button) folded before Flop (didn't bet)



PokerStars Hand #213573029959:  Hold'em No Limit ($0.01/$0.02 USD) - 2020/05/09 20:37:25 MSK [2020/05/09 13:37:25 ET]
Table 'Antiphos II' 6-max Seat #1 is the button
Seat 1: HaG1BaT0R ($5.30 in chips) 
Seat 2: lawlex_2 ($3.56 in chips) 
Seat 3: bello4820 ($1.31 in chips) 
Seat 4: LocoU 10 ($0.46 in chips) 
Seat 6: Karbew ($1.96 in chips) 
lawlex_2: posts small blind $0.01
bello4820: posts big blind $0.02
*** HOLE CARDS ***
Dealt to lawlex_2 [Tc 4h]
LocoU 10: calls $0.02
Karbew: folds 
HaG1BaT0R: raises $0.04 to $0.06
lawlex_2: folds 
bello4820: raises $1.25 to $1.31 and is all-in
LocoU 10: folds 
HaG1BaT0R: folds 
Uncalled bet ($1.25) returned to bello4820
bello4820 collected $0.15 from pot
*** SUMMARY ***
Total pot $0.15 | Rake $0 
Seat 1: HaG1BaT0R (button) folded before Flop
Seat 2: lawlex_2 (small blind) folded before Flop
Seat 3: bello4820 (big blind) collected ($0.15)
Seat 4: LocoU 10 folded before Flop
Seat 6: Karbew folded before Flop (didn't bet)



PokerStars Hand #213573056931:  Hold'em No Limit ($0.01/$0.02 USD) - 2020/05/09 20:37:51 MSK [2020/05/09 13:37:51 ET]
Table 'Antiphos II' 6-max Seat #2 is the button
Seat 1: HaG1BaT0R ($5.24 in chips) 
Seat 2: lawlex_2 ($3.55 in chips) 
Seat 3: bello4820 ($1.40 in chips) 
Seat 4: LocoU 10 ($0.44 in chips) 
Seat 6: Karbew ($1.96 in chips) 
bello4820: posts small blind $0.01
LocoU 10: posts big blind $0.02
*** HOLE CARDS ***
Dealt to lawlex_2 [As 5h]
Karbew: folds 
HaG1BaT0R: raises $0.04 to $0.06
lawlex_2: folds 
bello4820: folds 
FUWI leaves the table
LocoU 10: calls $0.04
*** FLOP *** [Tc 6c 2d]
LocoU 10: checks 
HaG1BaT0R: checks 
*** TURN *** [Tc 6c 2d] [6s]
LocoU 10: checks 
HaG1BaT0R: bets $0.10
LocoU 10: folds 
Uncalled bet ($0.10) returned to HaG1BaT0R
HaG1BaT0R collected $0.13 from pot
HaG1BaT0R: doesn't show hand 
*** SUMMARY ***
Total pot $0.13 | Rake $0 
Board [Tc 6c 2d 6s]
Seat 1: HaG1BaT0R collected ($0.13)
Seat 2: lawlex_2 (button) folded before Flop (didn't bet)
Seat 3: bello4820 (small blind) folded before Flop
Seat 4: LocoU 10 (big blind) folded on the Turn
Seat 6: Karbew folded before Flop (didn't bet)



PokerStars Hand #213573098990:  Hold'em No Limit ($0.01/$0.02 USD) - 2020/05/09 20:38:31 MSK [2020/05/09 13:38:31 ET]
Table 'Antiphos II' 6-max Seat #3 is the button
Seat 1: HaG1BaT0R ($5.31 in chips) 
Seat 2: lawlex_2 ($3.55 in chips) 
Seat 3: bello4820 ($1.39 in chips) 
Seat 4: LocoU 10 ($0.38 in chips) 
Seat 6: Karbew ($1.96 in chips) 
LocoU 10: posts small blind $0.01
Karbew: posts big blind $0.02
*** HOLE CARDS ***
Dealt to lawlex_2 [Jh 3c]
HaG1BaT0R: folds 
lawlex_2: folds 
bello4820: calls $0.02
LocoU 10: calls $0.01
Karbew: checks 
*** FLOP *** [Td Kd 5h]
LocoU 10: bets $0.36 and is all-in
Karbew: folds 
bello4820: calls $0.36
*** TURN *** [Td Kd 5h] [2h]
*** RIVER *** [Td Kd 5h 2h] [Tc]
*** SHOW DOWN ***
LocoU 10: shows [Ks 8c] (two pair, Kings and Tens)
bello4820: shows [4d Kh] (two pair, Kings and Tens - lower kicker)
LocoU 10 collected $0.75 from pot
*** SUMMARY ***
Total pot $0.78 | Rake $0.03 
Board [Td Kd 5h 2h Tc]
Seat 1: HaG1BaT0R folded before Flop (didn't bet)
Seat 2: lawlex_2 folded before Flop (didn't bet)
Seat 3: bello4820 (button) showed [4d Kh] and lost with two pair, Kings and Tens
Seat 4: LocoU 10 (small blind) showed [Ks 8c] and won ($0.75) with two pair, Kings and Tens
Seat 6: Karbew (big blind) folded on the Flop



PokerStars Hand #213573132286:  Hold'em No Limit ($0.01/$0.02 USD) - 2020/05/09 20:39:02 MSK [2020/05/09 13:39:02 ET]
Table 'Antiphos II' 6-max Seat #4 is the button
Seat 1: HaG1BaT0R ($5.31 in chips) 
Seat 2: lawlex_2 ($3.55 in chips) 
Seat 3: bello4820 ($1.01 in chips) 
Seat 4: LocoU 10 ($0.75 in chips) 
Seat 6: Karbew ($1.94 in chips) 
Karbew: posts small blind $0.01
HaG1BaT0R: posts big blind $0.02
*** HOLE CARDS ***
Dealt to lawlex_2 [5s Tc]
Piet-1503 joins the table at seat #5 
lawlex_2: folds 
bello4820: folds 
LocoU 10: folds 
Karbew: folds 
Uncalled bet ($0.01) returned to HaG1BaT0R
HaG1BaT0R collected $0.02 from pot
HaG1BaT0R: doesn't show hand 
*** SUMMARY ***
Total pot $0.02 | Rake $0 
Seat 1: HaG1BaT0R (big blind) collected ($0.02)
Seat 2: lawlex_2 folded before Flop (didn't bet)
Seat 3: bello4820 folded before Flop (didn't bet)
Seat 4: LocoU 10 (button) folded before Flop (didn't bet)
Seat 6: Karbew (small blind) folded before Flop



PokerStars Hand #213573144354:  Hold'em No Limit ($0.01/$0.02 USD) - 2020/05/09 20:39:14 MSK [2020/05/09 13:39:14 ET]
Table 'Antiphos II' 6-max Seat #6 is the button
Seat 1: HaG1BaT0R ($5.32 in chips) 
Seat 2: lawlex_2 ($3.55 in chips) 
Seat 3: bello4820 ($1.01 in chips) 
Seat 4: LocoU 10 ($0.75 in chips) 
Seat 6: Karbew ($1.93 in chips) 
HaG1BaT0R: posts small blind $0.01
lawlex_2: posts big blind $0.02
Piet-1503: sits out 
*** HOLE CARDS ***
Dealt to lawlex_2 [Ks Jh]
bello4820: folds 
LocoU 10: calls $0.02
Karbew: folds 
HaG1BaT0R: raises $0.04 to $0.06
lawlex_2: calls $0.04
LocoU 10: calls $0.04
*** FLOP *** [2c 5s 8d]
HaG1BaT0R: bets $0.09
lawlex_2: folds 
LocoU 10: calls $0.09
*** TURN *** [2c 5s 8d] [Jd]
HaG1BaT0R: checks 
LocoU 10: bets $0.06
HaG1BaT0R: calls $0.06
*** RIVER *** [2c 5s 8d Jd] [4s]
HaG1BaT0R: bets $0.51
LocoU 10: raises $0.03 to $0.54 and is all-in
HaG1BaT0R: calls $0.03
*** SHOW DOWN ***
LocoU 10: shows [3s Ad] (a straight, Ace to Five)
HaG1BaT0R: shows [3h As] (a straight, Ace to Five)
HaG1BaT0R collected $0.76 from pot
LocoU 10 collected $0.75 from pot
*** SUMMARY ***
Total pot $1.56 | Rake $0.05 
Board [2c 5s 8d Jd 4s]
Seat 1: HaG1BaT0R (small blind) showed [3h As] and won ($0.76) with a straight, Ace to Five
Seat 2: lawlex_2 (big blind) folded on the Flop
Seat 3: bello4820 folded before Flop (didn't bet)
Seat 4: LocoU 10 showed [3s Ad] and won ($0.75) with a straight, Ace to Five
Seat 6: Karbew (button) folded before Flop (didn't bet)



PokerStars Hand #213573203513:  Hold'em No Limit ($0.01/$0.02 USD) - 2020/05/09 20:40:10 MSK [2020/05/09 13:40:10 ET]
Table 'Antiphos II' 6-max Seat #1 is the button
Seat 1: HaG1BaT0R ($5.33 in chips) 
Seat 2: lawlex_2 ($3.49 in chips) 
Seat 3: bello4820 ($1.01 in chips) 
Seat 4: LocoU 10 ($0.75 in chips) 
Seat 5: Piet-1503 ($2 in chips) 
Seat 6: Karbew ($1.93 in chips) 
lawlex_2: posts small blind $0.01
bello4820: posts big blind $0.02
Piet-1503: posts big blind $0.02
*** HOLE CARDS ***
Dealt to lawlex_2 [Ac Ks]
LocoU 10: folds 
Piet-1503: checks 
Karbew: folds 
HaG1BaT0R: folds 
lawlex_2: raises $0.04 to $0.06
bello4820: raises $0.04 to $0.10
Piet-1503: calls $0.08
lawlex_2: calls $0.04
*** FLOP *** [2s 3h Th]
lawlex_2: checks 
bello4820: bets $0.15
Piet-1503: calls $0.15
lawlex_2: calls $0.15
*** TURN *** [2s 3h Th] [Jd]
lawlex_2: checks 
bello4820: checks 
Piet-1503: checks 
*** RIVER *** [2s 3h Th Jd] [9c]
lawlex_2: checks 
bello4820: bets $0.02
Piet-1503: folds 
lawlex_2: raises $0.20 to $0.22
bello4820: calls $0.20
*** SHOW DOWN ***
lawlex_2: shows [Ac Ks] (high card Ace)
bello4820: shows [Jc Td] (two pair, Jacks and Tens)
bello4820 collected $1.15 from pot
*** SUMMARY ***
Total pot $1.19 | Rake $0.04 
Board [2s 3h Th Jd 9c]
Seat 1: HaG1BaT0R (button) folded before Flop (didn't bet)
Seat 2: lawlex_2 (small blind) showed [Ac Ks] and lost with high card Ace
Seat 3: bello4820 (big blind) showed [Jc Td] and won ($1.15) with two pair, Jacks and Tens
Seat 4: LocoU 10 folded before Flop (didn't bet)
Seat 5: Piet-1503 folded on the River
Seat 6: Karbew folded before Flop (didn't bet)



PokerStars Hand #213573280063:  Hold'em No Limit ($0.01/$0.02 USD) - 2020/05/09 20:41:15 MSK [2020/05/09 13:41:15 ET]
Table 'Antiphos II' 6-max Seat #2 is the button
Seat 1: HaG1BaT0R ($5.33 in chips) 
Seat 2: lawlex_2 ($3.02 in chips) 
Seat 3: bello4820 ($1.69 in chips) 
Seat 4: LocoU 10 ($0.75 in chips) 
Seat 5: Piet-1503 ($2 in chips) 
Seat 6: Karbew ($1.93 in chips) 
bello4820: posts small blind $0.01
LocoU 10: posts big blind $0.02
*** HOLE CARDS ***
Dealt to lawlex_2 [Js Ac]
Piet-1503: folds 
Karbew: folds 
HaG1BaT0R: folds 
lawlex_2: raises $0.04 to $0.06
bello4820: folds 
LocoU 10: folds 
Uncalled bet ($0.04) returned to lawlex_2
lawlex_2 collected $0.05 from pot
lawlex_2: doesn't show hand 
*** SUMMARY ***
Total pot $0.05 | Rake $0 
Seat 1: HaG1BaT0R folded before Flop (didn't bet)
Seat 2: lawlex_2 (button) collected ($0.05)
Seat 3: bello4820 (small blind) folded before Flop
Seat 4: LocoU 10 (big blind) folded before Flop
Seat 5: Piet-1503 folded before Flop (didn't bet)
Seat 6: Karbew folded before Flop (didn't bet)



PokerStars Hand #213573292570:  Hold'em No Limit ($0.01/$0.02 USD) - 2020/05/09 20:41:27 MSK [2020/05/09 13:41:27 ET]
Table 'Antiphos II' 6-max Seat #3 is the button
Seat 1: HaG1BaT0R ($5.33 in chips) 
Seat 2: lawlex_2 ($3.05 in chips) 
Seat 3: bello4820 ($1.68 in chips) 
Seat 4: LocoU 10 ($0.73 in chips) 
Seat 5: Piet-1503 ($2 in chips) 
Seat 6: Karbew ($1.93 in chips) 
LocoU 10: posts small blind $0.01
Piet-1503: posts big blind $0.02
*** HOLE CARDS ***
Dealt to lawlex_2 [8c 6s]
Karbew: folds 
HaG1BaT0R: folds 
lawlex_2: folds 
bello4820: calls $0.02
LocoU 10: raises $0.06 to $0.08
Piet-1503: calls $0.06
bello4820: calls $0.06
*** FLOP *** [9d 3c 8d]
LocoU 10: checks 
Piet-1503: checks 
bello4820: checks 
*** TURN *** [9d 3c 8d] [7h]
LocoU 10: bets $0.08
Piet-1503: calls $0.08
bello4820: calls $0.08
*** RIVER *** [9d 3c 8d 7h] [2c]
LocoU 10: checks 
Piet-1503: checks 
bello4820: bets $0.23
LocoU 10: folds 
Piet-1503: folds 
Uncalled bet ($0.23) returned to bello4820
bello4820 collected $0.46 from pot
*** SUMMARY ***
Total pot $0.48 | Rake $0.02 
Board [9d 3c 8d 7h 2c]
Seat 1: HaG1BaT0R folded before Flop (didn't bet)
Seat 2: lawlex_2 folded before Flop (didn't bet)
Seat 3: bello4820 (button) collected ($0.46)
Seat 4: LocoU 10 (small blind) folded on the River
Seat 5: Piet-1503 (big blind) folded on the River
Seat 6: Karbew folded before Flop (didn't bet)



PokerStars Hand #213573362737:  Hold'em No Limit ($0.01/$0.02 USD) - 2020/05/09 20:42:29 MSK [2020/05/09 13:42:29 ET]
Table 'Antiphos II' 6-max Seat #4 is the button
Seat 1: HaG1BaT0R ($5.33 in chips) 
Seat 2: lawlex_2 ($3.05 in chips) 
Seat 3: bello4820 ($1.98 in chips) 
Seat 4: LocoU 10 ($0.57 in chips) 
Seat 5: Piet-1503 ($2 in chips) 
Seat 6: Karbew ($1.93 in chips) 
Piet-1503: posts small blind $0.01
Karbew: posts big blind $0.02
*** HOLE CARDS ***
Dealt to lawlex_2 [2h Ad]
HaG1BaT0R: folds 
lawlex_2: raises $0.04 to $0.06
bello4820: calls $0.06
LocoU 10: calls $0.06
Piet-1503: calls $0.05
Karbew: raises $0.14 to $0.20
lawlex_2: folds 
bello4820: calls $0.14
LocoU 10: calls $0.14
Piet-1503: calls $0.14
*** FLOP *** [5s Kc Tc]
Piet-1503: checks 
Karbew: checks 
bello4820: bets $0.20
LocoU 10: raises $0.17 to $0.37 and is all-in
Piet-1503: calls $0.37
Karbew: folds 
bello4820: calls $0.17
*** TURN *** [5s Kc Tc] [Jh]
Piet-1503: checks 
bello4820: bets $0.20
Piet-1503: calls $0.20
*** RIVER *** [5s Kc Tc Jh] [Kd]
Piet-1503: checks 
bello4820: checks 
*** SHOW DOWN ***
Piet-1503: shows [Jd 9h] (two pair, Kings and Jacks)
bello4820: mucks hand 
Piet-1503 collected $0.39 from side pot
LocoU 10: shows [6h Kh] (three of a kind, Kings)
LocoU 10 collected $1.90 from main pot
*** SUMMARY ***
Total pot $2.37 Main pot $1.90. Side pot $0.39. | Rake $0.08 
Board [5s Kc Tc Jh Kd]
Seat 1: HaG1BaT0R folded before Flop (didn't bet)
Seat 2: lawlex_2 folded before Flop
Seat 3: bello4820 mucked [Qc 5c]
Seat 4: LocoU 10 (button) showed [6h Kh] and won ($1.90) with three of a kind, Kings
Seat 5: Piet-1503 (small blind) showed [Jd 9h] and won ($0.39) with two pair, Kings and Jacks
Seat 6: Karbew (big blind) folded on the Flop



PokerStars Hand #213573440152:  Hold'em No Limit ($0.01/$0.02 USD) - 2020/05/09 20:43:42 MSK [2020/05/09 13:43:42 ET]
Table 'Antiphos II' 6-max Seat #5 is the button
Seat 1: HaG1BaT0R ($5.33 in chips) 
Seat 2: lawlex_2 ($2.99 in chips) 
Seat 3: bello4820 ($1.21 in chips) 
Seat 4: LocoU 10 ($1.90 in chips) 
Seat 5: Piet-1503 ($2 in chips) 
Seat 6: Karbew ($1.73 in chips) 
Karbew: posts small blind $0.01
HaG1BaT0R: posts big blind $0.02
*** HOLE CARDS ***
Dealt to lawlex_2 [Jc Td]
lawlex_2: raises $0.04 to $0.06
bello4820: calls $0.06
LocoU 10: folds 
Piet-1503: calls $0.06
Karbew: folds 
HaG1BaT0R: folds 
*** FLOP *** [Kc 9d 6h]
lawlex_2: bets $0.13
bello4820: folds 
Piet-1503: calls $0.13
*** TURN *** [Kc 9d 6h] [2s]
lawlex_2: checks 
Piet-1503: checks 
*** RIVER *** [Kc 9d 6h 2s] [3d]
lawlex_2: checks 
Piet-1503: checks 
*** SHOW DOWN ***
lawlex_2: shows [Jc Td] (high card King)
Piet-1503: shows [Qc Jh] (high card King - Queen kicker)
Piet-1503 collected $0.45 from pot
*** SUMMARY ***
Total pot $0.47 | Rake $0.02 
Board [Kc 9d 6h 2s 3d]
Seat 1: HaG1BaT0R (big blind) folded before Flop
Seat 2: lawlex_2 showed [Jc Td] and lost with high card King
Seat 3: bello4820 folded on the Flop
Seat 4: LocoU 10 folded before Flop (didn't bet)
Seat 5: Piet-1503 (button) showed [Qc Jh] and won ($0.45) with high card King
Seat 6: Karbew (small blind) folded before Flop



PokerStars Hand #213573479079:  Hold'em No Limit ($0.01/$0.02 USD) - 2020/05/09 20:44:18 MSK [2020/05/09 13:44:18 ET]
Table 'Antiphos II' 6-max Seat #6 is the button
Seat 1: HaG1BaT0R ($5.31 in chips) 
Seat 2: lawlex_2 ($2.80 in chips) 
Seat 3: bello4820 ($1.15 in chips) 
Seat 4: LocoU 10 ($1.90 in chips) 
Seat 5: Piet-1503 ($2.26 in chips) 
Seat 6: Karbew ($1.72 in chips) 
HaG1BaT0R: posts small blind $0.01
lawlex_2: posts big blind $0.02
*** HOLE CARDS ***
Dealt to lawlex_2 [Ah Kd]
bello4820: folds 
LocoU 10: folds 
Piet-1503: calls $0.02
Karbew: raises $0.06 to $0.08
HaG1BaT0R: folds 
lawlex_2: calls $0.06
Piet-1503: calls $0.06
*** FLOP *** [Tc 5h Qh]
lawlex_2: bets $0.16
Piet-1503: folds 
Karbew: raises $0.28 to $0.44
lawlex_2: calls $0.28
*** TURN *** [Tc 5h Qh] [As]
lawlex_2: bets $0.73
Karbew: raises $0.47 to $1.20 and is all-in
lawlex_2: calls $0.47
*** RIVER *** [Tc 5h Qh As] [9c]
*** SHOW DOWN ***
lawlex_2: shows [Ah Kd] (a pair of Aces)
Karbew: shows [Qc Ac] (two pair, Aces and Queens)
Karbew cashed out the hand for $2.83 | Cash Out Fee $0.03
*** SUMMARY ***
Total pot $3.53 | Rake $0.12 
Board [Tc 5h Qh As 9c]
Seat 1: HaG1BaT0R (small blind) folded before Flop
Seat 2: lawlex_2 (big blind) showed [Ah Kd] and lost with a pair of Aces
Seat 3: bello4820 folded before Flop (didn't bet)
Seat 4: LocoU 10 folded before Flop (didn't bet)
Seat 5: Piet-1503 folded on the Flop
Seat 6: Karbew (button) showed [Qc Ac] and won ($3.41) with two pair, Aces and Queens (pot not awarded as player cashed out)



PokerStars Hand #213573536511:  Hold'em No Limit ($0.01/$0.02 USD) - 2020/05/09 20:45:13 MSK [2020/05/09 13:45:13 ET]
Table 'Antiphos II' 6-max Seat #1 is the button
Seat 1: HaG1BaT0R ($5.30 in chips) 
Seat 2: lawlex_2 ($1.08 in chips) 
Seat 3: bello4820 ($1.15 in chips) 
Seat 4: LocoU 10 ($1.90 in chips) 
Seat 5: Piet-1503 ($2.18 in chips) 
Seat 6: Karbew ($2.83 in chips) 
lawlex_2: posts small blind $0.01
bello4820: posts big blind $0.02
*** HOLE CARDS ***
Dealt to lawlex_2 [Jc Ac]
LocoU 10: calls $0.02
Piet-1503: folds 
Karbew: calls $0.02
HaG1BaT0R: folds 
lawlex_2: raises $0.04 to $0.06
bello4820: calls $0.04
LocoU 10: folds 
Karbew: calls $0.04
*** FLOP *** [6s 4s 5d]
lawlex_2: bets $0.13
bello4820: folds 
Karbew: raises $0.45 to $0.58
lawlex_2: calls $0.45
*** TURN *** [6s 4s 5d] [Jh]
lawlex_2: bets $0.44 and is all-in
Karbew: calls $0.44
*** RIVER *** [6s 4s 5d Jh] [Kd]
*** SHOW DOWN ***
lawlex_2: shows [Jc Ac] (a pair of Jacks)
Karbew: shows [6d 6c] (three of a kind, Sixes)
Karbew collected $2.16 from pot
*** SUMMARY ***
Total pot $2.24 | Rake $0.08 
Board [6s 4s 5d Jh Kd]
Seat 1: HaG1BaT0R (button) folded before Flop (didn't bet)
Seat 2: lawlex_2 (small blind) showed [Jc Ac] and lost with a pair of Jacks
Seat 3: bello4820 (big blind) folded on the Flop
Seat 4: LocoU 10 folded before Flop
Seat 5: Piet-1503 folded before Flop (didn't bet)
Seat 6: Karbew showed [6d 6c] and won ($2.16) with three of a kind, Sixes



PokerStars Hand #213573640197:  Hold'em No Limit ($0.01/$0.02 USD) - 2020/05/09 20:46:51 MSK [2020/05/09 13:46:51 ET]
Table 'Antiphos II' 6-max Seat #4 is the button
Seat 1: HaG1BaT0R ($5.22 in chips) 
Seat 2: lawlex_2 ($2 in chips) 
Seat 4: LocoU 10 ($1.97 in chips) 
Seat 5: Piet-1503 ($2.16 in chips) 
Seat 6: Karbew ($3.91 in chips) 
Piet-1503: posts small blind $0.01
Karbew: posts big blind $0.02
*** HOLE CARDS ***
Dealt to lawlex_2 [7h 8c]
HaG1BaT0R: folds 
lawlex_2: folds 
LocoU 10: folds 
Piet-1503: calls $0.01
Karbew: checks 
*** FLOP *** [4c 2s Kc]
Piet-1503: checks 
Karbew: checks 
*** TURN *** [4c 2s Kc] [8h]
Piet-1503: checks 
Karbew: checks 
*** RIVER *** [4c 2s Kc 8h] [4s]
Piet-1503: checks 
Karbew: checks 
*** SHOW DOWN ***
Piet-1503: shows [Tc 9s] (a pair of Fours)
Karbew: shows [6c Jh] (a pair of Fours - King+Jack kicker)
Karbew collected $0.04 from pot
*** SUMMARY ***
Total pot $0.04 | Rake $0 
Board [4c 2s Kc 8h 4s]
Seat 1: HaG1BaT0R folded before Flop (didn't bet)
Seat 2: lawlex_2 folded before Flop (didn't bet)
Seat 4: LocoU 10 (button) folded before Flop (didn't bet)
Seat 5: Piet-1503 (small blind) showed [Tc 9s] and lost with a pair of Fours
Seat 6: Karbew (big blind) showed [6c Jh] and won ($0.04) with a pair of Fours



PokerStars Hand #213573669654:  Hold'em No Limit ($0.01/$0.02 USD) - 2020/05/09 20:47:20 MSK [2020/05/09 13:47:20 ET]
Table 'Antiphos II' 6-max Seat #5 is the button
Seat 1: HaG1BaT0R ($5.22 in chips) 
Seat 2: lawlex_2 ($2 in chips) 
Seat 3: bello4820 ($1.09 in chips) 
Seat 4: LocoU 10 ($1.97 in chips) 
Seat 5: Piet-1503 ($2.14 in chips) 
Seat 6: Karbew ($3.93 in chips) 
Karbew: posts small blind $0.01
HaG1BaT0R: posts big blind $0.02
*** HOLE CARDS ***
Dealt to lawlex_2 [3c Qc]
lawlex_2: folds 
bello4820: calls $0.02
LocoU 10: calls $0.02
Piet-1503: folds 
Karbew: folds 
HaG1BaT0R: checks 
*** FLOP *** [Qh 2s 4c]
HaG1BaT0R: checks 
bello4820: checks 
LocoU 10: checks 
*** TURN *** [Qh 2s 4c] [2c]
HaG1BaT0R: checks 
bello4820: checks 
LocoU 10: checks 
*** RIVER *** [Qh 2s 4c 2c] [Kd]
HaG1BaT0R: bets $0.02
bello4820: folds 
LocoU 10: raises $0.10 to $0.12
HaG1BaT0R: calls $0.10
*** SHOW DOWN ***
LocoU 10: shows [Ad 2d] (three of a kind, Deuces)
HaG1BaT0R: mucks hand 
LocoU 10 collected $0.30 from pot
*** SUMMARY ***
Total pot $0.31 | Rake $0.01 
Board [Qh 2s 4c 2c Kd]
Seat 1: HaG1BaT0R (big blind) mucked [3d Kc]
Seat 2: lawlex_2 folded before Flop (didn't bet)
Seat 3: bello4820 folded on the River
Seat 4: LocoU 10 showed [Ad 2d] and won ($0.30) with three of a kind, Deuces
Seat 5: Piet-1503 (button) folded before Flop (didn't bet)
Seat 6: Karbew (small blind) folded before Flop



PokerStars Hand #213573707746:  Hold'em No Limit ($0.01/$0.02 USD) - 2020/05/09 20:47:56 MSK [2020/05/09 13:47:56 ET]
Table 'Antiphos II' 6-max Seat #6 is the button
Seat 1: HaG1BaT0R ($5.08 in chips) 
Seat 2: lawlex_2 ($2 in chips) 
Seat 3: bello4820 ($1.07 in chips) 
Seat 4: LocoU 10 ($2.13 in chips) 
Seat 5: Piet-1503 ($2.14 in chips) 
Seat 6: Karbew ($3.92 in chips) 
HaG1BaT0R: posts small blind $0.01
lawlex_2: posts big blind $0.02
*** HOLE CARDS ***
Dealt to lawlex_2 [4d Qd]
bello4820: raises $0.02 to $0.04
LocoU 10: folds 
Piet-1503: calls $0.04
Karbew: folds 
HaG1BaT0R: raises $0.14 to $0.18
lawlex_2: folds 
bello4820: raises $0.89 to $1.07 and is all-in
Piet-1503: calls $1.03
HaG1BaT0R: folds 
*** FLOP *** [6h Ac 2c]
*** TURN *** [6h Ac 2c] [2s]
*** RIVER *** [6h Ac 2c 2s] [5h]
*** SHOW DOWN ***
bello4820: shows [Kc Jh] (a pair of Deuces)
Piet-1503: shows [As Ad] (a full house, Aces full of Deuces)
Piet-1503 collected $2.26 from pot
*** SUMMARY ***
Total pot $2.34 | Rake $0.08 
Board [6h Ac 2c 2s 5h]
Seat 1: HaG1BaT0R (small blind) folded before Flop
Seat 2: lawlex_2 (big blind) folded before Flop
Seat 3: bello4820 showed [Kc Jh] and lost with a pair of Deuces
Seat 4: LocoU 10 folded before Flop (didn't bet)
Seat 5: Piet-1503 showed [As Ad] and won ($2.26) with a full house, Aces full of Deuces
Seat 6: Karbew (button) folded before Flop (didn't bet)



PokerStars Hand #213573751069:  Hold'em No Limit ($0.01/$0.02 USD) - 2020/05/09 20:48:38 MSK [2020/05/09 13:48:38 ET]
Table 'Antiphos II' 6-max Seat #1 is the button
Seat 1: HaG1BaT0R ($4.90 in chips) 
Seat 2: lawlex_2 ($1.98 in chips) 
Seat 4: LocoU 10 ($2.13 in chips) 
Seat 5: Piet-1503 ($3.33 in chips) 
Seat 6: Karbew ($3.92 in chips) 
lawlex_2: posts small blind $0.01
LocoU 10: posts big blind $0.02
*** HOLE CARDS ***
Dealt to lawlex_2 [8h Kc]
Piet-1503: folds 
Karbew: folds 
HaG1BaT0R: folds 
lawlex_2: raises $0.04 to $0.06
LocoU 10: folds 
Uncalled bet ($0.04) returned to lawlex_2
lawlex_2 collected $0.04 from pot
lawlex_2: doesn't show hand 
*** SUMMARY ***
Total pot $0.04 | Rake $0 
Seat 1: HaG1BaT0R (button) folded before Flop (didn't bet)
Seat 2: lawlex_2 (small blind) collected ($0.04)
Seat 4: LocoU 10 (big blind) folded before Flop
Seat 5: Piet-1503 folded before Flop (didn't bet)
Seat 6: Karbew folded before Flop (didn't bet)



PokerStars Hand #213573763334:  Hold'em No Limit ($0.01/$0.02 USD) - 2020/05/09 20:48:49 MSK [2020/05/09 13:48:49 ET]
Table 'Antiphos II' 6-max Seat #2 is the button
Seat 1: HaG1BaT0R ($4.90 in chips) 
Seat 2: lawlex_2 ($2 in chips) 
Seat 4: LocoU 10 ($2.11 in chips) 
Seat 5: Piet-1503 ($3.33 in chips) 
Seat 6: Karbew ($3.92 in chips) 
LocoU 10: posts small blind $0.01
Piet-1503: posts big blind $0.02
*** HOLE CARDS ***
Dealt to lawlex_2 [Tc Qh]
bello4820 leaves the table
Karbew: raises $0.04 to $0.06
bello4820 joins the table at seat #3 
HaG1BaT0R: folds 
lawlex_2: calls $0.06
LocoU 10: folds 
Piet-1503: folds 
*** FLOP *** [7h 4s Qd]
Karbew: bets $0.10
lawlex_2: raises $0.23 to $0.33
Karbew: folds 
Uncalled bet ($0.23) returned to lawlex_2
lawlex_2 collected $0.34 from pot
lawlex_2: doesn't show hand 
*** SUMMARY ***
Total pot $0.35 | Rake $0.01 
Board [7h 4s Qd]
Seat 1: HaG1BaT0R folded before Flop (didn't bet)
Seat 2: lawlex_2 (button) collected ($0.34)
Seat 4: LocoU 10 (small blind) folded before Flop
Seat 5: Piet-1503 (big blind) folded before Flop
Seat 6: Karbew folded on the Flop



PokerStars Hand #213573810434:  Hold'em No Limit ($0.01/$0.02 USD) - 2020/05/09 20:49:32 MSK [2020/05/09 13:49:32 ET]
Table 'Antiphos II' 6-max Seat #4 is the button
Seat 1: HaG1BaT0R ($4.90 in chips) 
Seat 2: lawlex_2 ($2.18 in chips) 
Seat 3: bello4820 ($1.60 in chips) 
Seat 4: LocoU 10 ($2.10 in chips) 
Seat 5: Piet-1503 ($3.31 in chips) 
Seat 6: Karbew ($3.76 in chips) 
Piet-1503: posts small blind $0.01
Karbew: posts big blind $0.02
bello4820: posts big blind $0.02
*** HOLE CARDS ***
Dealt to lawlex_2 [As 8d]
HaG1BaT0R: folds 
lawlex_2: raises $0.04 to $0.06
bello4820: folds 
LocoU 10: raises $0.06 to $0.12
Piet-1503: raises $0.06 to $0.18
Karbew: folds 
lawlex_2: folds 
LocoU 10: calls $0.06
*** FLOP *** [Kd 9s 2s]
Piet-1503: checks 
LocoU 10: checks 
*** TURN *** [Kd 9s 2s] [7s]
Piet-1503: bets $0.22
LocoU 10: folds 
Uncalled bet ($0.22) returned to Piet-1503
Piet-1503 collected $0.44 from pot
Piet-1503: doesn't show hand 
*** SUMMARY ***
Total pot $0.46 | Rake $0.02 
Board [Kd 9s 2s 7s]
Seat 1: HaG1BaT0R folded before Flop (didn't bet)
Seat 2: lawlex_2 folded before Flop
Seat 3: bello4820 folded before Flop (didn't bet)
Seat 4: LocoU 10 (button) folded on the Turn
Seat 5: Piet-1503 (small blind) collected ($0.44)
Seat 6: Karbew (big blind) folded before Flop



PokerStars Hand #213573854917:  Hold'em No Limit ($0.01/$0.02 USD) - 2020/05/09 20:50:15 MSK [2020/05/09 13:50:15 ET]
Table 'Antiphos II' 6-max Seat #5 is the button
Seat 1: HaG1BaT0R ($4.90 in chips) 
Seat 2: lawlex_2 ($2.12 in chips) 
Seat 3: bello4820 ($1.58 in chips) 
Seat 4: LocoU 10 ($1.92 in chips) 
Seat 5: Piet-1503 ($3.57 in chips) 
Seat 6: Karbew ($3.74 in chips) 
Karbew: posts small blind $0.01
HaG1BaT0R: posts big blind $0.02
*** HOLE CARDS ***
Dealt to lawlex_2 [Qh 4s]
lawlex_2: folds 
bello4820: calls $0.02
LocoU 10: calls $0.02
Piet-1503: folds 
Karbew: folds 
HaG1BaT0R: checks 
*** FLOP *** [7s 6d 3c]
HaG1BaT0R: bets $0.04
bello4820: calls $0.04
LocoU 10: calls $0.04
*** TURN *** [7s 6d 3c] [Kc]
HaG1BaT0R: bets $0.14
bello4820: calls $0.14
LocoU 10: folds 
*** RIVER *** [7s 6d 3c Kc] [Kd]
HaG1BaT0R: bets $0.50
bello4820: calls $0.50
*** SHOW DOWN ***
HaG1BaT0R: shows [8d 9h] (a pair of Kings)
bello4820: shows [6h 7d] (two pair, Kings and Sevens)
bello4820 collected $1.42 from pot
*** SUMMARY ***
Total pot $1.47 | Rake $0.05 
Board [7s 6d 3c Kc Kd]
Seat 1: HaG1BaT0R (big blind) showed [8d 9h] and lost with a pair of Kings
Seat 2: lawlex_2 folded before Flop (didn't bet)
Seat 3: bello4820 showed [6h 7d] and won ($1.42) with two pair, Kings and Sevens
Seat 4: LocoU 10 folded on the Turn
Seat 5: Piet-1503 (button) folded before Flop (didn't bet)
Seat 6: Karbew (small blind) folded before Flop



PokerStars Hand #213573906191:  Hold'em No Limit ($0.01/$0.02 USD) - 2020/05/09 20:51:04 MSK [2020/05/09 13:51:04 ET]
Table 'Antiphos II' 6-max Seat #6 is the button
Seat 1: HaG1BaT0R ($4.20 in chips) 
Seat 2: lawlex_2 ($2.12 in chips) 
Seat 3: bello4820 ($2.30 in chips) 
Seat 4: LocoU 10 ($1.86 in chips) 
Seat 5: Piet-1503 ($3.57 in chips) 
Seat 6: Karbew ($3.73 in chips) 
HaG1BaT0R: posts small blind $0.01
lawlex_2: posts big blind $0.02
*** HOLE CARDS ***
Dealt to lawlex_2 [4d 8s]
bello4820: calls $0.02
LocoU 10: raises $0.04 to $0.06
Piet-1503: calls $0.06
Karbew: folds 
HaG1BaT0R: folds 
lawlex_2: folds 
bello4820: calls $0.04
*** FLOP *** [Js 4s 8d]
bello4820: checks 
LocoU 10: bets $0.10
Piet-1503: calls $0.10
bello4820: folds 
*** TURN *** [Js 4s 8d] [3h]
LocoU 10: bets $0.10
Piet-1503: calls $0.10
*** RIVER *** [Js 4s 8d 3h] [6c]
LocoU 10: bets $0.10
Piet-1503: calls $0.10
*** SHOW DOWN ***
LocoU 10: shows [9c 9s] (a pair of Nines)
Piet-1503: mucks hand 
LocoU 10 collected $0.78 from pot
*** SUMMARY ***
Total pot $0.81 | Rake $0.03 
Board [Js 4s 8d 3h 6c]
Seat 1: HaG1BaT0R (small blind) folded before Flop
Seat 2: lawlex_2 (big blind) folded before Flop
Seat 3: bello4820 folded on the Flop
Seat 4: LocoU 10 showed [9c 9s] and won ($0.78) with a pair of Nines
Seat 5: Piet-1503 mucked [Ac Qd]
Seat 6: Karbew (button) folded before Flop (didn't bet)



PokerStars Hand #213573971602:  Hold'em No Limit ($0.01/$0.02 USD) - 2020/05/09 20:52:06 MSK [2020/05/09 13:52:06 ET]
Table 'Antiphos II' 6-max Seat #1 is the button
Seat 1: HaG1BaT0R ($4.19 in chips) 
Seat 2: lawlex_2 ($2.10 in chips) 
Seat 3: bello4820 ($2.24 in chips) 
Seat 4: LocoU 10 ($2.28 in chips) 
Seat 5: Piet-1503 ($3.21 in chips) 
Seat 6: Karbew ($3.73 in chips) 
lawlex_2: posts small blind $0.01
bello4820: posts big blind $0.02
*** HOLE CARDS ***
Dealt to lawlex_2 [3h 8h]
LocoU 10: folds 
Piet-1503: folds 
Karbew: folds 
HaG1BaT0R: folds 
lawlex_2: folds 
Uncalled bet ($0.01) returned to bello4820
bello4820 collected $0.02 from pot
*** SUMMARY ***
Total pot $0.02 | Rake $0 
Seat 1: HaG1BaT0R (button) folded before Flop (didn't bet)
Seat 2: lawlex_2 (small blind) folded before Flop
Seat 3: bello4820 (big blind) collected ($0.02)
Seat 4: LocoU 10 folded before Flop (didn't bet)
Seat 5: Piet-1503 folded before Flop (didn't bet)
Seat 6: Karbew folded before Flop (didn't bet)



PokerStars Hand #213573984746:  Hold'em No Limit ($0.01/$0.02 USD) - 2020/05/09 20:52:19 MSK [2020/05/09 13:52:19 ET]
Table 'Antiphos II' 6-max Seat #2 is the button
Seat 1: HaG1BaT0R ($4.19 in chips) 
Seat 2: lawlex_2 ($2.09 in chips) 
Seat 3: bello4820 ($2.25 in chips) 
Seat 4: LocoU 10 ($2.28 in chips) 
Seat 5: Piet-1503 ($3.21 in chips) 
Seat 6: Karbew ($3.73 in chips) 
bello4820: posts small blind $0.01
LocoU 10: posts big blind $0.02
*** HOLE CARDS ***
Dealt to lawlex_2 [Kh 8c]
Piet-1503: calls $0.02
Karbew: folds 
HaG1BaT0R: folds 
lawlex_2: folds 
bello4820: raises $0.04 to $0.06
LocoU 10: folds 
Piet-1503: calls $0.04
*** FLOP *** [Qs Th Js]
bello4820: checks 
Piet-1503: checks 
*** TURN *** [Qs Th Js] [Tc]
bello4820: bets $0.07
Piet-1503: folds 
Uncalled bet ($0.07) returned to bello4820
bello4820 collected $0.14 from pot
*** SUMMARY ***
Total pot $0.14 | Rake $0 
Board [Qs Th Js Tc]
Seat 1: HaG1BaT0R folded before Flop (didn't bet)
Seat 2: lawlex_2 (button) folded before Flop (didn't bet)
Seat 3: bello4820 (small blind) collected ($0.14)
Seat 4: LocoU 10 (big blind) folded before Flop
Seat 5: Piet-1503 folded on the Turn
Seat 6: Karbew folded before Flop (didn't bet)



PokerStars Hand #213574019014:  Hold'em No Limit ($0.01/$0.02 USD) - 2020/05/09 20:52:52 MSK [2020/05/09 13:52:52 ET]
Table 'Antiphos II' 6-max Seat #3 is the button
Seat 1: HaG1BaT0R ($4.19 in chips) 
Seat 2: lawlex_2 ($2.09 in chips) 
Seat 3: bello4820 ($2.33 in chips) 
Seat 4: LocoU 10 ($2.26 in chips) 
Seat 5: Piet-1503 ($3.15 in chips) 
Seat 6: Karbew ($3.73 in chips) 
LocoU 10: posts small blind $0.01
Piet-1503: posts big blind $0.02
*** HOLE CARDS ***
Dealt to lawlex_2 [5s 3s]
Karbew: folds 
HaG1BaT0R: folds 
lawlex_2: folds 
bello4820: calls $0.02
LocoU 10: calls $0.01
Piet-1503: checks 
*** FLOP *** [Jd 8h 2s]
LocoU 10: checks 
Piet-1503: checks 
bello4820: checks 
*** TURN *** [Jd 8h 2s] [Qs]
LocoU 10: checks 
Piet-1503: checks 
bello4820: checks 
*** RIVER *** [Jd 8h 2s Qs] [8c]
LocoU 10: checks 
Piet-1503: checks 
bello4820: checks 
*** SHOW DOWN ***
LocoU 10: shows [6h 9s] (a pair of Eights)
Piet-1503: shows [Th 5h] (a pair of Eights - Queen+Jack+Ten kicker)
bello4820: shows [Kd 6c] (a pair of Eights - King kicker)
bello4820 collected $0.06 from pot
*** SUMMARY ***
Total pot $0.06 | Rake $0 
Board [Jd 8h 2s Qs 8c]
Seat 1: HaG1BaT0R folded before Flop (didn't bet)
Seat 2: lawlex_2 folded before Flop (didn't bet)
Seat 3: bello4820 (button) showed [Kd 6c] and won ($0.06) with a pair of Eights
Seat 4: LocoU 10 (small blind) showed [6h 9s] and lost with a pair of Eights
Seat 5: Piet-1503 (big blind) showed [Th 5h] and lost with a pair of Eights
Seat 6: Karbew folded before Flop (didn't bet)



PokerStars Hand #213574071165:  Hold'em No Limit ($0.01/$0.02 USD) - 2020/05/09 20:53:42 MSK [2020/05/09 13:53:42 ET]
Table 'Antiphos II' 6-max Seat #4 is the button
Seat 1: HaG1BaT0R ($4.19 in chips) 
Seat 2: lawlex_2 ($2.09 in chips) 
Seat 3: bello4820 ($2.37 in chips) 
Seat 4: LocoU 10 ($2.24 in chips) 
Seat 5: Piet-1503 ($3.13 in chips) 
Seat 6: Karbew ($3.73 in chips) 
Piet-1503: posts small blind $0.01
Karbew: posts big blind $0.02
*** HOLE CARDS ***
Dealt to lawlex_2 [2h Kh]
HaG1BaT0R: folds 
lawlex_2: raises $0.04 to $0.06
bello4820: folds 
LocoU 10: calls $0.06
Piet-1503: folds 
Karbew: folds 
*** FLOP *** [Qd 4d Tc]
lawlex_2: bets $0.09
LocoU 10: calls $0.09
*** TURN *** [Qd 4d Tc] [3s]
lawlex_2: checks 
LocoU 10: bets $0.16
lawlex_2: folds 
Uncalled bet ($0.16) returned to LocoU 10
LocoU 10 collected $0.32 from pot
LocoU 10: doesn't show hand 
*** SUMMARY ***
Total pot $0.33 | Rake $0.01 
Board [Qd 4d Tc 3s]
Seat 1: HaG1BaT0R folded before Flop (didn't bet)
Seat 2: lawlex_2 folded on the Turn
Seat 3: bello4820 folded before Flop (didn't bet)
Seat 4: LocoU 10 (button) collected ($0.32)
Seat 5: Piet-1503 (small blind) folded before Flop
Seat 6: Karbew (big blind) folded before Flop



PokerStars Hand #213574111576:  Hold'em No Limit ($0.01/$0.02 USD) - 2020/05/09 20:54:19 MSK [2020/05/09 13:54:19 ET]
Table 'Antiphos II' 6-max Seat #5 is the button
Seat 1: HaG1BaT0R ($4.19 in chips) 
Seat 2: lawlex_2 ($1.94 in chips) 
Seat 3: bello4820 ($2.37 in chips) 
Seat 4: LocoU 10 ($2.41 in chips) 
Seat 5: Piet-1503 ($3.12 in chips) 
Seat 6: Karbew ($3.71 in chips) 
Karbew: posts small blind $0.01
HaG1BaT0R: posts big blind $0.02
*** HOLE CARDS ***
Dealt to lawlex_2 [Jh 2s]
lawlex_2: folds 
bello4820: calls $0.02
LocoU 10: raises $0.02 to $0.04
Piet-1503: folds 
Karbew: folds 
HaG1BaT0R: folds 
bello4820: calls $0.02
*** FLOP *** [4h 2c Ah]
bello4820: checks 
LocoU 10: checks 
*** TURN *** [4h 2c Ah] [5s]
bello4820: bets $0.02
LocoU 10: calls $0.02
*** RIVER *** [4h 2c Ah 5s] [Ts]
bello4820: bets $0.07
LocoU 10: folds 
Uncalled bet ($0.07) returned to bello4820
bello4820 collected $0.14 from pot
*** SUMMARY ***
Total pot $0.15 | Rake $0.01 
Board [4h 2c Ah 5s Ts]
Seat 1: HaG1BaT0R (big blind) folded before Flop
Seat 2: lawlex_2 folded before Flop (didn't bet)
Seat 3: bello4820 collected ($0.14)
Seat 4: LocoU 10 folded on the River
Seat 5: Piet-1503 (button) folded before Flop (didn't bet)
Seat 6: Karbew (small blind) folded before Flop



PokerStars Hand #213574160153:  Hold'em No Limit ($0.01/$0.02 USD) - 2020/05/09 20:55:08 MSK [2020/05/09 13:55:08 ET]
Table 'Antiphos II' 6-max Seat #6 is the button
Seat 1: HaG1BaT0R ($4.17 in chips) 
Seat 2: lawlex_2 ($1.94 in chips) 
Seat 3: bello4820 ($2.45 in chips) 
Seat 4: LocoU 10 ($2.35 in chips) 
Seat 5: Piet-1503 ($3.12 in chips) 
Seat 6: Karbew ($3.70 in chips) 
HaG1BaT0R: posts small blind $0.01
lawlex_2: posts big blind $0.02
*** HOLE CARDS ***
Dealt to lawlex_2 [7s Th]
bello4820: calls $0.02
LocoU 10: raises $0.04 to $0.06
Piet-1503: folds 
Karbew: folds 
HaG1BaT0R: folds 
lawlex_2: folds 
bello4820: folds 
Uncalled bet ($0.04) returned to LocoU 10
LocoU 10 collected $0.07 from pot
LocoU 10: doesn't show hand 
*** SUMMARY ***
Total pot $0.07 | Rake $0 
Seat 1: HaG1BaT0R (small blind) folded before Flop
Seat 2: lawlex_2 (big blind) folded before Flop
Seat 3: bello4820 folded before Flop
Seat 4: LocoU 10 collected ($0.07)
Seat 5: Piet-1503 folded before Flop (didn't bet)
Seat 6: Karbew (button) folded before Flop (didn't bet)



PokerStars Hand #213574175075:  Hold'em No Limit ($0.01/$0.02 USD) - 2020/05/09 20:55:31 MSK [2020/05/09 13:55:31 ET]
Table 'Antiphos II' 6-max Seat #1 is the button
Seat 1: HaG1BaT0R ($4.16 in chips) 
Seat 2: lawlex_2 ($1.92 in chips) 
Seat 3: bello4820 ($2.43 in chips) 
Seat 4: LocoU 10 ($2.40 in chips) 
Seat 5: Piet-1503 ($3.12 in chips) 
Seat 6: Karbew ($3.70 in chips) 
lawlex_2: posts small blind $0.01
bello4820: posts big blind $0.02
*** HOLE CARDS ***
Dealt to lawlex_2 [3s As]
LocoU 10: folds 
Piet-1503: folds 
Karbew: folds 
HaG1BaT0R: folds 
lawlex_2: raises $0.04 to $0.06
bello4820: calls $0.04
*** FLOP *** [Th 2h Tc]
lawlex_2: bets $0.08
bello4820: folds 
Uncalled bet ($0.08) returned to lawlex_2
lawlex_2 collected $0.12 from pot
lawlex_2: doesn't show hand 
*** SUMMARY ***
Total pot $0.12 | Rake $0 
Board [Th 2h Tc]
Seat 1: HaG1BaT0R (button) folded before Flop (didn't bet)
Seat 2: lawlex_2 (small blind) collected ($0.12)
Seat 3: bello4820 (big blind) folded on the Flop
Seat 4: LocoU 10 folded before Flop (didn't bet)
Seat 5: Piet-1503 folded before Flop (didn't bet)
Seat 6: Karbew folded before Flop (didn't bet)



PokerStars Hand #213574190356:  Hold'em No Limit ($0.01/$0.02 USD) - 2020/05/09 20:55:54 MSK [2020/05/09 13:55:54 ET]
Table 'Antiphos II' 6-max Seat #2 is the button
Seat 1: HaG1BaT0R ($4.16 in chips) 
Seat 2: lawlex_2 ($1.98 in chips) 
Seat 3: bello4820 ($2.37 in chips) 
Seat 4: LocoU 10 ($2.40 in chips) 
Seat 5: Piet-1503 ($3.12 in chips) 
Seat 6: Karbew ($3.70 in chips) 
bello4820: posts small blind $0.01
LocoU 10: posts big blind $0.02
*** HOLE CARDS ***
Dealt to lawlex_2 [Kc Qh]
Piet-1503: folds 
Karbew: folds 
HaG1BaT0R: raises $0.02 to $0.04
lawlex_2: calls $0.04
bello4820: calls $0.03
LocoU 10: folds 
*** FLOP *** [7h 8s 9h]
bello4820: bets $0.07
HaG1BaT0R: calls $0.07
lawlex_2: folds 
*** TURN *** [7h 8s 9h] [Qd]
bello4820: bets $0.14
HaG1BaT0R: folds 
Uncalled bet ($0.14) returned to bello4820
bello4820 collected $0.27 from pot
*** SUMMARY ***
Total pot $0.28 | Rake $0.01 
Board [7h 8s 9h Qd]
Seat 1: HaG1BaT0R folded on the Turn
Seat 2: lawlex_2 (button) folded on the Flop
Seat 3: bello4820 (small blind) collected ($0.27)
Seat 4: LocoU 10 (big blind) folded before Flop
Seat 5: Piet-1503 folded before Flop (didn't bet)
Seat 6: Karbew folded before Flop (didn't bet)



PokerStars Hand #213574223660:  Hold'em No Limit ($0.01/$0.02 USD) - 2020/05/09 20:56:45 MSK [2020/05/09 13:56:45 ET]
Table 'Antiphos II' 6-max Seat #3 is the button
Seat 1: HaG1BaT0R ($4.05 in chips) 
Seat 2: lawlex_2 ($1.94 in chips) 
Seat 3: bello4820 ($2.53 in chips) 
Seat 5: Piet-1503 ($3.12 in chips) 
Seat 6: Karbew ($3.70 in chips) 
Piet-1503: posts small blind $0.01
Karbew: posts big blind $0.02
*** HOLE CARDS ***
Dealt to lawlex_2 [Kd 4d]
HaG1BaT0R: folds 
lawlex_2: folds 
bello4820: calls $0.02
Piet-1503: calls $0.01
Karbew: raises $0.06 to $0.08
bello4820: folds 
Piet-1503: folds 
Uncalled bet ($0.06) returned to Karbew
Karbew collected $0.06 from pot
*** SUMMARY ***
Total pot $0.06 | Rake $0 
Seat 1: HaG1BaT0R folded before Flop (didn't bet)
Seat 2: lawlex_2 folded before Flop (didn't bet)
Seat 3: bello4820 (button) folded before Flop
Seat 5: Piet-1503 (small blind) folded before Flop
Seat 6: Karbew (big blind) collected ($0.06)



PokerStars Hand #213574238858:  Hold'em No Limit ($0.01/$0.02 USD) - 2020/05/09 20:57:08 MSK [2020/05/09 13:57:08 ET]
Table 'Antiphos II' 6-max Seat #5 is the button
Seat 1: HaG1BaT0R ($4.05 in chips) 
Seat 2: lawlex_2 ($1.94 in chips) 
Seat 3: bello4820 ($2.51 in chips) 
Seat 5: Piet-1503 ($3.10 in chips) 
Seat 6: Karbew ($3.74 in chips) 
Karbew: posts small blind $0.01
HaG1BaT0R: posts big blind $0.02
*** HOLE CARDS ***
Dealt to lawlex_2 [2c 2s]
lawlex_2: raises $0.04 to $0.06
bello4820: folds 
Piet-1503: folds 
Karbew: folds 
HaG1BaT0R: folds 
Uncalled bet ($0.04) returned to lawlex_2
lawlex_2 collected $0.05 from pot
lawlex_2: doesn't show hand 
*** SUMMARY ***
Total pot $0.05 | Rake $0 
Seat 1: HaG1BaT0R (big blind) folded before Flop
Seat 2: lawlex_2 collected ($0.05)
Seat 3: bello4820 folded before Flop (didn't bet)
Seat 5: Piet-1503 (button) folded before Flop (didn't bet)
Seat 6: Karbew (small blind) folded before Flop



PokerStars Hand #213574247107:  Hold'em No Limit ($0.01/$0.02 USD) - 2020/05/09 20:57:20 MSK [2020/05/09 13:57:20 ET]
Table 'Antiphos II' 6-max Seat #6 is the button
Seat 1: HaG1BaT0R ($4.03 in chips) 
Seat 2: lawlex_2 ($1.97 in chips) 
Seat 3: bello4820 ($2.51 in chips) 
Seat 5: Piet-1503 ($3.10 in chips) 
Seat 6: Karbew ($3.73 in chips) 
HaG1BaT0R: posts small blind $0.01
lawlex_2: posts big blind $0.02
*** HOLE CARDS ***
Dealt to lawlex_2 [7s 6c]
bello4820: folds 
Piet-1503: calls $0.02
Karbew: folds 
HaG1BaT0R: calls $0.01
lawlex_2: checks 
*** FLOP *** [7d 2d 3h]
HaG1BaT0R: checks 
lawlex_2: bets $0.04
Piet-1503: calls $0.04
HaG1BaT0R: folds 
*** TURN *** [7d 2d 3h] [Ac]
lawlex_2: bets $0.09
Piet-1503: calls $0.09
*** RIVER *** [7d 2d 3h Ac] [Tc]
lawlex_2: checks 
Piet-1503: checks 
*** SHOW DOWN ***
lawlex_2: shows [7s 6c] (a pair of Sevens)
Piet-1503: shows [8c 8s] (a pair of Eights)
Piet-1503 collected $0.31 from pot
*** SUMMARY ***
Total pot $0.32 | Rake $0.01 
Board [7d 2d 3h Ac Tc]
Seat 1: HaG1BaT0R (small blind) folded on the Flop
Seat 2: lawlex_2 (big blind) showed [7s 6c] and lost with a pair of Sevens
Seat 3: bello4820 folded before Flop (didn't bet)
Seat 5: Piet-1503 showed [8c 8s] and won ($0.31) with a pair of Eights
Seat 6: Karbew (button) folded before Flop (didn't bet)



PokerStars Hand #213574276576:  Hold'em No Limit ($0.01/$0.02 USD) - 2020/05/09 20:57:52 MSK [2020/05/09 13:57:52 ET]
Table 'Antiphos II' 6-max Seat #1 is the button
Seat 1: HaG1BaT0R ($4.01 in chips) 
Seat 2: lawlex_2 ($1.82 in chips) 
Seat 3: bello4820 ($2.51 in chips) 
Seat 5: Piet-1503 ($3.26 in chips) 
Seat 6: Karbew ($3.73 in chips) 
lawlex_2: posts small blind $0.01
bello4820: posts big blind $0.02
*** HOLE CARDS ***
Dealt to lawlex_2 [8h 9d]
Piet-1503: folds 
Karbew: folds 
HaG1BaT0R: folds 
lawlex_2: folds 
Uncalled bet ($0.01) returned to bello4820
bello4820 collected $0.02 from pot
*** SUMMARY ***
Total pot $0.02 | Rake $0 
Seat 1: HaG1BaT0R (button) folded before Flop (didn't bet)
Seat 2: lawlex_2 (small blind) folded before Flop
Seat 3: bello4820 (big blind) collected ($0.02)
Seat 5: Piet-1503 folded before Flop (didn't bet)
Seat 6: Karbew folded before Flop (didn't bet)



PokerStars Hand #213574281672:  Hold'em No Limit ($0.01/$0.02 USD) - 2020/05/09 20:57:59 MSK [2020/05/09 13:57:59 ET]
Table 'Antiphos II' 6-max Seat #2 is the button
Seat 1: HaG1BaT0R ($4.01 in chips) 
Seat 2: lawlex_2 ($1.81 in chips) 
Seat 3: bello4820 ($2.52 in chips) 
Seat 5: Piet-1503 ($3.26 in chips) 
Seat 6: Karbew ($3.73 in chips) 
bello4820: posts small blind $0.01
Piet-1503: posts big blind $0.02
*** HOLE CARDS ***
Dealt to lawlex_2 [3d 7d]
Karbew: folds 
HaG1BaT0R: folds 
lawlex_2: folds 
bello4820: calls $0.01
Piet-1503: raises $0.04 to $0.06
bello4820: calls $0.04
*** FLOP *** [3c Ac 8d]
bello4820: bets $0.06
Piet-1503: calls $0.06
*** TURN *** [3c Ac 8d] [Kd]
bello4820: checks 
Piet-1503: bets $0.17
bello4820: folds 
Uncalled bet ($0.17) returned to Piet-1503
Piet-1503 collected $0.23 from pot
Piet-1503: doesn't show hand 
*** SUMMARY ***
Total pot $0.24 | Rake $0.01 
Board [3c Ac 8d Kd]
Seat 1: HaG1BaT0R folded before Flop (didn't bet)
Seat 2: lawlex_2 (button) folded before Flop (didn't bet)
Seat 3: bello4820 (small blind) folded on the Turn
Seat 5: Piet-1503 (big blind) collected ($0.23)
Seat 6: Karbew folded before Flop (didn't bet)



PokerStars Hand #213574304592:  Hold'em No Limit ($0.01/$0.02 USD) - 2020/05/09 20:58:34 MSK [2020/05/09 13:58:34 ET]
Table 'Antiphos II' 6-max Seat #3 is the button
Seat 1: HaG1BaT0R ($4.01 in chips) 
Seat 2: lawlex_2 ($1.81 in chips) 
Seat 3: bello4820 ($2.40 in chips) 
Seat 5: Piet-1503 ($3.37 in chips) 
Seat 6: Karbew ($3.73 in chips) 
Piet-1503: posts small blind $0.01
Karbew: posts big blind $0.02
*** HOLE CARDS ***
Dealt to lawlex_2 [5c 2d]
HaG1BaT0R: folds 
lawlex_2: folds 
bello4820: calls $0.02
Piet-1503: raises $0.04 to $0.06
Karbew: calls $0.04
bello4820: folds 
*** FLOP *** [7h Ad 9d]
Piet-1503: checks 
Karbew: bets $0.10
Piet-1503: calls $0.10
*** TURN *** [7h Ad 9d] [Ks]
Piet-1503: checks 
Karbew: checks 
*** RIVER *** [7h Ad 9d Ks] [As]
Piet-1503: checks 
Karbew: checks 
*** SHOW DOWN ***
Piet-1503: shows [Js Jd] (two pair, Aces and Jacks)
Karbew: shows [Qc Kc] (two pair, Aces and Kings)
Karbew collected $0.33 from pot
*** SUMMARY ***
Total pot $0.34 | Rake $0.01 
Board [7h Ad 9d Ks As]
Seat 1: HaG1BaT0R folded before Flop (didn't bet)
Seat 2: lawlex_2 folded before Flop (didn't bet)
Seat 3: bello4820 (button) folded before Flop
Seat 5: Piet-1503 (small blind) showed [Js Jd] and lost with two pair, Aces and Jacks
Seat 6: Karbew (big blind) showed [Qc Kc] and won ($0.33) with two pair, Aces and Kings



PokerStars Hand #213574330482:  Hold'em No Limit ($0.01/$0.02 USD) - 2020/05/09 20:59:13 MSK [2020/05/09 13:59:13 ET]
Table 'Antiphos II' 6-max Seat #5 is the button
Seat 1: HaG1BaT0R ($4.01 in chips) 
Seat 2: lawlex_2 ($1.81 in chips) 
Seat 3: bello4820 ($2.38 in chips) 
Seat 4: LocoU 10 ($2.38 in chips) 
Seat 5: Piet-1503 ($3.21 in chips) 
Seat 6: Karbew ($3.90 in chips) 
Karbew: posts small blind $0.01
HaG1BaT0R: posts big blind $0.02
LocoU 10: posts small & big blinds $0.03
*** HOLE CARDS ***
Dealt to lawlex_2 [Ks 2s]
lawlex_2: folds 
bello4820: calls $0.02
LocoU 10: checks 
Piet-1503: calls $0.02
Karbew: calls $0.01
HaG1BaT0R: checks 
*** FLOP *** [Td 9h Kh]
Karbew: checks 
HaG1BaT0R: checks 
bello4820: bets $0.02
LocoU 10: calls $0.02
Piet-1503: calls $0.02
Karbew: folds 
HaG1BaT0R: calls $0.02
*** TURN *** [Td 9h Kh] [8h]
HaG1BaT0R: checks 
bello4820: bets $0.09
LocoU 10: folds 
Piet-1503: calls $0.09
HaG1BaT0R: folds 
*** RIVER *** [Td 9h Kh 8h] [Qd]
bello4820: bets $0.18
Piet-1503: folds 
Uncalled bet ($0.18) returned to bello4820
bello4820 collected $0.36 from pot
*** SUMMARY ***
Total pot $0.37 | Rake $0.01 
Board [Td 9h Kh 8h Qd]
Seat 1: HaG1BaT0R (big blind) folded on the Turn
Seat 2: lawlex_2 folded before Flop (didn't bet)
Seat 3: bello4820 collected ($0.36)
Seat 4: LocoU 10 folded on the Turn
Seat 5: Piet-1503 (button) folded on the River
Seat 6: Karbew (small blind) folded on the Flop



PokerStars Hand #213574392380:  Hold'em No Limit ($0.01/$0.02 USD) - 2020/05/09 21:00:41 MSK [2020/05/09 14:00:41 ET]
Table 'Antiphos II' 6-max Seat #6 is the button
Seat 1: HaG1BaT0R ($3.97 in chips) 
Seat 2: lawlex_2 ($1.81 in chips) 
Seat 3: bello4820 ($2.61 in chips) 
Seat 4: LocoU 10 ($2.33 in chips) 
Seat 5: Piet-1503 ($3.08 in chips) 
Seat 6: Karbew ($3.88 in chips) 
HaG1BaT0R: posts small blind $0.01
lawlex_2: posts big blind $0.02
*** HOLE CARDS ***
Dealt to lawlex_2 [Kd Qc]
bello4820: calls $0.02
LocoU 10: folds 
Piet-1503: raises $0.04 to $0.06
Karbew: folds 
HaG1BaT0R: folds 
lawlex_2: calls $0.04
bello4820: folds 
*** FLOP *** [6c As Qs]
bello4820 leaves the table
lawlex_2: bets $0.09
Piet-1503: calls $0.09
*** TURN *** [6c As Qs] [Jc]
lawlex_2: bets $0.21
Piet-1503: calls $0.21
*** RIVER *** [6c As Qs Jc] [Ah]
lawlex_2: checks 
Piet-1503: checks 
*** SHOW DOWN ***
lawlex_2: shows [Kd Qc] (two pair, Aces and Queens)
Piet-1503: shows [Ks Kc] (two pair, Aces and Kings)
Piet-1503 collected $0.72 from pot
*** SUMMARY ***
Total pot $0.75 | Rake $0.03 
Board [6c As Qs Jc Ah]
Seat 1: HaG1BaT0R (small blind) folded before Flop
Seat 2: lawlex_2 (big blind) showed [Kd Qc] and lost with two pair, Aces and Queens
Seat 3: bello4820 folded before Flop
Seat 4: LocoU 10 folded before Flop (didn't bet)
Seat 5: Piet-1503 showed [Ks Kc] and won ($0.72) with two pair, Aces and Kings
Seat 6: Karbew (button) folded before Flop (didn't bet)



PokerStars Hand #213574433782:  Hold'em No Limit ($0.01/$0.02 USD) - 2020/05/09 21:01:30 MSK [2020/05/09 14:01:30 ET]
Table 'Antiphos II' 6-max Seat #1 is the button
Seat 1: HaG1BaT0R ($3.96 in chips) 
Seat 2: lawlex_2 ($1.45 in chips) 
Seat 4: LocoU 10 ($2.33 in chips) 
Seat 5: Piet-1503 ($3.44 in chips) 
Seat 6: Karbew ($3.88 in chips) 
lawlex_2: posts small blind $0.01
LocoU 10: posts big blind $0.02
*** HOLE CARDS ***
Dealt to lawlex_2 [Ts 9c]
Piet-1503: folds 
Karbew: folds 
HaG1BaT0R: folds 
lawlex_2: raises $0.04 to $0.06
LocoU 10: folds 
Uncalled bet ($0.04) returned to lawlex_2
lawlex_2 collected $0.04 from pot
lawlex_2: doesn't show hand 
*** SUMMARY ***
Total pot $0.04 | Rake $0 
Seat 1: HaG1BaT0R (button) folded before Flop (didn't bet)
Seat 2: lawlex_2 (small blind) collected ($0.04)
Seat 4: LocoU 10 (big blind) folded before Flop
Seat 5: Piet-1503 folded before Flop (didn't bet)
Seat 6: Karbew folded before Flop (didn't bet)



PokerStars Hand #213574446823:  Hold'em No Limit ($0.01/$0.02 USD) - 2020/05/09 21:01:44 MSK [2020/05/09 14:01:44 ET]
Table 'Antiphos II' 6-max Seat #2 is the button
Seat 1: HaG1BaT0R ($3.96 in chips) 
Seat 2: lawlex_2 ($1.47 in chips) 
Seat 4: LocoU 10 ($2.31 in chips) 
Seat 5: Piet-1503 ($3.44 in chips) 
Seat 6: Karbew ($3.88 in chips) 
LocoU 10: posts small blind $0.01
Piet-1503: posts big blind $0.02
*** HOLE CARDS ***
Dealt to lawlex_2 [5c Kd]
Karbew: folds 
HaG1BaT0R: folds 
lawlex_2: folds 
LocoU 10: folds 
Uncalled bet ($0.01) returned to Piet-1503
AlissonStein joins the table at seat #3 
Piet-1503 collected $0.02 from pot
Piet-1503: doesn't show hand 
*** SUMMARY ***
Total pot $0.02 | Rake $0 
Seat 1: HaG1BaT0R folded before Flop (didn't bet)
Seat 2: lawlex_2 (button) folded before Flop (didn't bet)
Seat 4: LocoU 10 (small blind) folded before Flop
Seat 5: Piet-1503 (big blind) collected ($0.02)
Seat 6: Karbew folded before Flop (didn't bet)



PokerStars Hand #213574461409:  Hold'em No Limit ($0.01/$0.02 USD) - 2020/05/09 21:01:58 MSK [2020/05/09 14:01:58 ET]
Table 'Antiphos II' 6-max Seat #4 is the button
Seat 1: HaG1BaT0R ($3.96 in chips) 
Seat 2: lawlex_2 ($1.47 in chips) 
Seat 4: LocoU 10 ($2.30 in chips) 
Seat 5: Piet-1503 ($3.45 in chips) 
Seat 6: Karbew ($3.88 in chips) 
Piet-1503: posts small blind $0.01
Karbew: posts big blind $0.02
AlissonStein: sits out 
*** HOLE CARDS ***
Dealt to lawlex_2 [Kc 6h]
HaG1BaT0R: folds 
lawlex_2: folds 
LocoU 10: raises $0.02 to $0.04
Piet-1503: calls $0.03
Karbew: calls $0.02
*** FLOP *** [4d 2h 5c]
Piet-1503: bets $0.09
Karbew: folds 
LocoU 10: calls $0.09
*** TURN *** [4d 2h 5c] [7c]
Piet-1503: bets $0.15
LocoU 10: folds 
Uncalled bet ($0.15) returned to Piet-1503
Piet-1503 collected $0.29 from pot
Piet-1503: doesn't show hand 
*** SUMMARY ***
Total pot $0.30 | Rake $0.01 
Board [4d 2h 5c 7c]
Seat 1: HaG1BaT0R folded before Flop (didn't bet)
Seat 2: lawlex_2 folded before Flop (didn't bet)
Seat 4: LocoU 10 (button) folded on the Turn
Seat 5: Piet-1503 (small blind) collected ($0.29)
Seat 6: Karbew (big blind) folded on the Flop



PokerStars Hand #213574497437:  Hold'em No Limit ($0.01/$0.02 USD) - 2020/05/09 21:02:34 MSK [2020/05/09 14:02:34 ET]
Table 'Antiphos II' 6-max Seat #5 is the button
Seat 1: HaG1BaT0R ($3.96 in chips) 
Seat 2: lawlex_2 ($1.47 in chips) 
Seat 4: LocoU 10 ($2.17 in chips) 
Seat 5: Piet-1503 ($3.61 in chips) 
Seat 6: Karbew ($3.84 in chips) 
Karbew: posts small blind $0.01
HaG1BaT0R: posts big blind $0.02
AlissonStein: sits out 
*** HOLE CARDS ***
Dealt to lawlex_2 [7c Js]
lawlex_2: folds 
LocoU 10: folds 
Piet-1503: calls $0.02
Karbew: folds 
HaG1BaT0R: checks 
*** FLOP *** [As 5c Jd]
HaG1BaT0R: checks 
Piet-1503: bets $0.04
HaG1BaT0R: folds 
Uncalled bet ($0.04) returned to Piet-1503
Piet-1503 collected $0.05 from pot
Piet-1503: doesn't show hand 
*** SUMMARY ***
Total pot $0.05 | Rake $0 
Board [As 5c Jd]
Seat 1: HaG1BaT0R (big blind) folded on the Flop
Seat 2: lawlex_2 folded before Flop (didn't bet)
Seat 4: LocoU 10 folded before Flop (didn't bet)
Seat 5: Piet-1503 (button) collected ($0.05)
Seat 6: Karbew (small blind) folded before Flop



PokerStars Hand #213574521294:  Hold'em No Limit ($0.01/$0.02 USD) - 2020/05/09 21:02:55 MSK [2020/05/09 14:02:55 ET]
Table 'Antiphos II' 6-max Seat #6 is the button
Seat 1: HaG1BaT0R ($3.94 in chips) 
Seat 2: lawlex_2 ($1.47 in chips) 
Seat 5: Piet-1503 ($3.64 in chips) 
Seat 6: Karbew ($3.83 in chips) 
HaG1BaT0R: posts small blind $0.01
lawlex_2: posts big blind $0.02
AlissonStein: sits out 
*** HOLE CARDS ***
Dealt to lawlex_2 [4c Qs]
Piet-1503: folds 
Karbew: folds 
HaG1BaT0R: raises $0.04 to $0.06
lawlex_2: folds 
Uncalled bet ($0.04) returned to HaG1BaT0R
HaG1BaT0R collected $0.04 from pot
HaG1BaT0R: doesn't show hand 
*** SUMMARY ***
Total pot $0.04 | Rake $0 
Seat 1: HaG1BaT0R (small blind) collected ($0.04)
Seat 2: lawlex_2 (big blind) folded before Flop
Seat 5: Piet-1503 folded before Flop (didn't bet)
Seat 6: Karbew (button) folded before Flop (didn't bet)



PokerStars Hand #213574533347:  Hold'em No Limit ($0.01/$0.02 USD) - 2020/05/09 21:03:07 MSK [2020/05/09 14:03:07 ET]
Table 'Antiphos II' 6-max Seat #1 is the button
Seat 1: HaG1BaT0R ($3.96 in chips) 
Seat 2: lawlex_2 ($1.45 in chips) 
Seat 3: AlissonStein ($2 in chips) 
Seat 5: Piet-1503 ($3.64 in chips) 
Seat 6: Karbew ($3.83 in chips) 
lawlex_2: posts small blind $0.01
AlissonStein: posts big blind $0.02
*** HOLE CARDS ***
Dealt to lawlex_2 [Kh 5h]
Piet-1503: calls $0.02
Karbew: folds 
HaG1BaT0R: folds 
lawlex_2: raises $0.04 to $0.06
AlissonStein: folds 
Piet-1503: calls $0.04
*** FLOP *** [Js 2c Ad]
lawlex_2: checks 
Piet-1503: bets $0.11
lawlex_2: folds 
Uncalled bet ($0.11) returned to Piet-1503
Piet-1503 collected $0.14 from pot
Piet-1503: doesn't show hand 
*** SUMMARY ***
Total pot $0.14 | Rake $0 
Board [Js 2c Ad]
Seat 1: HaG1BaT0R (button) folded before Flop (didn't bet)
Seat 2: lawlex_2 (small blind) folded on the Flop
Seat 3: AlissonStein (big blind) folded before Flop
Seat 5: Piet-1503 collected ($0.14)
Seat 6: Karbew folded before Flop (didn't bet)



PokerStars Hand #213574566004:  Hold'em No Limit ($0.01/$0.02 USD) - 2020/05/09 21:03:38 MSK [2020/05/09 14:03:38 ET]
Table 'Antiphos II' 6-max Seat #2 is the button
Seat 1: HaG1BaT0R ($3.96 in chips) 
Seat 2: lawlex_2 ($1.39 in chips) 
Seat 3: AlissonStein ($1.98 in chips) 
Seat 5: Piet-1503 ($3.72 in chips) 
Seat 6: Karbew ($3.83 in chips) 
AlissonStein: posts small blind $0.01
Piet-1503: posts big blind $0.02
*** HOLE CARDS ***
Dealt to lawlex_2 [9d 5s]
Karbew: folds 
HaG1BaT0R: folds 
lawlex_2: folds 
AlissonStein: raises $0.04 to $0.06
Piet-1503: folds 
Uncalled bet ($0.04) returned to AlissonStein
AlissonStein collected $0.04 from pot
AlissonStein: doesn't show hand 
*** SUMMARY ***
Total pot $0.04 | Rake $0 
Seat 1: HaG1BaT0R folded before Flop (didn't bet)
Seat 2: lawlex_2 (button) folded before Flop (didn't bet)
Seat 3: AlissonStein (small blind) collected ($0.04)
Seat 5: Piet-1503 (big blind) folded before Flop
Seat 6: Karbew folded before Flop (didn't bet)



PokerStars Hand #213574583255:  Hold'em No Limit ($0.01/$0.02 USD) - 2020/05/09 21:03:54 MSK [2020/05/09 14:03:54 ET]
Table 'Antiphos II' 6-max Seat #3 is the button
Seat 1: HaG1BaT0R ($3.96 in chips) 
Seat 2: lawlex_2 ($1.39 in chips) 
Seat 3: AlissonStein ($2 in chips) 
Seat 5: Piet-1503 ($3.70 in chips) 
Seat 6: Karbew ($3.83 in chips) 
Piet-1503: posts small blind $0.01
Karbew: posts big blind $0.02
*** HOLE CARDS ***
Dealt to lawlex_2 [As Ad]
HaG1BaT0R: folds 
lawlex_2: calls $0.02
AlissonStein: folds 
Piet-1503: calls $0.01
Karbew: checks 
*** FLOP *** [9s 4d Qd]
Piet-1503: checks 
Karbew: checks 
lawlex_2: bets $0.02
Piet-1503: folds 
Karbew: folds 
Uncalled bet ($0.02) returned to lawlex_2
lawlex_2 collected $0.06 from pot
lawlex_2: doesn't show hand 
*** SUMMARY ***
Total pot $0.06 | Rake $0 
Board [9s 4d Qd]
Seat 1: HaG1BaT0R folded before Flop (didn't bet)
Seat 2: lawlex_2 collected ($0.06)
Seat 3: AlissonStein (button) folded before Flop (didn't bet)
Seat 5: Piet-1503 (small blind) folded on the Flop
Seat 6: Karbew (big blind) folded on the Flop



PokerStars Hand #213574607741:  Hold'em No Limit ($0.01/$0.02 USD) - 2020/05/09 21:04:17 MSK [2020/05/09 14:04:17 ET]
Table 'Antiphos II' 6-max Seat #5 is the button
Seat 1: HaG1BaT0R ($3.96 in chips) 
Seat 2: lawlex_2 ($1.43 in chips) 
Seat 3: AlissonStein ($2 in chips) 
Seat 5: Piet-1503 ($3.68 in chips) 
Seat 6: Karbew ($3.81 in chips) 
Karbew: posts small blind $0.01
HaG1BaT0R: posts big blind $0.02
*** HOLE CARDS ***
Dealt to lawlex_2 [Th 8c]
lawlex_2: folds 
AlissonStein: raises $0.04 to $0.06
Piet-1503: folds 
Karbew: folds 
HaG1BaT0R: folds 
Uncalled bet ($0.04) returned to AlissonStein
AlissonStein collected $0.05 from pot
AlissonStein: doesn't show hand 
*** SUMMARY ***
Total pot $0.05 | Rake $0 
Seat 1: HaG1BaT0R (big blind) folded before Flop
Seat 2: lawlex_2 folded before Flop (didn't bet)
Seat 3: AlissonStein collected ($0.05)
Seat 5: Piet-1503 (button) folded before Flop (didn't bet)
Seat 6: Karbew (small blind) folded before Flop



PokerStars Hand #213574619970:  Hold'em No Limit ($0.01/$0.02 USD) - 2020/05/09 21:04:29 MSK [2020/05/09 14:04:29 ET]
Table 'Antiphos II' 6-max Seat #6 is the button
Seat 1: HaG1BaT0R ($3.94 in chips) 
Seat 2: lawlex_2 ($1.43 in chips) 
Seat 3: AlissonStein ($2.03 in chips) 
Seat 5: Piet-1503 ($3.68 in chips) 
Seat 6: Karbew ($3.80 in chips) 
HaG1BaT0R: posts small blind $0.01
lawlex_2: posts big blind $0.02
*** HOLE CARDS ***
Dealt to lawlex_2 [Ad 8h]
AlissonStein: folds 
Piet-1503: folds 
Karbew: folds 
HaG1BaT0R: folds 
Uncalled bet ($0.01) returned to lawlex_2
lawlex_2 collected $0.02 from pot
lawlex_2: doesn't show hand 
*** SUMMARY ***
Total pot $0.02 | Rake $0 
Seat 1: HaG1BaT0R (small blind) folded before Flop
Seat 2: lawlex_2 (big blind) collected ($0.02)
Seat 3: AlissonStein folded before Flop (didn't bet)
Seat 5: Piet-1503 folded before Flop (didn't bet)
Seat 6: Karbew (button) folded before Flop (didn't bet)



PokerStars Hand #213574630566:  Hold'em No Limit ($0.01/$0.02 USD) - 2020/05/09 21:04:39 MSK [2020/05/09 14:04:39 ET]
Table 'Antiphos II' 6-max Seat #1 is the button
Seat 1: HaG1BaT0R ($3.93 in chips) 
Seat 2: lawlex_2 ($1.44 in chips) 
Seat 3: AlissonStein ($2.03 in chips) 
Seat 5: Piet-1503 ($3.68 in chips) 
Seat 6: Karbew ($3.80 in chips) 
lawlex_2: posts small blind $0.01
AlissonStein: posts big blind $0.02
*** HOLE CARDS ***
Dealt to lawlex_2 [Qh 2c]
Piet-1503: raises $0.04 to $0.06
Karbew: folds 
HaG1BaT0R: folds 
lawlex_2: folds 
AlissonStein: folds 
Uncalled bet ($0.04) returned to Piet-1503
Piet-1503 collected $0.05 from pot
Piet-1503: doesn't show hand 
*** SUMMARY ***
Total pot $0.05 | Rake $0 
Seat 1: HaG1BaT0R (button) folded before Flop (didn't bet)
Seat 2: lawlex_2 (small blind) folded before Flop
Seat 3: AlissonStein (big blind) folded before Flop
Seat 5: Piet-1503 collected ($0.05)
Seat 6: Karbew folded before Flop (didn't bet)



PokerStars Hand #213574642952:  Hold'em No Limit ($0.01/$0.02 USD) - 2020/05/09 21:04:50 MSK [2020/05/09 14:04:50 ET]
Table 'Antiphos II' 6-max Seat #2 is the button
Seat 1: HaG1BaT0R ($3.93 in chips) 
Seat 2: lawlex_2 ($1.43 in chips) 
Seat 3: AlissonStein ($2.01 in chips) 
Seat 5: Piet-1503 ($3.71 in chips) 
Seat 6: Karbew ($3.80 in chips) 
AlissonStein: posts small blind $0.01
Piet-1503: posts big blind $0.02
*** HOLE CARDS ***
Dealt to lawlex_2 [Jc 8s]
Karbew: folds 
HaG1BaT0R: folds 
lawlex_2: folds 
AlissonStein: raises $0.04 to $0.06
Piet-1503: folds 
Uncalled bet ($0.04) returned to AlissonStein
AlissonStein collected $0.04 from pot
AlissonStein: doesn't show hand 
*** SUMMARY ***
Total pot $0.04 | Rake $0 
Seat 1: HaG1BaT0R folded before Flop (didn't bet)
Seat 2: lawlex_2 (button) folded before Flop (didn't bet)
Seat 3: AlissonStein (small blind) collected ($0.04)
Seat 5: Piet-1503 (big blind) folded before Flop
Seat 6: Karbew folded before Flop (didn't bet)



PokerStars Hand #213574657908:  Hold'em No Limit ($0.01/$0.02 USD) - 2020/05/09 21:05:04 MSK [2020/05/09 14:05:04 ET]
Table 'Antiphos II' 6-max Seat #3 is the button
Seat 1: HaG1BaT0R ($3.93 in chips) 
Seat 2: lawlex_2 ($1.43 in chips) 
Seat 3: AlissonStein ($2.03 in chips) 
Seat 5: Piet-1503 ($3.69 in chips) 
Karbew leaves the table
Piet-1503: posts small blind $0.01
HaG1BaT0R: posts big blind $0.02
*** HOLE CARDS ***
Dealt to lawlex_2 [Ad 7c]
lawlex_2: raises $0.04 to $0.06
AlissonStein: folds 
Piet-1503: folds 
HaG1BaT0R: calls $0.04
*** FLOP *** [4c 5h 4d]
HaG1BaT0R: checks 
lawlex_2: bets $0.09
HaG1BaT0R: folds 
Uncalled bet ($0.09) returned to lawlex_2
lawlex_2 collected $0.13 from pot
lawlex_2: doesn't show hand 
*** SUMMARY ***
Total pot $0.13 | Rake $0 
Board [4c 5h 4d]
Seat 1: HaG1BaT0R (big blind) folded on the Flop
Seat 2: lawlex_2 collected ($0.13)
Seat 3: AlissonStein (button) folded before Flop (didn't bet)
Seat 5: Piet-1503 (small blind) folded before Flop



PokerStars Hand #213574681164:  Hold'em No Limit ($0.01/$0.02 USD) - 2020/05/09 21:05:20 MSK [2020/05/09 14:05:20 ET]
Table 'Antiphos II' 6-max Seat #5 is the button
Seat 1: HaG1BaT0R ($3.87 in chips) 
Seat 2: lawlex_2 ($1.50 in chips) 
Seat 3: AlissonStein ($2.03 in chips) 
Seat 5: Piet-1503 ($3.68 in chips) 
HaG1BaT0R: posts small blind $0.01
lawlex_2: posts big blind $0.02
*** HOLE CARDS ***
Dealt to lawlex_2 [Ac 9d]
AlissonStein: raises $0.04 to $0.06
Piet-1503: folds 
HaG1BaT0R: folds 
lawlex_2: calls $0.04
*** FLOP *** [6d Jc Jd]
lawlex_2: checks 
AlissonStein: checks 
*** TURN *** [6d Jc Jd] [3h]
Pbrasil13 joins the table at seat #6 
lawlex_2: bets $0.07
AlissonStein: calls $0.07
*** RIVER *** [6d Jc Jd 3h] [8s]
lawlex_2: checks 
AlissonStein: checks 
*** SHOW DOWN ***
lawlex_2: shows [Ac 9d] (a pair of Jacks)
AlissonStein: shows [Ah Tc] (a pair of Jacks - Ace+Ten kicker)
AlissonStein collected $0.26 from pot
*** SUMMARY ***
Total pot $0.27 | Rake $0.01 
Board [6d Jc Jd 3h 8s]
Seat 1: HaG1BaT0R (small blind) folded before Flop
Seat 2: lawlex_2 (big blind) showed [Ac 9d] and lost with a pair of Jacks
Seat 3: AlissonStein showed [Ah Tc] and won ($0.26) with a pair of Jacks
Seat 5: Piet-1503 (button) folded before Flop (didn't bet)



PokerStars Hand #213574714629:  Hold'em No Limit ($0.01/$0.02 USD) - 2020/05/09 21:05:51 MSK [2020/05/09 14:05:51 ET]
Table 'Antiphos II' 6-max Seat #1 is the button
Seat 1: HaG1BaT0R ($3.86 in chips) 
Seat 2: lawlex_2 ($1.37 in chips) 
Seat 3: AlissonStein ($2.16 in chips) 
Seat 5: Piet-1503 ($3.68 in chips) 
lawlex_2: posts small blind $0.01
AlissonStein: posts big blind $0.02
Pbrasil13: sits out 
*** HOLE CARDS ***
Dealt to lawlex_2 [8s Jc]
Piet-1503: folds 
HaG1BaT0R: folds 
lawlex_2: folds 
Uncalled bet ($0.01) returned to AlissonStein
AlissonStein collected $0.02 from pot
AlissonStein: doesn't show hand 
*** SUMMARY ***
Total pot $0.02 | Rake $0 
Seat 1: HaG1BaT0R (button) folded before Flop (didn't bet)
Seat 2: lawlex_2 (small blind) folded before Flop
Seat 3: AlissonStein (big blind) collected ($0.02)
Seat 5: Piet-1503 folded before Flop (didn't bet)



PokerStars Hand #213574725609:  Hold'em No Limit ($0.01/$0.02 USD) - 2020/05/09 21:06:02 MSK [2020/05/09 14:06:02 ET]
Table 'Antiphos II' 6-max Seat #2 is the button
Seat 1: HaG1BaT0R ($3.86 in chips) 
Seat 2: lawlex_2 ($1.36 in chips) 
Seat 3: AlissonStein ($2.17 in chips) 
Seat 5: Piet-1503 ($3.68 in chips) 
AlissonStein: posts small blind $0.01
Piet-1503: posts big blind $0.02
Pbrasil13 has timed out
Pbrasil13: is sitting out 
*** HOLE CARDS ***
Dealt to lawlex_2 [6s Ac]
HaG1BaT0R: calls $0.02
Pbrasil13 is disconnected 
lawlex_2: raises $0.04 to $0.06
AlissonStein: folds 
Piet-1503: calls $0.04
HaG1BaT0R: calls $0.04
*** FLOP *** [7s Ks Ah]
Piet-1503: checks 
HaG1BaT0R: checks 
lawlex_2: checks 
*** TURN *** [7s Ks Ah] [2d]
Piet-1503: checks 
HaG1BaT0R: checks 
lawlex_2: bets $0.12
Piet-1503: folds 
HaG1BaT0R: folds 
Uncalled bet ($0.12) returned to lawlex_2
lawlex_2 collected $0.18 from pot
lawlex_2: doesn't show hand 
*** SUMMARY ***
Total pot $0.19 | Rake $0.01 
Board [7s Ks Ah 2d]
Seat 1: HaG1BaT0R folded on the Turn
Seat 2: lawlex_2 (button) collected ($0.18)
Seat 3: AlissonStein (small blind) folded before Flop
Seat 5: Piet-1503 (big blind) folded on the Turn



PokerStars Hand #213574777467:  Hold'em No Limit ($0.01/$0.02 USD) - 2020/05/09 21:06:51 MSK [2020/05/09 14:06:51 ET]
Table 'Antiphos II' 6-max Seat #3 is the button
Seat 1: HaG1BaT0R ($3.80 in chips) 
Seat 2: lawlex_2 ($1.48 in chips) 
Seat 3: AlissonStein ($2.16 in chips) 
Seat 5: Piet-1503 ($3.62 in chips) 
Seat 6: Pbrasil13 ($2 in chips) 
Piet-1503: posts small blind $0.01
Pbrasil13: posts big blind $0.02
*** HOLE CARDS ***
Dealt to lawlex_2 [6d Ah]
HaG1BaT0R: folds 
lawlex_2: raises $0.04 to $0.06
AlissonStein: folds 
Piet-1503: folds 
Pbrasil13: calls $0.04
*** FLOP *** [9d 2s Ts]
Pbrasil13: checks 
lawlex_2: checks 
*** TURN *** [9d 2s Ts] [Th]
Pbrasil13: checks 
lawlex_2: bets $0.07
Pbrasil13: calls $0.07
*** RIVER *** [9d 2s Ts Th] [2d]
Pbrasil13: bets $0.12
lawlex_2: folds 
Uncalled bet ($0.12) returned to Pbrasil13
Pbrasil13 collected $0.26 from pot
Pbrasil13: doesn't show hand 
*** SUMMARY ***
Total pot $0.27 | Rake $0.01 
Board [9d 2s Ts Th 2d]
Seat 1: HaG1BaT0R folded before Flop (didn't bet)
Seat 2: lawlex_2 folded on the River
Seat 3: AlissonStein (button) folded before Flop (didn't bet)
Seat 5: Piet-1503 (small blind) folded before Flop
Seat 6: Pbrasil13 (big blind) collected ($0.26)



PokerStars Hand #213574815753:  Hold'em No Limit ($0.01/$0.02 USD) - 2020/05/09 21:07:27 MSK [2020/05/09 14:07:27 ET]
Table 'Antiphos II' 6-max Seat #5 is the button
Seat 1: HaG1BaT0R ($3.80 in chips) 
Seat 2: lawlex_2 ($1.35 in chips) 
Seat 3: AlissonStein ($2.16 in chips) 
Seat 4: LocoU 10 ($2.17 in chips) 
Seat 5: Piet-1503 ($3.61 in chips) 
Seat 6: Pbrasil13 ($2.13 in chips) 
Pbrasil13: posts small blind $0.01
HaG1BaT0R: posts big blind $0.02
LocoU 10: posts small & big blinds $0.03
*** HOLE CARDS ***
Dealt to lawlex_2 [9h Ac]
lawlex_2: raises $0.04 to $0.06
AlissonStein: folds 
LocoU 10: calls $0.04
Piet-1503: folds 
Pbrasil13: calls $0.05
HaG1BaT0R: folds 
*** FLOP *** [Ad Js 7s]
Pbrasil13: checks 
lawlex_2: checks 
LocoU 10: checks 
*** TURN *** [Ad Js 7s] [4h]
Pbrasil13: checks 
lawlex_2: bets $0.13
LocoU 10: folds 
Pbrasil13: calls $0.13
*** RIVER *** [Ad Js 7s 4h] [4c]
Pbrasil13: bets $0.22
lawlex_2: calls $0.22
*** SHOW DOWN ***
Pbrasil13: shows [Jd 8s] (two pair, Jacks and Fours)
lawlex_2: shows [9h Ac] (two pair, Aces and Fours)
lawlex_2 collected $0.88 from pot
*** SUMMARY ***
Total pot $0.91 | Rake $0.03 
Board [Ad Js 7s 4h 4c]
Seat 1: HaG1BaT0R (big blind) folded before Flop
Seat 2: lawlex_2 showed [9h Ac] and won ($0.88) with two pair, Aces and Fours
Seat 3: AlissonStein folded before Flop (didn't bet)
Seat 4: LocoU 10 folded on the Turn
Seat 5: Piet-1503 (button) folded before Flop (didn't bet)
Seat 6: Pbrasil13 (small blind) showed [Jd 8s] and lost with two pair, Jacks and Fours



PokerStars Hand #213574865782:  Hold'em No Limit ($0.01/$0.02 USD) - 2020/05/09 21:08:14 MSK [2020/05/09 14:08:14 ET]
Table 'Antiphos II' 6-max Seat #6 is the button
Seat 1: HaG1BaT0R ($3.78 in chips) 
Seat 2: lawlex_2 ($1.82 in chips) 
Seat 3: AlissonStein ($2.16 in chips) 
Seat 4: LocoU 10 ($2.10 in chips) 
Seat 5: Piet-1503 ($3.61 in chips) 
Seat 6: Pbrasil13 ($1.72 in chips) 
HaG1BaT0R: posts small blind $0.01
lawlex_2: posts big blind $0.02
*** HOLE CARDS ***
Dealt to lawlex_2 [4s Ah]
AlissonStein: folds 
LocoU 10: raises $0.09 to $0.11
Piet-1503: folds 
Pbrasil13 is disconnected 
Pbrasil13 has timed out while disconnected
Pbrasil13: folds 
HaG1BaT0R: folds 
lawlex_2: folds 
Uncalled bet ($0.09) returned to LocoU 10
LocoU 10 collected $0.05 from pot
LocoU 10: doesn't show hand 
*** SUMMARY ***
Total pot $0.05 | Rake $0 
Seat 1: HaG1BaT0R (small blind) folded before Flop
Seat 2: lawlex_2 (big blind) folded before Flop
Seat 3: AlissonStein folded before Flop (didn't bet)
Seat 4: LocoU 10 collected ($0.05)
Seat 5: Piet-1503 folded before Flop (didn't bet)
Seat 6: Pbrasil13 (button) folded before Flop (didn't bet)



PokerStars Hand #213574901867:  Hold'em No Limit ($0.01/$0.02 USD) - 2020/05/09 21:08:48 MSK [2020/05/09 14:08:48 ET]
Table 'Antiphos II' 6-max Seat #1 is the button
Seat 1: HaG1BaT0R ($3.77 in chips) 
Seat 2: lawlex_2 ($1.80 in chips) 
Seat 3: AlissonStein ($2.16 in chips) 
Seat 4: LocoU 10 ($2.13 in chips) 
Seat 5: Piet-1503 ($3.61 in chips) 
Seat 6: Pbrasil13 ($1.72 in chips) 
lawlex_2: posts small blind $0.01
AlissonStein: posts big blind $0.02
*** HOLE CARDS ***
Dealt to lawlex_2 [As Ad]
LocoU 10: folds 
Piet-1503: calls $0.02
Pbrasil13: folds 
HaG1BaT0R: folds 
lawlex_2: calls $0.01
AlissonStein: checks 
*** FLOP *** [Js Th Ac]
lawlex_2: checks 
AlissonStein: checks 
Piet-1503: bets $0.05
lawlex_2: calls $0.05
AlissonStein: folds 
*** TURN *** [Js Th Ac] [Qd]
lawlex_2: checks 
Piet-1503: checks 
*** RIVER *** [Js Th Ac Qd] [Kd]
lawlex_2: bets $0.10
Piet-1503: raises $3.44 to $3.54 and is all-in
lawlex_2: calls $1.63 and is all-in
Uncalled bet ($1.81) returned to Piet-1503
*** SHOW DOWN ***
Piet-1503: shows [7s Ah] (a straight, Ten to Ace)
lawlex_2: shows [As Ad] (a straight, Ten to Ace)
lawlex_2 collected $1.75 from pot
Piet-1503 collected $1.74 from pot
*** SUMMARY ***
Total pot $3.62 | Rake $0.13 
Board [Js Th Ac Qd Kd]
Seat 1: HaG1BaT0R (button) folded before Flop (didn't bet)
Seat 2: lawlex_2 (small blind) showed [As Ad] and won ($1.75) with a straight, Ten to Ace
Seat 3: AlissonStein (big blind) folded on the Flop
Seat 4: LocoU 10 folded before Flop (didn't bet)
Seat 5: Piet-1503 showed [7s Ah] and won ($1.74) with a straight, Ten to Ace
Seat 6: Pbrasil13 folded before Flop (didn't bet)



PokerStars Hand #213574963465:  Hold'em No Limit ($0.01/$0.02 USD) - 2020/05/09 21:09:46 MSK [2020/05/09 14:09:46 ET]
Table 'Antiphos II' 6-max Seat #2 is the button
Seat 1: HaG1BaT0R ($3.77 in chips) 
Seat 2: lawlex_2 ($1.75 in chips) 
Seat 3: AlissonStein ($2.14 in chips) 
Seat 4: LocoU 10 ($2.13 in chips) 
Seat 5: Piet-1503 ($3.55 in chips) 
Seat 6: Pbrasil13 ($1.72 in chips) 
AlissonStein: posts small blind $0.01
LocoU 10: posts big blind $0.02
*** HOLE CARDS ***
Dealt to lawlex_2 [3s Ac]
Piet-1503: calls $0.02
Pbrasil13: folds 
HaG1BaT0R: raises $0.04 to $0.06
lawlex_2: folds 
AlissonStein: calls $0.05
LocoU 10: calls $0.04
Piet-1503: calls $0.04
*** FLOP *** [9d 3h 9s]
AlissonStein: checks 
LocoU 10: checks 
Piet-1503: checks 
HaG1BaT0R: checks 
*** TURN *** [9d 3h 9s] [Qh]
AlissonStein: checks 
LocoU 10: checks 
Piet-1503: checks 
HaG1BaT0R: bets $0.13
AlissonStein: calls $0.13
LocoU 10: folds 
Piet-1503: folds 
*** RIVER *** [9d 3h 9s Qh] [As]
AlissonStein: checks 
HaG1BaT0R: bets $0.36
AlissonStein: folds 
Uncalled bet ($0.36) returned to HaG1BaT0R
HaG1BaT0R collected $0.48 from pot
HaG1BaT0R: doesn't show hand 
*** SUMMARY ***
Total pot $0.50 | Rake $0.02 
Board [9d 3h 9s Qh As]
Seat 1: HaG1BaT0R collected ($0.48)
Seat 2: lawlex_2 (button) folded before Flop (didn't bet)
Seat 3: AlissonStein (small blind) folded on the River
Seat 4: LocoU 10 (big blind) folded on the Turn
Seat 5: Piet-1503 folded on the Turn
Seat 6: Pbrasil13 folded before Flop (didn't bet)



PokerStars Hand #213575037803:  Hold'em No Limit ($0.01/$0.02 USD) - 2020/05/09 21:10:52 MSK [2020/05/09 14:10:52 ET]
Table 'Antiphos II' 6-max Seat #3 is the button
Seat 1: HaG1BaT0R ($4.06 in chips) 
Seat 2: lawlex_2 ($1.75 in chips) 
Seat 3: AlissonStein ($1.95 in chips) 
Seat 4: LocoU 10 ($2.07 in chips) 
Seat 5: Piet-1503 ($3.49 in chips) 
Seat 6: Pbrasil13 ($1.72 in chips) 
LocoU 10: posts small blind $0.01
Piet-1503: posts big blind $0.02
*** HOLE CARDS ***
Dealt to lawlex_2 [3c Qs]
Pbrasil13 is disconnected 
Pbrasil13 has timed out while disconnected
Pbrasil13: folds 
HaG1BaT0R: folds 
lawlex_2: folds 
AlissonStein: folds 
LocoU 10: calls $0.01
Piet-1503: checks 
*** FLOP *** [Kd Td Tc]
LocoU 10: checks 
Piet-1503: checks 
*** TURN *** [Kd Td Tc] [8h]
LocoU 10: bets $0.04
Piet-1503: folds 
Uncalled bet ($0.04) returned to LocoU 10
LocoU 10 collected $0.04 from pot
LocoU 10: doesn't show hand 
*** SUMMARY ***
Total pot $0.04 | Rake $0 
Board [Kd Td Tc 8h]
Seat 1: HaG1BaT0R folded before Flop (didn't bet)
Seat 2: lawlex_2 folded before Flop (didn't bet)
Seat 3: AlissonStein (button) folded before Flop (didn't bet)
Seat 4: LocoU 10 (small blind) collected ($0.04)
Seat 5: Piet-1503 (big blind) folded on the Turn
Seat 6: Pbrasil13 folded before Flop (didn't bet)



PokerStars Hand #213575070654:  Hold'em No Limit ($0.01/$0.02 USD) - 2020/05/09 21:11:23 MSK [2020/05/09 14:11:23 ET]
Table 'Antiphos II' 6-max Seat #4 is the button
Seat 1: HaG1BaT0R ($4.06 in chips) 
Seat 2: lawlex_2 ($1.75 in chips) 
Seat 3: AlissonStein ($1.95 in chips) 
Seat 4: LocoU 10 ($2.09 in chips) 
Seat 5: Piet-1503 ($3.47 in chips) 
Piet-1503: posts small blind $0.01
HaG1BaT0R: posts big blind $0.02
*** HOLE CARDS ***
Dealt to lawlex_2 [Qd Kh]
lawlex_2: raises $0.04 to $0.06
AlissonStein: folds 
LocoU 10: folds 
Piet-1503: calls $0.05
HaG1BaT0R: folds 
*** FLOP *** [3d Ah 5c]
Piet-1503: checks 
lawlex_2: checks 
*** TURN *** [3d Ah 5c] [7d]
Piet-1503: checks 
lawlex_2: checks 
*** RIVER *** [3d Ah 5c 7d] [2c]
Piet-1503: checks 
lawlex_2: bets $0.07
Piet-1503: calls $0.07
*** SHOW DOWN ***
lawlex_2: shows [Qd Kh] (high card Ace)
Piet-1503: shows [8h 8c] (a pair of Eights)
Piet-1503 collected $0.27 from pot
*** SUMMARY ***
Total pot $0.28 | Rake $0.01 
Board [3d Ah 5c 7d 2c]
Seat 1: HaG1BaT0R (big blind) folded before Flop
Seat 2: lawlex_2 showed [Qd Kh] and lost with high card Ace
Seat 3: AlissonStein folded before Flop (didn't bet)
Seat 4: LocoU 10 (button) folded before Flop (didn't bet)
Seat 5: Piet-1503 (small blind) showed [8h 8c] and won ($0.27) with a pair of Eights



PokerStars Hand #213575104542:  Hold'em No Limit ($0.01/$0.02 USD) - 2020/05/09 21:11:55 MSK [2020/05/09 14:11:55 ET]
Table 'Antiphos II' 6-max Seat #5 is the button
Seat 1: HaG1BaT0R ($4.04 in chips) 
Seat 2: lawlex_2 ($1.62 in chips) 
Seat 3: AlissonStein ($1.95 in chips) 
Seat 4: LocoU 10 ($2.09 in chips) 
Seat 5: Piet-1503 ($3.61 in chips) 
HaG1BaT0R: posts small blind $0.01
lawlex_2: posts big blind $0.02
*** HOLE CARDS ***
Dealt to lawlex_2 [Ah Ac]
AlissonStein: folds 
LocoU 10: folds 
Piet-1503: calls $0.02
HaG1BaT0R: calls $0.01
lawlex_2: checks 
*** FLOP *** [6c 2s 4d]
HaG1BaT0R: checks 
lawlex_2: checks 
Piet-1503: checks 
*** TURN *** [6c 2s 4d] [5s]
HaG1BaT0R: checks 
lawlex_2: bets $0.02
Piet-1503: calls $0.02
HaG1BaT0R: folds 
*** RIVER *** [6c 2s 4d 5s] [Ts]
lawlex_2: bets $0.07
Piet-1503: calls $0.07
*** SHOW DOWN ***
lawlex_2: shows [Ah Ac] (a pair of Aces)
Piet-1503: mucks hand 
lawlex_2 collected $0.23 from pot
*** SUMMARY ***
Total pot $0.24 | Rake $0.01 
Board [6c 2s 4d 5s Ts]
Seat 1: HaG1BaT0R (small blind) folded on the Turn
Seat 2: lawlex_2 (big blind) showed [Ah Ac] and won ($0.23) with a pair of Aces
Seat 3: AlissonStein folded before Flop (didn't bet)
Seat 4: LocoU 10 folded before Flop (didn't bet)
Seat 5: Piet-1503 (button) mucked [5h Qh]



PokerStars Hand #213575140719:  Hold'em No Limit ($0.01/$0.02 USD) - 2020/05/09 21:12:29 MSK [2020/05/09 14:12:29 ET]
Table 'Antiphos II' 6-max Seat #1 is the button
Seat 1: HaG1BaT0R ($4.02 in chips) 
Seat 2: lawlex_2 ($1.74 in chips) 
Seat 3: AlissonStein ($1.95 in chips) 
Seat 4: LocoU 10 ($2.09 in chips) 
Seat 5: Piet-1503 ($3.50 in chips) 
lawlex_2: posts small blind $0.01
AlissonStein: posts big blind $0.02
*** HOLE CARDS ***
Dealt to lawlex_2 [Qh 8c]
LocoU 10: folds 
Piet-1503: folds 
HaG1BaT0R: raises $0.04 to $0.06
lawlex_2: folds 
AlissonStein: calls $0.04
*** FLOP *** [Jc 2d Tc]
AlissonStein: checks 
HaG1BaT0R: bets $0.10
AlissonStein: folds 
Uncalled bet ($0.10) returned to HaG1BaT0R
HaG1BaT0R collected $0.13 from pot
HaG1BaT0R: doesn't show hand 
*** SUMMARY ***
Total pot $0.13 | Rake $0 
Board [Jc 2d Tc]
Seat 1: HaG1BaT0R (button) collected ($0.13)
Seat 2: lawlex_2 (small blind) folded before Flop
Seat 3: AlissonStein (big blind) folded on the Flop
Seat 4: LocoU 10 folded before Flop (didn't bet)
Seat 5: Piet-1503 folded before Flop (didn't bet)



PokerStars Hand #213575165708:  Hold'em No Limit ($0.01/$0.02 USD) - 2020/05/09 21:12:52 MSK [2020/05/09 14:12:52 ET]
Table 'Antiphos II' 6-max Seat #2 is the button
Seat 1: HaG1BaT0R ($4.09 in chips) 
Seat 2: lawlex_2 ($1.73 in chips) 
Seat 3: AlissonStein ($1.89 in chips) 
Seat 4: LocoU 10 ($2.09 in chips) 
Seat 5: Piet-1503 ($3.50 in chips) 
AlissonStein: posts small blind $0.01
LocoU 10: posts big blind $0.02
*** HOLE CARDS ***
Dealt to lawlex_2 [3c 5c]
Piet-1503: folds 
HaG1BaT0R: folds 
lawlex_2: folds 
AlissonStein: folds 
Uncalled bet ($0.01) returned to LocoU 10
LocoU 10 collected $0.02 from pot
LocoU 10: doesn't show hand 
*** SUMMARY ***
Total pot $0.02 | Rake $0 
Seat 1: HaG1BaT0R folded before Flop (didn't bet)
Seat 2: lawlex_2 (button) folded before Flop (didn't bet)
Seat 3: AlissonStein (small blind) folded before Flop
Seat 4: LocoU 10 (big blind) collected ($0.02)
Seat 5: Piet-1503 folded before Flop (didn't bet)



PokerStars Hand #213575179797:  Hold'em No Limit ($0.01/$0.02 USD) - 2020/05/09 21:13:06 MSK [2020/05/09 14:13:06 ET]
Table 'Antiphos II' 6-max Seat #3 is the button
Seat 1: HaG1BaT0R ($4.09 in chips) 
Seat 2: lawlex_2 ($1.73 in chips) 
Seat 3: AlissonStein ($1.88 in chips) 
Seat 4: LocoU 10 ($2.10 in chips) 
Seat 5: Piet-1503 ($3.50 in chips) 
LocoU 10: posts small blind $0.01
Piet-1503: posts big blind $0.02
*** HOLE CARDS ***
Dealt to lawlex_2 [Qs 4c]
HaG1BaT0R: folds 
lawlex_2: folds 
AlissonStein: raises $0.04 to $0.06
LocoU 10: calls $0.05
Piet-1503: calls $0.04
*** FLOP *** [Kd 3c 8s]
LocoU 10: bets $0.16
Piet-1503: folds 
AlissonStein: folds 
Uncalled bet ($0.16) returned to LocoU 10
LocoU 10 collected $0.17 from pot
LocoU 10: doesn't show hand 
*** SUMMARY ***
Total pot $0.18 | Rake $0.01 
Board [Kd 3c 8s]
Seat 1: HaG1BaT0R folded before Flop (didn't bet)
Seat 2: lawlex_2 folded before Flop (didn't bet)
Seat 3: AlissonStein (button) folded on the Flop
Seat 4: LocoU 10 (small blind) collected ($0.17)
Seat 5: Piet-1503 (big blind) folded on the Flop



PokerStars Hand #213575205196:  Hold'em No Limit ($0.01/$0.02 USD) - 2020/05/09 21:13:30 MSK [2020/05/09 14:13:30 ET]
Table 'Antiphos II' 6-max Seat #4 is the button
Seat 1: HaG1BaT0R ($4.09 in chips) 
Seat 2: lawlex_2 ($1.73 in chips) 
Seat 3: AlissonStein ($1.82 in chips) 
Seat 4: LocoU 10 ($2.21 in chips) 
Seat 5: Piet-1503 ($3.44 in chips) 
Piet-1503: posts small blind $0.01
HaG1BaT0R: posts big blind $0.02
*** HOLE CARDS ***
Dealt to lawlex_2 [5h Th]
lawlex_2: folds 
AlissonStein: raises $0.04 to $0.06
LocoU 10: folds 
Piet-1503: folds 
HaG1BaT0R: folds 
Uncalled bet ($0.04) returned to AlissonStein
AlissonStein collected $0.05 from pot
AlissonStein: doesn't show hand 
*** SUMMARY ***
Total pot $0.05 | Rake $0 
Seat 1: HaG1BaT0R (big blind) folded before Flop
Seat 2: lawlex_2 folded before Flop (didn't bet)
Seat 3: AlissonStein collected ($0.05)
Seat 4: LocoU 10 (button) folded before Flop (didn't bet)
Seat 5: Piet-1503 (small blind) folded before Flop



PokerStars Hand #213575217955:  Hold'em No Limit ($0.01/$0.02 USD) - 2020/05/09 21:13:43 MSK [2020/05/09 14:13:43 ET]
Table 'Antiphos II' 6-max Seat #5 is the button
Seat 1: HaG1BaT0R ($4.07 in chips) 
Seat 2: lawlex_2 ($1.73 in chips) 
Seat 3: AlissonStein ($1.85 in chips) 
Seat 4: LocoU 10 ($2.21 in chips) 
Seat 5: Piet-1503 ($3.43 in chips) 
HaG1BaT0R: posts small blind $0.01
lawlex_2: posts big blind $0.02
*** HOLE CARDS ***
Dealt to lawlex_2 [Kh 8h]
AlissonStein: folds 
LocoU 10: calls $0.02
Piet-1503: calls $0.02
HaG1BaT0R: calls $0.01
lawlex_2: raises $0.04 to $0.06
LocoU 10: folds 
Piet-1503: calls $0.04
HaG1BaT0R: folds 
*** FLOP *** [4s 9d 3c]
lawlex_2: bets $0.10
Piet-1503: calls $0.10
*** TURN *** [4s 9d 3c] [4d]
lawlex_2: checks 
Piet-1503: checks 
*** RIVER *** [4s 9d 3c 4d] [5c]
lawlex_2: checks 
Piet-1503: checks 
*** SHOW DOWN ***
lawlex_2: shows [Kh 8h] (a pair of Fours)
Piet-1503: shows [8c Kc] (a pair of Fours)
lawlex_2 collected $0.18 from pot
Piet-1503 collected $0.17 from pot
*** SUMMARY ***
Total pot $0.36 | Rake $0.01 
Board [4s 9d 3c 4d 5c]
Seat 1: HaG1BaT0R (small blind) folded before Flop
Seat 2: lawlex_2 (big blind) showed [Kh 8h] and won ($0.18) with a pair of Fours
Seat 3: AlissonStein folded before Flop (didn't bet)
Seat 4: LocoU 10 folded before Flop
Seat 5: Piet-1503 (button) showed [8c Kc] and won ($0.17) with a pair of Fours



PokerStars Hand #213575260437:  Hold'em No Limit ($0.01/$0.02 USD) - 2020/05/09 21:14:23 MSK [2020/05/09 14:14:23 ET]
Table 'Antiphos II' 6-max Seat #1 is the button
Seat 1: HaG1BaT0R ($4.05 in chips) 
Seat 2: lawlex_2 ($1.75 in chips) 
Seat 3: AlissonStein ($1.85 in chips) 
Seat 4: LocoU 10 ($2.19 in chips) 
Seat 5: Piet-1503 ($3.44 in chips) 
lawlex_2: posts small blind $0.01
AlissonStein: posts big blind $0.02
*** HOLE CARDS ***
Dealt to lawlex_2 [2d Js]
LocoU 10: folds 
Piet-1503: raises $0.04 to $0.06
HaG1BaT0R: folds 
lawlex_2: folds 
AlissonStein: folds 
Uncalled bet ($0.04) returned to Piet-1503
Piet-1503 collected $0.05 from pot
Piet-1503: doesn't show hand 
*** SUMMARY ***
Total pot $0.05 | Rake $0 
Seat 1: HaG1BaT0R (button) folded before Flop (didn't bet)
Seat 2: lawlex_2 (small blind) folded before Flop
Seat 3: AlissonStein (big blind) folded before Flop
Seat 4: LocoU 10 folded before Flop (didn't bet)
Seat 5: Piet-1503 collected ($0.05)



PokerStars Hand #213575277164:  Hold'em No Limit ($0.01/$0.02 USD) - 2020/05/09 21:14:40 MSK [2020/05/09 14:14:40 ET]
Table 'Antiphos II' 6-max Seat #2 is the button
Seat 1: HaG1BaT0R ($4.05 in chips) 
Seat 2: lawlex_2 ($1.74 in chips) 
Seat 3: AlissonStein ($1.83 in chips) 
Seat 4: LocoU 10 ($2.19 in chips) 
Seat 5: Piet-1503 ($3.47 in chips) 
AlissonStein: posts small blind $0.01
LocoU 10: posts big blind $0.02
*** HOLE CARDS ***
Dealt to lawlex_2 [Ah 6s]
Piet-1503: calls $0.02
HaG1BaT0R: folds 
lawlex_2: raises $0.04 to $0.06
AlissonStein: folds 
LocoU 10: calls $0.04
Piet-1503: calls $0.04
*** FLOP *** [Jd Kh Jh]
LocoU 10: checks 
Piet-1503: checks 
lawlex_2: checks 
*** TURN *** [Jd Kh Jh] [Ts]
LocoU 10: bets $0.02
Piet-1503: calls $0.02
lawlex_2: calls $0.02
*** RIVER *** [Jd Kh Jh Ts] [8c]
LocoU 10: bets $0.02
Piet-1503: folds 
lawlex_2: folds 
Uncalled bet ($0.02) returned to LocoU 10
LocoU 10 collected $0.24 from pot
LocoU 10: doesn't show hand 
*** SUMMARY ***
Total pot $0.25 | Rake $0.01 
Board [Jd Kh Jh Ts 8c]
Seat 1: HaG1BaT0R folded before Flop (didn't bet)
Seat 2: lawlex_2 (button) folded on the River
Seat 3: AlissonStein (small blind) folded before Flop
Seat 4: LocoU 10 (big blind) collected ($0.24)
Seat 5: Piet-1503 folded on the River



PokerStars Hand #213575327490:  Hold'em No Limit ($0.01/$0.02 USD) - 2020/05/09 21:15:25 MSK [2020/05/09 14:15:25 ET]
Table 'Antiphos II' 6-max Seat #3 is the button
Seat 1: HaG1BaT0R ($4.05 in chips) 
Seat 2: lawlex_2 ($1.66 in chips) 
Seat 3: AlissonStein ($1.82 in chips) 
Seat 4: LocoU 10 ($2.35 in chips) 
Seat 5: Piet-1503 ($3.39 in chips) 
LocoU 10: posts small blind $0.01
Piet-1503: posts big blind $0.02
*** HOLE CARDS ***
Dealt to lawlex_2 [Tc Td]
HaG1BaT0R: folds 
lawlex_2: calls $0.02
AlissonStein: folds 
LocoU 10: folds 
Piet-1503: raises $0.04 to $0.06
lawlex_2: calls $0.04
*** FLOP *** [7d Qc 8d]
Piet-1503: bets $0.07
lawlex_2: calls $0.07
*** TURN *** [7d Qc 8d] [5s]
Piet-1503: checks 
lawlex_2: checks 
*** RIVER *** [7d Qc 8d 5s] [Qd]
Piet-1503: checks 
lawlex_2: checks 
*** SHOW DOWN ***
Piet-1503: shows [6d 6s] (two pair, Queens and Sixes)
lawlex_2: shows [Tc Td] (two pair, Queens and Tens)
lawlex_2 collected $0.26 from pot
*** SUMMARY ***
Total pot $0.27 | Rake $0.01 
Board [7d Qc 8d 5s Qd]
Seat 1: HaG1BaT0R folded before Flop (didn't bet)
Seat 2: lawlex_2 showed [Tc Td] and won ($0.26) with two pair, Queens and Tens
Seat 3: AlissonStein (button) folded before Flop (didn't bet)
Seat 4: LocoU 10 (small blind) folded before Flop
Seat 5: Piet-1503 (big blind) showed [6d 6s] and lost with two pair, Queens and Sixes



PokerStars Hand #213575363156:  Hold'em No Limit ($0.01/$0.02 USD) - 2020/05/09 21:15:59 MSK [2020/05/09 14:15:59 ET]
Table 'Antiphos II' 6-max Seat #4 is the button
Seat 1: HaG1BaT0R ($4.05 in chips) 
Seat 2: lawlex_2 ($1.79 in chips) 
Seat 3: AlissonStein ($1.82 in chips) 
Seat 4: LocoU 10 ($2.34 in chips) 
Seat 5: Piet-1503 ($3.26 in chips) 
Piet-1503: posts small blind $0.01
HaG1BaT0R: posts big blind $0.02
*** HOLE CARDS ***
Dealt to lawlex_2 [6h Kh]
lawlex_2: raises $0.04 to $0.06
AlissonStein: folds 
LocoU 10: folds 
Piet-1503: folds 
HaG1BaT0R: folds 
Uncalled bet ($0.04) returned to lawlex_2
lawlex_2 collected $0.05 from pot
lawlex_2: doesn't show hand 
*** SUMMARY ***
Total pot $0.05 | Rake $0 
Seat 1: HaG1BaT0R (big blind) folded before Flop
Seat 2: lawlex_2 collected ($0.05)
Seat 3: AlissonStein folded before Flop (didn't bet)
Seat 4: LocoU 10 (button) folded before Flop (didn't bet)
Seat 5: Piet-1503 (small blind) folded before Flop



PokerStars Hand #213575379350:  Hold'em No Limit ($0.01/$0.02 USD) - 2020/05/09 21:16:14 MSK [2020/05/09 14:16:14 ET]
Table 'Antiphos II' 6-max Seat #5 is the button
Seat 1: HaG1BaT0R ($4.03 in chips) 
Seat 2: lawlex_2 ($1.82 in chips) 
Seat 3: AlissonStein ($1.82 in chips) 
Seat 4: LocoU 10 ($2.34 in chips) 
Seat 5: Piet-1503 ($3.25 in chips) 
HaG1BaT0R: posts small blind $0.01
lawlex_2: posts big blind $0.02
*** HOLE CARDS ***
Dealt to lawlex_2 [5h Jd]
AlissonStein: folds 
LocoU 10: folds 
Piet-1503: folds 
HaG1BaT0R: folds 
Uncalled bet ($0.01) returned to lawlex_2
lawlex_2 collected $0.02 from pot
lawlex_2: doesn't show hand 
*** SUMMARY ***
Total pot $0.02 | Rake $0 
Seat 1: HaG1BaT0R (small blind) folded before Flop
Seat 2: lawlex_2 (big blind) collected ($0.02)
Seat 3: AlissonStein folded before Flop (didn't bet)
Seat 4: LocoU 10 folded before Flop (didn't bet)
Seat 5: Piet-1503 (button) folded before Flop (didn't bet)



PokerStars Hand #213575402712:  Hold'em No Limit ($0.01/$0.02 USD) - 2020/05/09 21:16:29 MSK [2020/05/09 14:16:29 ET]
Table 'Antiphos II' 6-max Seat #1 is the button
Seat 1: HaG1BaT0R ($4.02 in chips) 
Seat 2: lawlex_2 ($1.83 in chips) 
Seat 3: AlissonStein ($1.82 in chips) 
Seat 4: LocoU 10 ($2.34 in chips) 
Seat 5: Piet-1503 ($3.25 in chips) 
lawlex_2: posts small blind $0.01
AlissonStein: posts big blind $0.02
*** HOLE CARDS ***
Dealt to lawlex_2 [Tc Kd]
LocoU 10: raises $0.13 to $0.15
Piet-1503: folds 
HaG1BaT0R: folds 
lawlex_2: folds 
AlissonStein: folds 
Uncalled bet ($0.13) returned to LocoU 10
LocoU 10 collected $0.05 from pot
LocoU 10: doesn't show hand 
*** SUMMARY ***
Total pot $0.05 | Rake $0 
Seat 1: HaG1BaT0R (button) folded before Flop (didn't bet)
Seat 2: lawlex_2 (small blind) folded before Flop
Seat 3: AlissonStein (big blind) folded before Flop
Seat 4: LocoU 10 collected ($0.05)
Seat 5: Piet-1503 folded before Flop (didn't bet)



PokerStars Hand #213575421955:  Hold'em No Limit ($0.01/$0.02 USD) - 2020/05/09 21:16:47 MSK [2020/05/09 14:16:47 ET]
Table 'Antiphos II' 6-max Seat #2 is the button
Seat 1: HaG1BaT0R ($4.02 in chips) 
Seat 2: lawlex_2 ($1.82 in chips) 
Seat 3: AlissonStein ($1.80 in chips) 
Seat 4: LocoU 10 ($2.37 in chips) 
Seat 5: Piet-1503 ($3.25 in chips) 
AlissonStein: posts small blind $0.01
LocoU 10: posts big blind $0.02
*** HOLE CARDS ***
Dealt to lawlex_2 [5s Jd]
Piet-1503: folds 
HaG1BaT0R: raises $0.04 to $0.06
lawlex_2: folds 
AlissonStein: calls $0.05
LocoU 10: calls $0.04
*** FLOP *** [5c Th 2c]
AlissonStein: checks 
LocoU 10: checks 
HaG1BaT0R: checks 
*** TURN *** [5c Th 2c] [8d]
AlissonStein: bets $0.09
LocoU 10: folds 
HaG1BaT0R: folds 
Uncalled bet ($0.09) returned to AlissonStein
AlissonStein collected $0.17 from pot
AlissonStein: doesn't show hand 
*** SUMMARY ***
Total pot $0.18 | Rake $0.01 
Board [5c Th 2c 8d]
Seat 1: HaG1BaT0R folded on the Turn
Seat 2: lawlex_2 (button) folded before Flop (didn't bet)
Seat 3: AlissonStein (small blind) collected ($0.17)
Seat 4: LocoU 10 (big blind) folded on the Turn
Seat 5: Piet-1503 folded before Flop (didn't bet)



PokerStars Hand #213575455063:  Hold'em No Limit ($0.01/$0.02 USD) - 2020/05/09 21:17:17 MSK [2020/05/09 14:17:17 ET]
Table 'Antiphos II' 6-max Seat #3 is the button
Seat 1: HaG1BaT0R ($3.96 in chips) 
Seat 2: lawlex_2 ($1.82 in chips) 
Seat 3: AlissonStein ($1.91 in chips) 
Seat 4: LocoU 10 ($2.31 in chips) 
Seat 5: Piet-1503 ($3.25 in chips) 
LocoU 10: posts small blind $0.01
Piet-1503: posts big blind $0.02
*** HOLE CARDS ***
Dealt to lawlex_2 [Kh Ac]
HaG1BaT0R: folds 
lawlex_2: raises $0.04 to $0.06
AlissonStein: folds 
LocoU 10: folds 
Piet-1503: calls $0.04
*** FLOP *** [7s Ad 6h]
Piet-1503: checks 
lawlex_2: checks 
*** TURN *** [7s Ad 6h] [3h]
Piet-1503: checks 
lawlex_2: bets $0.09
Piet-1503: folds 
Uncalled bet ($0.09) returned to lawlex_2
lawlex_2 collected $0.13 from pot
lawlex_2: doesn't show hand 
*** SUMMARY ***
Total pot $0.13 | Rake $0 
Board [7s Ad 6h 3h]
Seat 1: HaG1BaT0R folded before Flop (didn't bet)
Seat 2: lawlex_2 collected ($0.13)
Seat 3: AlissonStein (button) folded before Flop (didn't bet)
Seat 4: LocoU 10 (small blind) folded before Flop
Seat 5: Piet-1503 (big blind) folded on the Turn



PokerStars Hand #213575480673:  Hold'em No Limit ($0.01/$0.02 USD) - 2020/05/09 21:17:41 MSK [2020/05/09 14:17:41 ET]
Table 'Antiphos II' 6-max Seat #4 is the button
Seat 1: HaG1BaT0R ($3.96 in chips) 
Seat 2: lawlex_2 ($1.89 in chips) 
Seat 3: AlissonStein ($1.91 in chips) 
Seat 4: LocoU 10 ($2.30 in chips) 
Seat 5: Piet-1503 ($3.19 in chips) 
Piet-1503: posts small blind $0.01
HaG1BaT0R: posts big blind $0.02
*** HOLE CARDS ***
Dealt to lawlex_2 [Td 6h]
lawlex_2: folds 
AlissonStein: raises $0.04 to $0.06
LocoU 10: folds 
Piet-1503: folds 
HaG1BaT0R: folds 
Uncalled bet ($0.04) returned to AlissonStein
AlissonStein collected $0.05 from pot
Pbrasil13 was removed from the table for failing to post
Pbrasil13 leaves the table
AlissonStein: doesn't show hand 
*** SUMMARY ***
Total pot $0.05 | Rake $0 
Seat 1: HaG1BaT0R (big blind) folded before Flop
Seat 2: lawlex_2 folded before Flop (didn't bet)
Seat 3: AlissonStein collected ($0.05)
Seat 4: LocoU 10 (button) folded before Flop (didn't bet)
Seat 5: Piet-1503 (small blind) folded before Flop



PokerStars Hand #213575492005:  Hold'em No Limit ($0.01/$0.02 USD) - 2020/05/09 21:17:51 MSK [2020/05/09 14:17:51 ET]
Table 'Antiphos II' 6-max Seat #5 is the button
Seat 1: HaG1BaT0R ($3.94 in chips) 
Seat 2: lawlex_2 ($1.89 in chips) 
Seat 3: AlissonStein ($1.94 in chips) 
Seat 4: LocoU 10 ($2.30 in chips) 
Seat 5: Piet-1503 ($3.18 in chips) 
HaG1BaT0R: posts small blind $0.01
lawlex_2: posts big blind $0.02
*** HOLE CARDS ***
Dealt to lawlex_2 [Ad Kh]
AlissonStein: folds 
edeildo joins the table at seat #6 
LocoU 10: raises $0.04 to $0.06
Piet-1503: calls $0.06
HaG1BaT0R: folds 
lawlex_2: calls $0.04
*** FLOP *** [2h Qc Qh]
lawlex_2: checks 
LocoU 10: checks 
Piet-1503: checks 
*** TURN *** [2h Qc Qh] [9c]
lawlex_2: bets $0.09
LocoU 10: folds 
Piet-1503: folds 
Uncalled bet ($0.09) returned to lawlex_2
lawlex_2 collected $0.18 from pot
lawlex_2: doesn't show hand 
*** SUMMARY ***
Total pot $0.19 | Rake $0.01 
Board [2h Qc Qh 9c]
Seat 1: HaG1BaT0R (small blind) folded before Flop
Seat 2: lawlex_2 (big blind) collected ($0.18)
Seat 3: AlissonStein folded before Flop (didn't bet)
Seat 4: LocoU 10 folded on the Turn
Seat 5: Piet-1503 (button) folded on the Turn



PokerStars Hand #213575537841:  Hold'em No Limit ($0.01/$0.02 USD) - 2020/05/09 21:18:34 MSK [2020/05/09 14:18:34 ET]
Table 'Antiphos II' 6-max Seat #1 is the button
Seat 1: HaG1BaT0R ($3.93 in chips) 
Seat 2: lawlex_2 ($2.01 in chips) 
Seat 3: AlissonStein ($1.94 in chips) 
Seat 4: LocoU 10 ($2.24 in chips) 
Seat 5: Piet-1503 ($3.12 in chips) 
Seat 6: edeildo ($0.80 in chips) 
lawlex_2: posts small blind $0.01
AlissonStein: posts big blind $0.02
edeildo: posts big blind $0.02
*** HOLE CARDS ***
Dealt to lawlex_2 [3s 4d]
LocoU 10: raises $0.04 to $0.06
Piet-1503: folds 
edeildo: calls $0.04
HaG1BaT0R: calls $0.06
lawlex_2: folds 
AlissonStein: calls $0.04
*** FLOP *** [8d Kc 5s]
AlissonStein: checks 
LocoU 10: checks 
edeildo: bets $0.02
HaG1BaT0R: calls $0.02
AlissonStein: calls $0.02
LocoU 10: calls $0.02
*** TURN *** [8d Kc 5s] [5d]
AlissonStein: checks 
LocoU 10: checks 
edeildo: bets $0.10
HaG1BaT0R: folds 
AlissonStein: calls $0.10
LocoU 10: folds 
*** RIVER *** [8d Kc 5s 5d] [Ah]
AlissonStein: checks 
edeildo: checks 
*** SHOW DOWN ***
AlissonStein: shows [Qd 9d] (a pair of Fives)
edeildo: shows [2h Ks] (two pair, Kings and Fives)
edeildo collected $0.51 from pot
*** SUMMARY ***
Total pot $0.53 | Rake $0.02 
Board [8d Kc 5s 5d Ah]
Seat 1: HaG1BaT0R (button) folded on the Turn
Seat 2: lawlex_2 (small blind) folded before Flop
Seat 3: AlissonStein (big blind) showed [Qd 9d] and lost with a pair of Fives
Seat 4: LocoU 10 folded on the Turn
Seat 5: Piet-1503 folded before Flop (didn't bet)
Seat 6: edeildo showed [2h Ks] and won ($0.51) with two pair, Kings and Fives



PokerStars Hand #213575599757:  Hold'em No Limit ($0.01/$0.02 USD) - 2020/05/09 21:19:31 MSK [2020/05/09 14:19:31 ET]
Table 'Antiphos II' 6-max Seat #2 is the button
Seat 1: HaG1BaT0R ($3.85 in chips) 
Seat 2: lawlex_2 ($2 in chips) 
Seat 3: AlissonStein ($1.76 in chips) 
Seat 4: LocoU 10 ($2.16 in chips) 
Seat 5: Piet-1503 ($3.12 in chips) 
Seat 6: edeildo ($1.13 in chips) 
AlissonStein: posts small blind $0.01
LocoU 10: posts big blind $0.02
*** HOLE CARDS ***
Dealt to lawlex_2 [6c 2h]
Piet-1503: raises $0.04 to $0.06
edeildo: calls $0.06
HaG1BaT0R: folds 
lawlex_2: folds 
AlissonStein: folds 
LocoU 10: raises $0.04 to $0.10
Piet-1503: raises $0.08 to $0.18
edeildo: calls $0.12
LocoU 10: calls $0.08
*** FLOP *** [Ks 2s 3h]
LocoU 10: checks 
Piet-1503: bets $0.27
edeildo: folds 
LocoU 10: folds 
Uncalled bet ($0.27) returned to Piet-1503
Piet-1503 collected $0.53 from pot
Piet-1503: doesn't show hand 
*** SUMMARY ***
Total pot $0.55 | Rake $0.02 
Board [Ks 2s 3h]
Seat 1: HaG1BaT0R folded before Flop (didn't bet)
Seat 2: lawlex_2 (button) folded before Flop (didn't bet)
Seat 3: AlissonStein (small blind) folded before Flop
Seat 4: LocoU 10 (big blind) folded on the Flop
Seat 5: Piet-1503 collected ($0.53)
Seat 6: edeildo folded on the Flop



PokerStars Hand #213575671508:  Hold'em No Limit ($0.01/$0.02 USD) - 2020/05/09 21:20:38 MSK [2020/05/09 14:20:38 ET]
Table 'Antiphos II' 6-max Seat #3 is the button
Seat 1: HaG1BaT0R ($3.85 in chips) 
Seat 2: lawlex_2 ($2 in chips) 
Seat 3: AlissonStein ($1.75 in chips) 
Seat 4: LocoU 10 ($1.98 in chips) 
Seat 5: Piet-1503 ($3.47 in chips) 
Seat 6: edeildo ($0.95 in chips) 
LocoU 10: posts small blind $0.01
Piet-1503: posts big blind $0.02
*** HOLE CARDS ***
Dealt to lawlex_2 [Jd Jh]
edeildo: folds 
HaG1BaT0R: folds 
lawlex_2 has timed out
lawlex_2: folds 
AlissonStein: raises $0.04 to $0.06
LocoU 10: folds 
Piet-1503: folds 
Uncalled bet ($0.04) returned to AlissonStein
AlissonStein collected $0.05 from pot
AlissonStein: doesn't show hand 
*** SUMMARY ***
Total pot $0.05 | Rake $0 
Seat 1: HaG1BaT0R folded before Flop (didn't bet)
Seat 2: lawlex_2 folded before Flop (didn't bet)
Seat 3: AlissonStein (button) collected ($0.05)
Seat 4: LocoU 10 (small blind) folded before Flop
Seat 5: Piet-1503 (big blind) folded before Flop
Seat 6: edeildo folded before Flop (didn't bet)



PokerStars Hand #213575695054:  Hold'em No Limit ($0.01/$0.02 USD) - 2020/05/09 21:21:00 MSK [2020/05/09 14:21:00 ET]
Table 'Antiphos II' 6-max Seat #4 is the button
Seat 1: HaG1BaT0R ($3.85 in chips) 
Seat 2: lawlex_2 ($2 in chips) 
Seat 3: AlissonStein ($1.78 in chips) 
Seat 4: LocoU 10 ($1.97 in chips) 
Seat 5: Piet-1503 ($3.45 in chips) 
Seat 6: edeildo ($0.95 in chips) 
Piet-1503: posts small blind $0.01
edeildo: posts big blind $0.02
*** HOLE CARDS ***
Dealt to lawlex_2 [3c 5d]
HaG1BaT0R: folds 
lawlex_2: folds 
AlissonStein: folds 
LocoU 10: calls $0.02
Piet-1503: calls $0.01
edeildo: checks 
*** FLOP *** [Ah Tc 4h]
Piet-1503: checks 
edeildo: checks 
LocoU 10: checks 
*** TURN *** [Ah Tc 4h] [Th]
Piet-1503: checks 
edeildo: checks 
LocoU 10: checks 
*** RIVER *** [Ah Tc 4h Th] [4d]
Piet-1503: checks 
edeildo: checks 
LocoU 10: bets $0.04
Piet-1503: folds 
edeildo: folds 
Uncalled bet ($0.04) returned to LocoU 10
LocoU 10 collected $0.06 from pot
LocoU 10: doesn't show hand 
*** SUMMARY ***
Total pot $0.06 | Rake $0 
Board [Ah Tc 4h Th 4d]
Seat 1: HaG1BaT0R folded before Flop (didn't bet)
Seat 2: lawlex_2 folded before Flop (didn't bet)
Seat 3: AlissonStein folded before Flop (didn't bet)
Seat 4: LocoU 10 (button) collected ($0.06)
Seat 5: Piet-1503 (small blind) folded on the River
Seat 6: edeildo (big blind) folded on the River



PokerStars Hand #213575749177:  Hold'em No Limit ($0.01/$0.02 USD) - 2020/05/09 21:21:50 MSK [2020/05/09 14:21:50 ET]
Table 'Antiphos II' 6-max Seat #5 is the button
Seat 1: HaG1BaT0R ($3.85 in chips) 
Seat 2: lawlex_2 ($2 in chips) 
Seat 3: AlissonStein ($1.78 in chips) 
Seat 4: LocoU 10 ($2.01 in chips) 
Seat 5: Piet-1503 ($3.43 in chips) 
Seat 6: edeildo ($0.93 in chips) 
edeildo: posts small blind $0.01
HaG1BaT0R: posts big blind $0.02
*** HOLE CARDS ***
Dealt to lawlex_2 [Ts 3c]
lawlex_2: folds 
AlissonStein: folds 
LocoU 10: calls $0.02
Piet-1503: folds 
edeildo: calls $0.01
HaG1BaT0R: checks 
*** FLOP *** [2c 9c 8s]
edeildo: checks 
HaG1BaT0R: checks 
LocoU 10: bets $0.06
edeildo: calls $0.06
HaG1BaT0R: folds 
*** TURN *** [2c 9c 8s] [2s]
edeildo: checks 
LocoU 10: bets $0.06
edeildo: calls $0.06
*** RIVER *** [2c 9c 8s 2s] [2d]
edeildo: checks 
LocoU 10: bets $0.14
edeildo: folds 
Uncalled bet ($0.14) returned to LocoU 10
LocoU 10 collected $0.29 from pot
LocoU 10: doesn't show hand 
*** SUMMARY ***
Total pot $0.30 | Rake $0.01 
Board [2c 9c 8s 2s 2d]
Seat 1: HaG1BaT0R (big blind) folded on the Flop
Seat 2: lawlex_2 folded before Flop (didn't bet)
Seat 3: AlissonStein folded before Flop (didn't bet)
Seat 4: LocoU 10 collected ($0.29)
Seat 5: Piet-1503 (button) folded before Flop (didn't bet)
Seat 6: edeildo (small blind) folded on the River



PokerStars Hand #213575804391:  Hold'em No Limit ($0.01/$0.02 USD) - 2020/05/09 21:22:42 MSK [2020/05/09 14:22:42 ET]
Table 'Antiphos II' 6-max Seat #6 is the button
Seat 1: HaG1BaT0R ($3.83 in chips) 
Seat 2: lawlex_2 ($2 in chips) 
Seat 3: AlissonStein ($1.78 in chips) 
Seat 4: LocoU 10 ($2.16 in chips) 
Seat 5: Piet-1503 ($3.43 in chips) 
Seat 6: edeildo ($0.79 in chips) 
HaG1BaT0R: posts small blind $0.01
lawlex_2: posts big blind $0.02
*** HOLE CARDS ***
Dealt to lawlex_2 [As Jh]
AlissonStein: raises $0.04 to $0.06
LocoU 10: folds 
Piet-1503: folds 
edeildo: folds 
HaG1BaT0R: folds 
edeildo leaves the table
lawlex_2: calls $0.04
*** FLOP *** [5h 8c Kh]
lawlex_2: checks 
Piet-1503 leaves the table
AlissonStein: bets $0.06
lawlex_2: folds 
Uncalled bet ($0.06) returned to AlissonStein
AlissonStein collected $0.13 from pot
AlissonStein: doesn't show hand 
*** SUMMARY ***
Total pot $0.13 | Rake $0 
Board [5h 8c Kh]
Seat 1: HaG1BaT0R (small blind) folded before Flop
Seat 2: lawlex_2 (big blind) folded on the Flop
Seat 3: AlissonStein collected ($0.13)
Seat 4: LocoU 10 folded before Flop (didn't bet)
Seat 5: Piet-1503 folded before Flop (didn't bet)
Seat 6: edeildo (button) folded before Flop (didn't bet)



PokerStars Hand #213575836797:  Hold'em No Limit ($0.01/$0.02 USD) - 2020/05/09 21:23:12 MSK [2020/05/09 14:23:12 ET]
Table 'Antiphos II' 6-max Seat #1 is the button
Seat 1: HaG1BaT0R ($3.82 in chips) 
Seat 2: lawlex_2 ($1.94 in chips) 
Seat 3: AlissonStein ($1.85 in chips) 
Seat 4: LocoU 10 ($2.16 in chips) 
lawlex_2: posts small blind $0.01
AlissonStein: posts big blind $0.02
*** HOLE CARDS ***
Dealt to lawlex_2 [7h 9c]
LocoU 10: folds 
HaG1BaT0R: folds 
lawlex_2: folds 
Uncalled bet ($0.01) returned to AlissonStein
AlissonStein collected $0.02 from pot
AlissonStein: doesn't show hand 
*** SUMMARY ***
Total pot $0.02 | Rake $0 
Seat 1: HaG1BaT0R (button) folded before Flop (didn't bet)
Seat 2: lawlex_2 (small blind) folded before Flop
Seat 3: AlissonStein (big blind) collected ($0.02)
Seat 4: LocoU 10 folded before Flop (didn't bet)



PokerStars Hand #213575847196:  Hold'em No Limit ($0.01/$0.02 USD) - 2020/05/09 21:23:22 MSK [2020/05/09 14:23:22 ET]
Table 'Antiphos II' 6-max Seat #2 is the button
Seat 1: HaG1BaT0R ($3.82 in chips) 
Seat 2: lawlex_2 ($1.93 in chips) 
Seat 3: AlissonStein ($1.86 in chips) 
Seat 4: LocoU 10 ($2.16 in chips) 
AlissonStein: posts small blind $0.01
LocoU 10: posts big blind $0.02
*** HOLE CARDS ***
Dealt to lawlex_2 [5c 9s]
zitrih joins the table at seat #5 
HaG1BaT0R: folds 
lawlex_2: folds 
AlissonStein: folds 
Uncalled bet ($0.01) returned to LocoU 10
LocoU 10 collected $0.02 from pot
LocoU 10: doesn't show hand 
*** SUMMARY ***
Total pot $0.02 | Rake $0 
Seat 1: HaG1BaT0R folded before Flop (didn't bet)
Seat 2: lawlex_2 (button) folded before Flop (didn't bet)
Seat 3: AlissonStein (small blind) folded before Flop
Seat 4: LocoU 10 (big blind) collected ($0.02)



PokerStars Hand #213575855268:  Hold'em No Limit ($0.01/$0.02 USD) - 2020/05/09 21:23:29 MSK [2020/05/09 14:23:29 ET]
Table 'Antiphos II' 6-max Seat #3 is the button
Seat 1: HaG1BaT0R ($3.82 in chips) 
Seat 2: lawlex_2 ($1.93 in chips) 
Seat 3: AlissonStein ($1.85 in chips) 
Seat 4: LocoU 10 ($2.17 in chips) 
Seat 5: zitrih ($1.60 in chips) 
LocoU 10: posts small blind $0.01
zitrih: posts big blind $0.02
*** HOLE CARDS ***
Dealt to lawlex_2 [2h 4c]
HaG1BaT0R: folds 
TapeTarko joins the table at seat #6 
lawlex_2: folds 
AlissonStein: folds 
LocoU 10: raises $0.04 to $0.06
zitrih: calls $0.04
*** FLOP *** [3s 9c Ks]
LocoU 10: checks 
zitrih: checks 
*** TURN *** [3s 9c Ks] [Ts]
LocoU 10: checks 
zitrih: checks 
*** RIVER *** [3s 9c Ks Ts] [8s]
LocoU 10: bets $0.06
zitrih: folds 
Uncalled bet ($0.06) returned to LocoU 10
LocoU 10 collected $0.12 from pot
*** SUMMARY ***
Total pot $0.12 | Rake $0 
Board [3s 9c Ks Ts 8s]
Seat 1: HaG1BaT0R folded before Flop (didn't bet)
Seat 2: lawlex_2 folded before Flop (didn't bet)
Seat 3: AlissonStein (button) folded before Flop (didn't bet)
Seat 4: LocoU 10 (small blind) collected ($0.12)
Seat 5: zitrih (big blind) folded on the River



PokerStars Hand #213575898050:  Hold'em No Limit ($0.01/$0.02 USD) - 2020/05/09 21:24:09 MSK [2020/05/09 14:24:09 ET]
Table 'Antiphos II' 6-max Seat #4 is the button
Seat 1: HaG1BaT0R ($3.82 in chips) 
Seat 2: lawlex_2 ($1.93 in chips) 
Seat 3: AlissonStein ($1.85 in chips) 
Seat 4: LocoU 10 ($2.23 in chips) 
Seat 5: zitrih ($1.54 in chips) 
Seat 6: TapeTarko ($2 in chips) 
zitrih: posts small blind $0.01
TapeTarko: posts big blind $0.02
*** HOLE CARDS ***
Dealt to lawlex_2 [Ks 8s]
HaG1BaT0R: folds 
lawlex_2: raises $0.04 to $0.06
AlissonStein: folds 
LocoU 10: folds 
zitrih: raises $0.04 to $0.10
TapeTarko: folds 
lawlex_2: calls $0.04
*** FLOP *** [Ac 3h 9d]
zitrih: checks 
lawlex_2: checks 
*** TURN *** [Ac 3h 9d] [5s]
zitrih: checks 
lawlex_2: checks 
*** RIVER *** [Ac 3h 9d 5s] [6s]
zitrih: checks 
lawlex_2: checks 
*** SHOW DOWN ***
zitrih: shows [8d 9c] (a pair of Nines)
lawlex_2: mucks hand 
zitrih collected $0.21 from pot
*** SUMMARY ***
Total pot $0.22 | Rake $0.01 
Board [Ac 3h 9d 5s 6s]
Seat 1: HaG1BaT0R folded before Flop (didn't bet)
Seat 2: lawlex_2 mucked [Ks 8s]
Seat 3: AlissonStein folded before Flop (didn't bet)
Seat 4: LocoU 10 (button) folded before Flop (didn't bet)
Seat 5: zitrih (small blind) showed [8d 9c] and won ($0.21) with a pair of Nines
Seat 6: TapeTarko (big blind) folded before Flop



PokerStars Hand #213575951370:  Hold'em No Limit ($0.01/$0.02 USD) - 2020/05/09 21:24:53 MSK [2020/05/09 14:24:53 ET]
Table 'Antiphos II' 6-max Seat #5 is the button
Seat 1: HaG1BaT0R ($3.82 in chips) 
Seat 2: lawlex_2 ($1.83 in chips) 
Seat 3: AlissonStein ($1.85 in chips) 
Seat 4: LocoU 10 ($2.23 in chips) 
Seat 5: zitrih ($1.65 in chips) 
Seat 6: TapeTarko ($1.98 in chips) 
TapeTarko: posts small blind $0.01
HaG1BaT0R: posts big blind $0.02
*** HOLE CARDS ***
Dealt to lawlex_2 [Ks 8c]
lawlex_2: calls $0.02
AlissonStein: folds 
LocoU 10: folds 
zitrih: folds 
TapeTarko: calls $0.01
HaG1BaT0R: checks 
*** FLOP *** [9s 9d 6s]
TapeTarko: bets $0.04
HaG1BaT0R: folds 
lawlex_2: folds 
Uncalled bet ($0.04) returned to TapeTarko
TapeTarko collected $0.06 from pot
TapeTarko: doesn't show hand 
*** SUMMARY ***
Total pot $0.06 | Rake $0 
Board [9s 9d 6s]
Seat 1: HaG1BaT0R (big blind) folded on the Flop
Seat 2: lawlex_2 folded on the Flop
Seat 3: AlissonStein folded before Flop (didn't bet)
Seat 4: LocoU 10 folded before Flop (didn't bet)
Seat 5: zitrih (button) folded before Flop (didn't bet)
Seat 6: TapeTarko (small blind) collected ($0.06)



PokerStars Hand #213575983932:  Hold'em No Limit ($0.01/$0.02 USD) - 2020/05/09 21:25:24 MSK [2020/05/09 14:25:24 ET]
Table 'Antiphos II' 6-max Seat #6 is the button
Seat 1: HaG1BaT0R ($3.80 in chips) 
Seat 2: lawlex_2 ($1.81 in chips) 
Seat 3: AlissonStein ($1.85 in chips) 
Seat 4: LocoU 10 ($2.23 in chips) 
Seat 5: zitrih ($1.65 in chips) 
Seat 6: TapeTarko ($2.02 in chips) 
HaG1BaT0R: posts small blind $0.01
lawlex_2: posts big blind $0.02
*** HOLE CARDS ***
Dealt to lawlex_2 [6c 4c]
AlissonStein: folds 
LocoU 10: folds 
zitrih: raises $0.04 to $0.06
TapeTarko: folds 
HaG1BaT0R: calls $0.05
lawlex_2: folds 
*** FLOP *** [9s 6d 8d]
HaG1BaT0R: bets $0.11
zitrih: raises $0.11 to $0.22
HaG1BaT0R: calls $0.11
*** TURN *** [9s 6d 8d] [5s]
HaG1BaT0R: checks 
zitrih: checks 
*** RIVER *** [9s 6d 8d 5s] [9d]
HaG1BaT0R: bets $0.31
zitrih: raises $0.55 to $0.86
HaG1BaT0R: calls $0.55
*** SHOW DOWN ***
zitrih: shows [Qd Jd] (a flush, Queen high)
HaG1BaT0R: mucks hand 
zitrih collected $2.22 from pot
*** SUMMARY ***
Total pot $2.30 | Rake $0.08 
Board [9s 6d 8d 5s 9d]
Seat 1: HaG1BaT0R (small blind) mucked [9h Ad]
Seat 2: lawlex_2 (big blind) folded before Flop
Seat 3: AlissonStein folded before Flop (didn't bet)
Seat 4: LocoU 10 folded before Flop (didn't bet)
Seat 5: zitrih showed [Qd Jd] and won ($2.22) with a flush, Queen high
Seat 6: TapeTarko (button) folded before Flop (didn't bet)



PokerStars Hand #213576039663:  Hold'em No Limit ($0.01/$0.02 USD) - 2020/05/09 21:26:16 MSK [2020/05/09 14:26:16 ET]
Table 'Antiphos II' 6-max Seat #1 is the button
Seat 1: HaG1BaT0R ($2.66 in chips) 
Seat 2: lawlex_2 ($1.79 in chips) 
Seat 3: AlissonStein ($1.85 in chips) 
Seat 4: LocoU 10 ($2.23 in chips) 
Seat 5: zitrih ($2.73 in chips) 
Seat 6: TapeTarko ($2.02 in chips) 
lawlex_2: posts small blind $0.01
AlissonStein: posts big blind $0.02
*** HOLE CARDS ***
Dealt to lawlex_2 [3c 7d]
LocoU 10: folds 
zitrih: calls $0.02
TapeTarko: raises $0.04 to $0.06
HaG1BaT0R: folds 
lawlex_2: folds 
AlissonStein: folds 
zitrih: calls $0.04
*** FLOP *** [Ad 4s Kh]
zitrih: checks 
TapeTarko: checks 
*** TURN *** [Ad 4s Kh] [As]
zitrih: bets $0.07
TapeTarko: calls $0.07
*** RIVER *** [Ad 4s Kh As] [5c]
zitrih: bets $0.16
TapeTarko: raises $0.18 to $0.34
zitrih: calls $0.18
*** SHOW DOWN ***
TapeTarko: shows [Ah 4h] (a full house, Aces full of Fours)
zitrih: mucks hand 
TapeTarko collected $0.94 from pot
*** SUMMARY ***
Total pot $0.97 | Rake $0.03 
Board [Ad 4s Kh As 5c]
Seat 1: HaG1BaT0R (button) folded before Flop (didn't bet)
Seat 2: lawlex_2 (small blind) folded before Flop
Seat 3: AlissonStein (big blind) folded before Flop
Seat 4: LocoU 10 folded before Flop (didn't bet)
Seat 5: zitrih mucked [Ac 2s]
Seat 6: TapeTarko showed [Ah 4h] and won ($0.94) with a full house, Aces full of Fours



PokerStars Hand #213576118249:  Hold'em No Limit ($0.01/$0.02 USD) - 2020/05/09 21:27:26 MSK [2020/05/09 14:27:26 ET]
Table 'Antiphos II' 6-max Seat #2 is the button
Seat 1: HaG1BaT0R ($2.66 in chips) 
Seat 2: lawlex_2 ($1.78 in chips) 
Seat 3: AlissonStein ($1.83 in chips) 
Seat 4: LocoU 10 ($2.23 in chips) 
Seat 5: zitrih ($2.26 in chips) 
Seat 6: TapeTarko ($2.49 in chips) 
AlissonStein: posts small blind $0.01
LocoU 10: posts big blind $0.02
*** HOLE CARDS ***
Dealt to lawlex_2 [Kd 9c]
zitrih: calls $0.02
TapeTarko: folds 
HaG1BaT0R: raises $0.07 to $0.09
lawlex_2: calls $0.09
AlissonStein: calls $0.08
LocoU 10: folds 
zitrih: calls $0.07
*** FLOP *** [2d 4h 3d]
AlissonStein: checks 
zitrih: checks 
HaG1BaT0R: checks 
lawlex_2: checks 
*** TURN *** [2d 4h 3d] [As]
AlissonStein: bets $0.13
zitrih: folds 
HaG1BaT0R: calls $0.13
lawlex_2: folds 
*** RIVER *** [2d 4h 3d As] [Td]
AlissonStein: bets $0.22
HaG1BaT0R: calls $0.22
*** SHOW DOWN ***
AlissonStein: shows [Kh Ad] (a pair of Aces)
HaG1BaT0R: mucks hand 
AlissonStein collected $1.04 from pot
*** SUMMARY ***
Total pot $1.08 | Rake $0.04 
Board [2d 4h 3d As Td]
Seat 1: HaG1BaT0R mucked [Ac Jc]
Seat 2: lawlex_2 (button) folded on the Turn
Seat 3: AlissonStein (small blind) showed [Kh Ad] and won ($1.04) with a pair of Aces
Seat 4: LocoU 10 (big blind) folded before Flop
Seat 5: zitrih folded on the Turn
Seat 6: TapeTarko folded before Flop (didn't bet)



PokerStars Hand #213576188803:  Hold'em No Limit ($0.01/$0.02 USD) - 2020/05/09 21:28:32 MSK [2020/05/09 14:28:32 ET]
Table 'Antiphos II' 6-max Seat #3 is the button
Seat 2: lawlex_2 ($1.69 in chips) 
Seat 3: AlissonStein ($2.43 in chips) 
Seat 4: LocoU 10 ($2.21 in chips) 
Seat 5: zitrih ($2.17 in chips) 
Seat 6: TapeTarko ($2.49 in chips) 
LocoU 10: posts small blind $0.01
zitrih: posts big blind $0.02
*** HOLE CARDS ***
Dealt to lawlex_2 [6s Kh]
TapeTarko: folds 
HaG1BaT0R leaves the table
lawlex_2: raises $0.04 to $0.06
AlissonStein: folds 
LocoU 10: calls $0.05
zitrih: folds 
*** FLOP *** [Kc 2h Ac]
Caraballoggg joins the table at seat #1 
LocoU 10: bets $0.06
lawlex_2: raises $0.13 to $0.19
LocoU 10: calls $0.13
*** TURN *** [Kc 2h Ac] [Td]
LocoU 10: checks 
lawlex_2: checks 
*** RIVER *** [Kc 2h Ac Td] [3s]
LocoU 10: bets $0.06
lawlex_2: calls $0.06
*** SHOW DOWN ***
LocoU 10: shows [Ad 6d] (a pair of Aces)
lawlex_2: mucks hand 
LocoU 10 collected $0.62 from pot
*** SUMMARY ***
Total pot $0.64 | Rake $0.02 
Board [Kc 2h Ac Td 3s]
Seat 2: lawlex_2 mucked [6s Kh]
Seat 3: AlissonStein (button) folded before Flop (didn't bet)
Seat 4: LocoU 10 (small blind) showed [Ad 6d] and won ($0.62) with a pair of Aces
Seat 5: zitrih (big blind) folded before Flop
Seat 6: TapeTarko folded before Flop (didn't bet)



PokerStars Hand #213576240736:  Hold'em No Limit ($0.01/$0.02 USD) - 2020/05/09 21:29:22 MSK [2020/05/09 14:29:22 ET]
Table 'Antiphos II' 6-max Seat #4 is the button
Seat 2: lawlex_2 ($1.38 in chips) 
Seat 3: AlissonStein ($2.43 in chips) 
Seat 4: LocoU 10 ($2.52 in chips) 
Seat 5: zitrih ($2.15 in chips) 
Seat 6: TapeTarko ($2.49 in chips) 
zitrih: posts small blind $0.01
TapeTarko: posts big blind $0.02
Caraballoggg: sits out 
*** HOLE CARDS ***
Dealt to lawlex_2 [6s 2h]
lawlex_2: folds 
AlissonStein: folds 
LocoU 10: calls $0.02
zitrih: calls $0.01
TapeTarko: checks 
*** FLOP *** [Ad Jh 5s]
zitrih: bets $0.02
TapeTarko: calls $0.02
LocoU 10: calls $0.02
*** TURN *** [Ad Jh 5s] [8s]
zitrih: bets $0.06
TapeTarko: folds 
LocoU 10: calls $0.06
*** RIVER *** [Ad Jh 5s 8s] [Js]
zitrih: bets $0.23
LocoU 10: calls $0.23
*** SHOW DOWN ***
zitrih: shows [Jd 5c] (a full house, Jacks full of Fives)
LocoU 10: mucks hand 
zitrih collected $0.68 from pot
*** SUMMARY ***
Total pot $0.70 | Rake $0.02 
Board [Ad Jh 5s 8s Js]
Seat 2: lawlex_2 folded before Flop (didn't bet)
Seat 3: AlissonStein folded before Flop (didn't bet)
Seat 4: LocoU 10 (button) mucked [Jc 6h]
Seat 5: zitrih (small blind) showed [Jd 5c] and won ($0.68) with a full house, Jacks full of Fives
Seat 6: TapeTarko (big blind) folded on the Turn



PokerStars Hand #213576312799:  Hold'em No Limit ($0.01/$0.02 USD) - 2020/05/09 21:30:28 MSK [2020/05/09 14:30:28 ET]
Table 'Antiphos II' 6-max Seat #5 is the button
Seat 1: Caraballoggg ($1.60 in chips) 
Seat 2: lawlex_2 ($1.38 in chips) 
Seat 3: AlissonStein ($2.43 in chips) 
Seat 4: LocoU 10 ($2.19 in chips) 
Seat 5: zitrih ($2.50 in chips) 
Seat 6: TapeTarko ($2.45 in chips) 
TapeTarko: posts small blind $0.01
Caraballoggg: posts big blind $0.02
*** HOLE CARDS ***
Dealt to lawlex_2 [Ad Jh]
lawlex_2 has timed out
lawlex_2: folds 
AlissonStein: raises $0.04 to $0.06
LocoU 10: folds 
zitrih: folds 
TapeTarko: folds 
Caraballoggg: folds 
Uncalled bet ($0.04) returned to AlissonStein
AlissonStein collected $0.05 from pot
AlissonStein: doesn't show hand 
*** SUMMARY ***
Total pot $0.05 | Rake $0 
Seat 1: Caraballoggg (big blind) folded before Flop
Seat 2: lawlex_2 folded before Flop (didn't bet)
Seat 3: AlissonStein collected ($0.05)
Seat 4: LocoU 10 folded before Flop (didn't bet)
Seat 5: zitrih (button) folded before Flop (didn't bet)
Seat 6: TapeTarko (small blind) folded before Flop



PokerStars Hand #213576336428:  Hold'em No Limit ($0.01/$0.02 USD) - 2020/05/09 21:30:50 MSK [2020/05/09 14:30:50 ET]
Table 'Antiphos II' 6-max Seat #6 is the button
Seat 1: Caraballoggg ($1.58 in chips) 
Seat 2: lawlex_2 ($1.38 in chips) 
Seat 3: AlissonStein ($2.46 in chips) 
Seat 4: LocoU 10 ($2.19 in chips) 
Seat 5: zitrih ($2.50 in chips) 
Seat 6: TapeTarko ($2.44 in chips) 
Caraballoggg: posts small blind $0.01
lawlex_2: posts big blind $0.02
*** HOLE CARDS ***
Dealt to lawlex_2 [Js 8d]
AlissonStein: raises $0.04 to $0.06
LocoU 10: calls $0.06
zitrih: folds 
TapeTarko: folds 
Caraballoggg: calls $0.05
lawlex_2: folds 
*** FLOP *** [6d 2d 6s]
Caraballoggg: checks 
AlissonStein: bets $0.10
LocoU 10: folds 
Caraballoggg: calls $0.10
*** TURN *** [6d 2d 6s] [7c]
Caraballoggg: checks 
AlissonStein: bets $0.14
Caraballoggg: calls $0.14
*** RIVER *** [6d 2d 6s 7c] [2h]
Caraballoggg: checks 
AlissonStein: checks 
*** SHOW DOWN ***
Caraballoggg: shows [Ah Kh] (two pair, Sixes and Deuces)
AlissonStein: mucks hand 
Caraballoggg collected $0.66 from pot
*** SUMMARY ***
Total pot $0.68 | Rake $0.02 
Board [6d 2d 6s 7c 2h]
Seat 1: Caraballoggg (small blind) showed [Ah Kh] and won ($0.66) with two pair, Sixes and Deuces
Seat 2: lawlex_2 (big blind) folded before Flop
Seat 3: AlissonStein mucked [Ks Jd]
Seat 4: LocoU 10 folded on the Flop
Seat 5: zitrih folded before Flop (didn't bet)
Seat 6: TapeTarko (button) folded before Flop (didn't bet)



PokerStars Hand #213576393349:  Hold'em No Limit ($0.01/$0.02 USD) - 2020/05/09 21:31:43 MSK [2020/05/09 14:31:43 ET]
Table 'Antiphos II' 6-max Seat #1 is the button
Seat 1: Caraballoggg ($1.94 in chips) 
Seat 2: lawlex_2 ($1.36 in chips) 
Seat 3: AlissonStein ($2.16 in chips) 
Seat 4: LocoU 10 ($2.13 in chips) 
Seat 5: zitrih ($2.50 in chips) 
Seat 6: TapeTarko ($2.44 in chips) 
lawlex_2: posts small blind $0.01
AlissonStein: posts big blind $0.02
*** HOLE CARDS ***
Dealt to lawlex_2 [6s 5s]
LocoU 10: folds 
zitrih: calls $0.02
TapeTarko: folds 
Caraballoggg: folds 
lawlex_2: folds 
AlissonStein: raises $0.04 to $0.06
zitrih: calls $0.04
*** FLOP *** [3h 9s Ad]
AlissonStein: checks 
zitrih: checks 
*** TURN *** [3h 9s Ad] [Ks]
AlissonStein: checks 
zitrih: checks 
*** RIVER *** [3h 9s Ad Ks] [Ts]
AlissonStein: bets $0.10
zitrih: folds 
Uncalled bet ($0.10) returned to AlissonStein
AlissonStein collected $0.13 from pot
AlissonStein: doesn't show hand 
*** SUMMARY ***
Total pot $0.13 | Rake $0 
Board [3h 9s Ad Ks Ts]
Seat 1: Caraballoggg (button) folded before Flop (didn't bet)
Seat 2: lawlex_2 (small blind) folded before Flop
Seat 3: AlissonStein (big blind) collected ($0.13)
Seat 4: LocoU 10 folded before Flop (didn't bet)
Seat 5: zitrih folded on the River
Seat 6: TapeTarko folded before Flop (didn't bet)



PokerStars Hand #213576444085:  Hold'em No Limit ($0.01/$0.02 USD) - 2020/05/09 21:32:30 MSK [2020/05/09 14:32:30 ET]
Table 'Antiphos II' 6-max Seat #2 is the button
Seat 1: Caraballoggg ($1.94 in chips) 
Seat 2: lawlex_2 ($1.35 in chips) 
Seat 3: AlissonStein ($2.23 in chips) 
Seat 4: LocoU 10 ($2.13 in chips) 
Seat 5: zitrih ($2.44 in chips) 
Seat 6: TapeTarko ($2.44 in chips) 
AlissonStein: posts small blind $0.01
LocoU 10: posts big blind $0.02
*** HOLE CARDS ***
Dealt to lawlex_2 [Qh Jd]
zitrih: folds 
TapeTarko: folds 
Caraballoggg: calls $0.02
lawlex_2: raises $0.04 to $0.06
AlissonStein: folds 
LocoU 10: calls $0.04
Caraballoggg: calls $0.04
*** FLOP *** [9c 9d Qs]
LocoU 10: bets $0.18
Caraballoggg: folds 
lawlex_2: calls $0.18
*** TURN *** [9c 9d Qs] [2d]
LocoU 10: bets $0.18
lawlex_2: calls $0.18
*** RIVER *** [9c 9d Qs 2d] [Tc]
LocoU 10: bets $0.20
lawlex_2: calls $0.20
*** SHOW DOWN ***
LocoU 10: shows [Qd 6s] (two pair, Queens and Nines)
lawlex_2: shows [Qh Jd] (two pair, Queens and Nines - Jack kicker)
lawlex_2 collected $1.26 from pot
*** SUMMARY ***
Total pot $1.31 | Rake $0.05 
Board [9c 9d Qs 2d Tc]
Seat 1: Caraballoggg folded on the Flop
Seat 2: lawlex_2 (button) showed [Qh Jd] and won ($1.26) with two pair, Queens and Nines
Seat 3: AlissonStein (small blind) folded before Flop
Seat 4: LocoU 10 (big blind) showed [Qd 6s] and lost with two pair, Queens and Nines
Seat 5: zitrih folded before Flop (didn't bet)
Seat 6: TapeTarko folded before Flop (didn't bet)



PokerStars Hand #213576500730:  Hold'em No Limit ($0.01/$0.02 USD) - 2020/05/09 21:33:21 MSK [2020/05/09 14:33:21 ET]
Table 'Antiphos II' 6-max Seat #3 is the button
Seat 1: Caraballoggg ($1.88 in chips) 
Seat 2: lawlex_2 ($1.99 in chips) 
Seat 3: AlissonStein ($2.22 in chips) 
Seat 4: LocoU 10 ($1.51 in chips) 
Seat 5: zitrih ($2.44 in chips) 
Seat 6: TapeTarko ($2.44 in chips) 
LocoU 10: posts small blind $0.01
zitrih: posts big blind $0.02
*** HOLE CARDS ***
Dealt to lawlex_2 [4d 5d]
TapeTarko: folds 
Caraballoggg: calls $0.02
lawlex_2: folds 
AlissonStein: folds 
LocoU 10: folds 
zitrih: checks 
*** FLOP *** [Jd 8c As]
zitrih: bets $0.02
Caraballoggg: calls $0.02
*** TURN *** [Jd 8c As] [4c]
zitrih: checks 
Caraballoggg: checks 
*** RIVER *** [Jd 8c As 4c] [7s]
zitrih: checks 
Caraballoggg: checks 
*** SHOW DOWN ***
zitrih: shows [7d Td] (a pair of Sevens)
Caraballoggg: shows [Ac 2h] (a pair of Aces)
Caraballoggg collected $0.09 from pot
*** SUMMARY ***
Total pot $0.09 | Rake $0 
Board [Jd 8c As 4c 7s]
Seat 1: Caraballoggg showed [Ac 2h] and won ($0.09) with a pair of Aces
Seat 2: lawlex_2 folded before Flop (didn't bet)
Seat 3: AlissonStein (button) folded before Flop (didn't bet)
Seat 4: LocoU 10 (small blind) folded before Flop
Seat 5: zitrih (big blind) showed [7d Td] and lost with a pair of Sevens
Seat 6: TapeTarko folded before Flop (didn't bet)



PokerStars Hand #213576532577:  Hold'em No Limit ($0.01/$0.02 USD) - 2020/05/09 21:33:51 MSK [2020/05/09 14:33:51 ET]
Table 'Antiphos II' 6-max Seat #4 is the button
Seat 1: Caraballoggg ($1.93 in chips) 
Seat 2: lawlex_2 ($1.99 in chips) 
Seat 3: AlissonStein ($2.22 in chips) 
Seat 4: LocoU 10 ($1.50 in chips) 
Seat 5: zitrih ($2.40 in chips) 
Seat 6: TapeTarko ($2.44 in chips) 
zitrih: posts small blind $0.01
TapeTarko: posts big blind $0.02
*** HOLE CARDS ***
Dealt to lawlex_2 [8h Ac]
Caraballoggg: folds 
lawlex_2: raises $0.04 to $0.06
AlissonStein: folds 
LocoU 10: calls $0.06
zitrih: calls $0.05
TapeTarko: folds 
*** FLOP *** [Jc 6s 2c]
zitrih: checks 
lawlex_2: checks 
LocoU 10: checks 
*** TURN *** [Jc 6s 2c] [5c]
zitrih: checks 
lawlex_2: bets $0.13
LocoU 10: folds 
zitrih: folds 
Uncalled bet ($0.13) returned to lawlex_2
lawlex_2 collected $0.19 from pot
lawlex_2: doesn't show hand 
*** SUMMARY ***
Total pot $0.20 | Rake $0.01 
Board [Jc 6s 2c 5c]
Seat 1: Caraballoggg folded before Flop (didn't bet)
Seat 2: lawlex_2 collected ($0.19)
Seat 3: AlissonStein folded before Flop (didn't bet)
Seat 4: LocoU 10 (button) folded on the Turn
Seat 5: zitrih (small blind) folded on the Turn
Seat 6: TapeTarko (big blind) folded before Flop



PokerStars Hand #213576586788:  Hold'em No Limit ($0.01/$0.02 USD) - 2020/05/09 21:34:41 MSK [2020/05/09 14:34:41 ET]
Table 'Antiphos II' 6-max Seat #5 is the button
Seat 1: Caraballoggg ($1.93 in chips) 
Seat 2: lawlex_2 ($2.12 in chips) 
Seat 3: AlissonStein ($2.22 in chips) 
Seat 4: LocoU 10 ($1.44 in chips) 
Seat 5: zitrih ($2.34 in chips) 
Seat 6: TapeTarko ($2.42 in chips) 
TapeTarko: posts small blind $0.01
Caraballoggg: posts big blind $0.02
*** HOLE CARDS ***
Dealt to lawlex_2 [Kc Ks]
lawlex_2: calls $0.02
AlissonStein: calls $0.02
LocoU 10: calls $0.02
zitrih: calls $0.02
TapeTarko: calls $0.01
Caraballoggg: checks 
*** FLOP *** [5h Td 8c]
TapeTarko: checks 
Caraballoggg: checks 
lawlex_2: bets $0.08
AlissonStein: calls $0.08
LocoU 10: folds 
zitrih: folds 
TapeTarko: folds 
Caraballoggg: folds 
*** TURN *** [5h Td 8c] [6h]
lawlex_2: bets $0.18
AlissonStein: calls $0.18
*** RIVER *** [5h Td 8c 6h] [Jh]
lawlex_2: checks 
AlissonStein: checks 
*** SHOW DOWN ***
lawlex_2: shows [Kc Ks] (a pair of Kings)
AlissonStein: mucks hand 
lawlex_2 collected $0.62 from pot
*** SUMMARY ***
Total pot $0.64 | Rake $0.02 
Board [5h Td 8c 6h Jh]
Seat 1: Caraballoggg (big blind) folded on the Flop
Seat 2: lawlex_2 showed [Kc Ks] and won ($0.62) with a pair of Kings
Seat 3: AlissonStein mucked [Tc 9c]
Seat 4: LocoU 10 folded on the Flop
Seat 5: zitrih (button) folded on the Flop
Seat 6: TapeTarko (small blind) folded on the Flop



PokerStars Hand #213576660803:  Hold'em No Limit ($0.01/$0.02 USD) - 2020/05/09 21:35:48 MSK [2020/05/09 14:35:48 ET]
Table 'Antiphos II' 6-max Seat #6 is the button
Seat 1: Caraballoggg ($1.91 in chips) 
Seat 2: lawlex_2 ($2.46 in chips) 
Seat 3: AlissonStein ($1.94 in chips) 
Seat 4: LocoU 10 ($1.42 in chips) 
Seat 5: zitrih ($2.32 in chips) 
Seat 6: TapeTarko ($2.40 in chips) 
Caraballoggg: posts small blind $0.01
lawlex_2: posts big blind $0.02
*** HOLE CARDS ***
Dealt to lawlex_2 [6h 3c]
AlissonStein: folds 
LocoU 10: folds 
zitrih: folds 
TapeTarko: folds 
Caraballoggg: folds 
Uncalled bet ($0.01) returned to lawlex_2
lawlex_2 collected $0.02 from pot
lawlex_2: doesn't show hand 
*** SUMMARY ***
Total pot $0.02 | Rake $0 
Seat 1: Caraballoggg (small blind) folded before Flop
Seat 2: lawlex_2 (big blind) collected ($0.02)
Seat 3: AlissonStein folded before Flop (didn't bet)
Seat 4: LocoU 10 folded before Flop (didn't bet)
Seat 5: zitrih folded before Flop (didn't bet)
Seat 6: TapeTarko (button) folded before Flop (didn't bet)



PokerStars Hand #213576678907:  Hold'em No Limit ($0.01/$0.02 USD) - 2020/05/09 21:36:05 MSK [2020/05/09 14:36:05 ET]
Table 'Antiphos II' 6-max Seat #1 is the button
Seat 1: Caraballoggg ($1.90 in chips) 
Seat 2: lawlex_2 ($2.47 in chips) 
Seat 3: AlissonStein ($1.94 in chips) 
Seat 4: LocoU 10 ($1.42 in chips) 
Seat 5: zitrih ($2.32 in chips) 
Seat 6: TapeTarko ($2.40 in chips) 
lawlex_2: posts small blind $0.01
AlissonStein: posts big blind $0.02
*** HOLE CARDS ***
Dealt to lawlex_2 [6d Qd]
LocoU 10 has timed out
LocoU 10: folds 
zitrih: raises $0.04 to $0.06
TapeTarko: folds 
Caraballoggg: folds 
lawlex_2: folds 
AlissonStein: folds 
Uncalled bet ($0.04) returned to zitrih
zitrih collected $0.05 from pot
zitrih: doesn't show hand 
*** SUMMARY ***
Total pot $0.05 | Rake $0 
Seat 1: Caraballoggg (button) folded before Flop (didn't bet)
Seat 2: lawlex_2 (small blind) folded before Flop
Seat 3: AlissonStein (big blind) folded before Flop
Seat 4: LocoU 10 folded before Flop (didn't bet)
Seat 5: zitrih collected ($0.05)
Seat 6: TapeTarko folded before Flop (didn't bet)



PokerStars Hand #213576705923:  Hold'em No Limit ($0.01/$0.02 USD) - 2020/05/09 21:36:30 MSK [2020/05/09 14:36:30 ET]
Table 'Antiphos II' 6-max Seat #2 is the button
Seat 1: Caraballoggg ($1.90 in chips) 
Seat 2: lawlex_2 ($2.46 in chips) 
Seat 3: AlissonStein ($1.92 in chips) 
Seat 4: LocoU 10 ($1.42 in chips) 
Seat 5: zitrih ($2.35 in chips) 
Seat 6: TapeTarko ($2.40 in chips) 
AlissonStein: posts small blind $0.01
LocoU 10: posts big blind $0.02
*** HOLE CARDS ***
Dealt to lawlex_2 [6s Ks]
zitrih: folds 
TapeTarko: raises $0.04 to $0.06
Caraballoggg: folds 
lawlex_2: calls $0.06
AlissonStein: folds 
LocoU 10: folds 
*** FLOP *** [9d 6c Qs]
TapeTarko: checks 
lawlex_2: bets $0.09
TapeTarko: folds 
Uncalled bet ($0.09) returned to lawlex_2
lawlex_2 collected $0.14 from pot
lawlex_2: doesn't show hand 
*** SUMMARY ***
Total pot $0.15 | Rake $0.01 
Board [9d 6c Qs]
Seat 1: Caraballoggg folded before Flop (didn't bet)
Seat 2: lawlex_2 (button) collected ($0.14)
Seat 3: AlissonStein (small blind) folded before Flop
Seat 4: LocoU 10 (big blind) folded before Flop
Seat 5: zitrih folded before Flop (didn't bet)
Seat 6: TapeTarko folded on the Flop



PokerStars Hand #213576738381:  Hold'em No Limit ($0.01/$0.02 USD) - 2020/05/09 21:37:00 MSK [2020/05/09 14:37:00 ET]
Table 'Antiphos II' 6-max Seat #3 is the button
Seat 1: Caraballoggg ($1.90 in chips) 
Seat 2: lawlex_2 ($2.54 in chips) 
Seat 3: AlissonStein ($1.91 in chips) 
Seat 4: LocoU 10 ($1.40 in chips) 
Seat 5: zitrih ($2.35 in chips) 
Seat 6: TapeTarko ($2.34 in chips) 
LocoU 10: posts small blind $0.01
zitrih: posts big blind $0.02
*** HOLE CARDS ***
Dealt to lawlex_2 [8c Ah]
TapeTarko: raises $0.04 to $0.06
Caraballoggg: folds 
lawlex_2: folds 
AlissonStein: folds 
LocoU 10: folds 
zitrih: calls $0.04
*** FLOP *** [As 3c Qs]
zitrih: checks 
TapeTarko: bets $0.08
zitrih: calls $0.08
*** TURN *** [As 3c Qs] [Th]
zitrih: checks 
TapeTarko: bets $0.20
zitrih: calls $0.20
*** RIVER *** [As 3c Qs Th] [6s]
zitrih: bets $0.34
TapeTarko: calls $0.34
*** SHOW DOWN ***
zitrih: shows [Ad 6h] (two pair, Aces and Sixes)
TapeTarko: shows [Td Ac] (two pair, Aces and Tens)
TapeTarko collected $1.32 from pot
*** SUMMARY ***
Total pot $1.37 | Rake $0.05 
Board [As 3c Qs Th 6s]
Seat 1: Caraballoggg folded before Flop (didn't bet)
Seat 2: lawlex_2 folded before Flop (didn't bet)
Seat 3: AlissonStein (button) folded before Flop (didn't bet)
Seat 4: LocoU 10 (small blind) folded before Flop
Seat 5: zitrih (big blind) showed [Ad 6h] and lost with two pair, Aces and Sixes
Seat 6: TapeTarko showed [Td Ac] and won ($1.32) with two pair, Aces and Tens



PokerStars Hand #213576806105:  Hold'em No Limit ($0.01/$0.02 USD) - 2020/05/09 21:37:58 MSK [2020/05/09 14:37:58 ET]
Table 'Antiphos II' 6-max Seat #4 is the button
Seat 1: Caraballoggg ($1.90 in chips) 
Seat 2: lawlex_2 ($2.54 in chips) 
Seat 3: AlissonStein ($1.91 in chips) 
Seat 4: LocoU 10 ($1.39 in chips) 
Seat 5: zitrih ($1.67 in chips) 
Seat 6: TapeTarko ($2.98 in chips) 
zitrih: posts small blind $0.01
TapeTarko: posts big blind $0.02
*** HOLE CARDS ***
Dealt to lawlex_2 [Kc 5s]
Caraballoggg: folds 
lawlex_2: folds 
AlissonStein: raises $0.04 to $0.06
LocoU 10: folds 
zitrih: folds 
TapeTarko: calls $0.04
*** FLOP *** [Qh 9h 4c]
TapeTarko: checks 
AlissonStein: checks 
*** TURN *** [Qh 9h 4c] [2s]
TapeTarko: checks 
AlissonStein: bets $0.06
TapeTarko: calls $0.06
*** RIVER *** [Qh 9h 4c 2s] [6c]
TapeTarko: checks 
AlissonStein: checks 
*** SHOW DOWN ***
TapeTarko: shows [Qd Qs] (three of a kind, Queens)
AlissonStein: mucks hand 
TapeTarko collected $0.24 from pot
*** SUMMARY ***
Total pot $0.25 | Rake $0.01 
Board [Qh 9h 4c 2s 6c]
Seat 1: Caraballoggg folded before Flop (didn't bet)
Seat 2: lawlex_2 folded before Flop (didn't bet)
Seat 3: AlissonStein mucked [Tc Ac]
Seat 4: LocoU 10 (button) folded before Flop (didn't bet)
Seat 5: zitrih (small blind) folded before Flop
Seat 6: TapeTarko (big blind) showed [Qd Qs] and won ($0.24) with three of a kind, Queens



PokerStars Hand #213576857526:  Hold'em No Limit ($0.01/$0.02 USD) - 2020/05/09 21:38:39 MSK [2020/05/09 14:38:39 ET]
Table 'Antiphos II' 6-max Seat #5 is the button
Seat 1: Caraballoggg ($1.90 in chips) 
Seat 2: lawlex_2 ($2.54 in chips) 
Seat 3: AlissonStein ($1.79 in chips) 
Seat 4: LocoU 10 ($1.39 in chips) 
Seat 5: zitrih ($1.66 in chips) 
Seat 6: TapeTarko ($3.10 in chips) 
TapeTarko: posts small blind $0.01
Caraballoggg: posts big blind $0.02
*** HOLE CARDS ***
Dealt to lawlex_2 [9d 6h]
lawlex_2: folds 
AlissonStein: folds 
LocoU 10: calls $0.02
zitrih: calls $0.02
TapeTarko: folds 
Caraballoggg: checks 
*** FLOP *** [6d 3c 2h]
Caraballoggg: checks 
LocoU 10: checks 
zitrih: bets $0.07
Caraballoggg: folds 
LocoU 10: calls $0.07
*** TURN *** [6d 3c 2h] [Jc]
LocoU 10: checks 
zitrih: checks 
*** RIVER *** [6d 3c 2h Jc] [5d]
LocoU 10: bets $0.20
zitrih: folds 
Uncalled bet ($0.20) returned to LocoU 10
LocoU 10 collected $0.20 from pot
LocoU 10: doesn't show hand 
*** SUMMARY ***
Total pot $0.21 | Rake $0.01 
Board [6d 3c 2h Jc 5d]
Seat 1: Caraballoggg (big blind) folded on the Flop
Seat 2: lawlex_2 folded before Flop (didn't bet)
Seat 3: AlissonStein folded before Flop (didn't bet)
Seat 4: LocoU 10 collected ($0.20)
Seat 5: zitrih (button) folded on the River
Seat 6: TapeTarko (small blind) folded before Flop



PokerStars Hand #213576912840:  Hold'em No Limit ($0.01/$0.02 USD) - 2020/05/09 21:39:31 MSK [2020/05/09 14:39:31 ET]
Table 'Antiphos II' 6-max Seat #6 is the button
Seat 1: Caraballoggg ($1.88 in chips) 
Seat 2: lawlex_2 ($2.54 in chips) 
Seat 3: AlissonStein ($1.79 in chips) 
Seat 4: LocoU 10 ($1.50 in chips) 
Seat 5: zitrih ($1.57 in chips) 
Seat 6: TapeTarko ($3.09 in chips) 
Caraballoggg: posts small blind $0.01
lawlex_2: posts big blind $0.02
*** HOLE CARDS ***
Dealt to lawlex_2 [Tc 8h]
AlissonStein: folds 
LocoU 10: calls $0.02
zitrih: calls $0.02
TapeTarko: folds 
Caraballoggg: folds 
lawlex_2: checks 
*** FLOP *** [6d Kh Qd]
lawlex_2: checks 
LocoU 10: checks 
zitrih: checks 
*** TURN *** [6d Kh Qd] [9c]
lawlex_2: checks 
LocoU 10: bets $0.02
zitrih: folds 
lawlex_2: calls $0.02
*** RIVER *** [6d Kh Qd 9c] [As]
lawlex_2: checks 
LocoU 10: checks 
*** SHOW DOWN ***
lawlex_2: shows [Tc 8h] (high card Ace)
LocoU 10: shows [9d Js] (a pair of Nines)
LocoU 10 collected $0.11 from pot
*** SUMMARY ***
Total pot $0.11 | Rake $0 
Board [6d Kh Qd 9c As]
Seat 1: Caraballoggg (small blind) folded before Flop
Seat 2: lawlex_2 (big blind) showed [Tc 8h] and lost with high card Ace
Seat 3: AlissonStein folded before Flop (didn't bet)
Seat 4: LocoU 10 showed [9d Js] and won ($0.11) with a pair of Nines
Seat 5: zitrih folded on the Turn
Seat 6: TapeTarko (button) folded before Flop (didn't bet)



PokerStars Hand #213576967766:  Hold'em No Limit ($0.01/$0.02 USD) - 2020/05/09 21:40:22 MSK [2020/05/09 14:40:22 ET]
Table 'Antiphos II' 6-max Seat #1 is the button
Seat 1: Caraballoggg ($1.87 in chips) 
Seat 2: lawlex_2 ($2.50 in chips) 
Seat 3: AlissonStein ($1.79 in chips) 
Seat 4: LocoU 10 ($1.57 in chips) 
Seat 5: zitrih ($1.55 in chips) 
Seat 6: TapeTarko ($3.09 in chips) 
lawlex_2: posts small blind $0.01
AlissonStein: posts big blind $0.02
*** HOLE CARDS ***
Dealt to lawlex_2 [Qc Kh]
LocoU 10: raises $0.08 to $0.10
zitrih: folds 
TapeTarko: folds 
Caraballoggg: folds 
lawlex_2: folds 
AlissonStein: folds 
Uncalled bet ($0.08) returned to LocoU 10
LocoU 10 collected $0.05 from pot
LocoU 10: doesn't show hand 
*** SUMMARY ***
Total pot $0.05 | Rake $0 
Seat 1: Caraballoggg (button) folded before Flop (didn't bet)
Seat 2: lawlex_2 (small blind) folded before Flop
Seat 3: AlissonStein (big blind) folded before Flop
Seat 4: LocoU 10 collected ($0.05)
Seat 5: zitrih folded before Flop (didn't bet)
Seat 6: TapeTarko folded before Flop (didn't bet)



PokerStars Hand #213576989781:  Hold'em No Limit ($0.01/$0.02 USD) - 2020/05/09 21:40:42 MSK [2020/05/09 14:40:42 ET]
Table 'Antiphos II' 6-max Seat #2 is the button
Seat 1: Caraballoggg ($1.87 in chips) 
Seat 2: lawlex_2 ($2.49 in chips) 
Seat 3: AlissonStein ($1.77 in chips) 
Seat 4: LocoU 10 ($1.60 in chips) 
Seat 5: zitrih ($1.55 in chips) 
Seat 6: TapeTarko ($3.09 in chips) 
AlissonStein: posts small blind $0.01
LocoU 10: posts big blind $0.02
*** HOLE CARDS ***
Dealt to lawlex_2 [4s Qc]
zitrih: folds 
TapeTarko: folds 
Caraballoggg: raises $0.30 to $0.32
lawlex_2: folds 
AlissonStein: folds 
LocoU 10: folds 
Uncalled bet ($0.30) returned to Caraballoggg
Caraballoggg collected $0.05 from pot
Caraballoggg: doesn't show hand 
*** SUMMARY ***
Total pot $0.05 | Rake $0 
Seat 1: Caraballoggg collected ($0.05)
Seat 2: lawlex_2 (button) folded before Flop (didn't bet)
Seat 3: AlissonStein (small blind) folded before Flop
Seat 4: LocoU 10 (big blind) folded before Flop
Seat 5: zitrih folded before Flop (didn't bet)
Seat 6: TapeTarko folded before Flop (didn't bet)



PokerStars Hand #213577011669:  Hold'em No Limit ($0.01/$0.02 USD) - 2020/05/09 21:41:03 MSK [2020/05/09 14:41:03 ET]
Table 'Antiphos II' 6-max Seat #3 is the button
Seat 1: Caraballoggg ($1.90 in chips) 
Seat 2: lawlex_2 ($2.49 in chips) 
Seat 3: AlissonStein ($1.76 in chips) 
Seat 4: LocoU 10 ($1.58 in chips) 
Seat 5: zitrih ($1.55 in chips) 
Seat 6: TapeTarko ($3.09 in chips) 
LocoU 10: posts small blind $0.01
zitrih: posts big blind $0.02
*** HOLE CARDS ***
Dealt to lawlex_2 [7c 6c]
TapeTarko: folds 
Caraballoggg: folds 
lawlex_2: folds 
AlissonStein: folds 
LocoU 10: raises $0.04 to $0.06
zitrih: calls $0.04
*** FLOP *** [Kd Td Qh]
LocoU 10: bets $0.04
zitrih: calls $0.04
*** TURN *** [Kd Td Qh] [8d]
LocoU 10: checks 
zitrih: checks 
*** RIVER *** [Kd Td Qh 8d] [Ah]
LocoU 10: bets $0.18
zitrih: calls $0.18
*** SHOW DOWN ***
LocoU 10: shows [Jh Qc] (a straight, Ten to Ace)
zitrih: mucks hand 
LocoU 10 collected $0.54 from pot
*** SUMMARY ***
Total pot $0.56 | Rake $0.02 
Board [Kd Td Qh 8d Ah]
Seat 1: Caraballoggg folded before Flop (didn't bet)
Seat 2: lawlex_2 folded before Flop (didn't bet)
Seat 3: AlissonStein (button) folded before Flop (didn't bet)
Seat 4: LocoU 10 (small blind) showed [Jh Qc] and won ($0.54) with a straight, Ten to Ace
Seat 5: zitrih (big blind) mucked [3c As]
Seat 6: TapeTarko folded before Flop (didn't bet)



PokerStars Hand #213577066411:  Hold'em No Limit ($0.01/$0.02 USD) - 2020/05/09 21:41:53 MSK [2020/05/09 14:41:53 ET]
Table 'Antiphos II' 6-max Seat #4 is the button
Seat 1: Caraballoggg ($1.90 in chips) 
Seat 2: lawlex_2 ($2.49 in chips) 
Seat 3: AlissonStein ($1.76 in chips) 
Seat 4: LocoU 10 ($1.84 in chips) 
Seat 5: zitrih ($1.27 in chips) 
Seat 6: TapeTarko ($3.09 in chips) 
zitrih: posts small blind $0.01
TapeTarko: posts big blind $0.02
*** HOLE CARDS ***
Dealt to lawlex_2 [4c Kh]
Caraballoggg: calls $0.02
lawlex_2: folds 
AlissonStein: calls $0.02
LocoU 10: raises $0.04 to $0.06
zitrih: calls $0.05
TapeTarko: calls $0.04
Caraballoggg: calls $0.04
AlissonStein: calls $0.04
*** FLOP *** [3c 9c 4h]
zitrih: checks 
TapeTarko: checks 
Caraballoggg: bets $0.22
AlissonStein: folds 
LocoU 10: calls $0.22
zitrih: folds 
TapeTarko: folds 
*** TURN *** [3c 9c 4h] [Js]
Caraballoggg: checks 
LocoU 10: bets $0.06
Caraballoggg: folds 
Uncalled bet ($0.06) returned to LocoU 10
LocoU 10 collected $0.71 from pot
LocoU 10: doesn't show hand 
*** SUMMARY ***
Total pot $0.74 | Rake $0.03 
Board [3c 9c 4h Js]
Seat 1: Caraballoggg folded on the Turn
Seat 2: lawlex_2 folded before Flop (didn't bet)
Seat 3: AlissonStein folded on the Flop
Seat 4: LocoU 10 (button) collected ($0.71)
Seat 5: zitrih (small blind) folded on the Flop
Seat 6: TapeTarko (big blind) folded on the Flop



PokerStars Hand #213577123976:  Hold'em No Limit ($0.01/$0.02 USD) - 2020/05/09 21:42:46 MSK [2020/05/09 14:42:46 ET]
Table 'Antiphos II' 6-max Seat #5 is the button
Seat 1: Caraballoggg ($1.62 in chips) 
Seat 2: lawlex_2 ($2.49 in chips) 
Seat 3: AlissonStein ($1.70 in chips) 
Seat 4: LocoU 10 ($2.27 in chips) 
Seat 5: zitrih ($1.21 in chips) 
Seat 6: TapeTarko ($3.03 in chips) 
TapeTarko: posts small blind $0.01
Caraballoggg: posts big blind $0.02
*** HOLE CARDS ***
Dealt to lawlex_2 [Jd 5d]
lawlex_2: folds 
AlissonStein: folds 
LocoU 10: raises $0.04 to $0.06
zitrih: calls $0.06
TapeTarko: folds 
Caraballoggg: folds 
*** FLOP *** [2h 4h 9h]
LocoU 10: bets $0.24
zitrih: calls $0.24
*** TURN *** [2h 4h 9h] [Qc]
LocoU 10: bets $0.30
zitrih: calls $0.30
*** RIVER *** [2h 4h 9h Qc] [Kd]
LocoU 10: bets $0.62
zitrih: calls $0.61 and is all-in
Uncalled bet ($0.01) returned to LocoU 10
*** SHOW DOWN ***
LocoU 10: shows [Kh 6h] (a flush, King high)
zitrih: shows [Th Kc] (a pair of Kings)
LocoU 10 collected $2.36 from pot
*** SUMMARY ***
Total pot $2.45 | Rake $0.09 
Board [2h 4h 9h Qc Kd]
Seat 1: Caraballoggg (big blind) folded before Flop
Seat 2: lawlex_2 folded before Flop (didn't bet)
Seat 3: AlissonStein folded before Flop (didn't bet)
Seat 4: LocoU 10 showed [Kh 6h] and won ($2.36) with a flush, King high
Seat 5: zitrih (button) showed [Th Kc] and lost with a pair of Kings
Seat 6: TapeTarko (small blind) folded before Flop



PokerStars Hand #213577173620:  Hold'em No Limit ($0.01/$0.02 USD) - 2020/05/09 21:43:32 MSK [2020/05/09 14:43:32 ET]
Table 'Antiphos II' 6-max Seat #6 is the button
Seat 1: Caraballoggg ($1.60 in chips) 
Seat 2: lawlex_2 ($2.49 in chips) 
Seat 3: AlissonStein ($1.70 in chips) 
Seat 4: LocoU 10 ($3.42 in chips) 
Seat 6: TapeTarko ($3.02 in chips) 
Caraballoggg: posts small blind $0.01
lawlex_2: posts big blind $0.02
*** HOLE CARDS ***
Dealt to lawlex_2 [5s 5h]
AlissonStein: folds 
LocoU 10: calls $0.02
TapeTarko: raises $0.06 to $0.08
Caraballoggg: calls $0.07
lawlex_2: folds 
LocoU 10: calls $0.06
*** FLOP *** [6d Th 4c]
Caraballoggg: bets $0.26
LocoU 10: folds 
TapeTarko: calls $0.26
*** TURN *** [6d Th 4c] [Kh]
Caraballoggg: bets $0.08
TapeTarko: calls $0.08
*** RIVER *** [6d Th 4c Kh] [2h]
Caraballoggg: bets $0.14
TapeTarko: calls $0.14
*** SHOW DOWN ***
Caraballoggg: shows [As 4d] (a pair of Fours)
TapeTarko: shows [Jh Jd] (a pair of Jacks)
TapeTarko collected $1.18 from pot
*** SUMMARY ***
Total pot $1.22 | Rake $0.04 
Board [6d Th 4c Kh 2h]
Seat 1: Caraballoggg (small blind) showed [As 4d] and lost with a pair of Fours
Seat 2: lawlex_2 (big blind) folded before Flop
Seat 3: AlissonStein folded before Flop (didn't bet)
Seat 4: LocoU 10 folded on the Flop
Seat 6: TapeTarko (button) showed [Jh Jd] and won ($1.18) with a pair of Jacks



PokerStars Hand #213577253741:  Hold'em No Limit ($0.01/$0.02 USD) - 2020/05/09 21:44:37 MSK [2020/05/09 14:44:37 ET]
Table 'Antiphos II' 6-max Seat #1 is the button
Seat 1: Caraballoggg ($1.04 in chips) 
Seat 2: lawlex_2 ($2.47 in chips) 
Seat 3: AlissonStein ($1.70 in chips) 
Seat 4: LocoU 10 ($3.34 in chips) 
Seat 5: zitrih ($2 in chips) 
Seat 6: TapeTarko ($3.64 in chips) 
lawlex_2: posts small blind $0.01
AlissonStein: posts big blind $0.02
*** HOLE CARDS ***
Dealt to lawlex_2 [Jd 6s]
LocoU 10 has timed out
LocoU 10: folds 
zitrih: folds 
TapeTarko: folds 
Caraballoggg: folds 
Caraballoggg leaves the table
lawlex_2: folds 
Uncalled bet ($0.01) returned to AlissonStein
INumb joins the table at seat #1 
AlissonStein collected $0.02 from pot
AlissonStein: doesn't show hand 
*** SUMMARY ***
Total pot $0.02 | Rake $0 
Seat 1: Caraballoggg (button) folded before Flop (didn't bet)
Seat 2: lawlex_2 (small blind) folded before Flop
Seat 3: AlissonStein (big blind) collected ($0.02)
Seat 4: LocoU 10 folded before Flop (didn't bet)
Seat 5: zitrih folded before Flop (didn't bet)
Seat 6: TapeTarko folded before Flop (didn't bet)



PokerStars Hand #213577278139:  Hold'em No Limit ($0.01/$0.02 USD) - 2020/05/09 21:45:00 MSK [2020/05/09 14:45:00 ET]
Table 'Antiphos II' 6-max Seat #2 is the button
Seat 2: lawlex_2 ($2.46 in chips) 
Seat 3: AlissonStein ($1.71 in chips) 
Seat 5: zitrih ($2 in chips) 
Seat 6: TapeTarko ($3.64 in chips) 
AlissonStein: posts small blind $0.01
zitrih: posts big blind $0.02
INumb: sits out 
*** HOLE CARDS ***
Dealt to lawlex_2 [Ks Tc]
TapeTarko: folds 
lawlex_2: raises $0.04 to $0.06
AlissonStein: calls $0.05
zitrih: folds 
*** FLOP *** [Qc 2h Jc]
AlissonStein: checks 
lawlex_2: bets $0.09
AlissonStein: calls $0.09
*** TURN *** [Qc 2h Jc] [4h]
AlissonStein: checks 
lawlex_2: checks 
*** RIVER *** [Qc 2h Jc 4h] [9d]
AlissonStein: checks 
lawlex_2: bets $0.21
AlissonStein: folds 
Uncalled bet ($0.21) returned to lawlex_2
lawlex_2 collected $0.31 from pot
lawlex_2: doesn't show hand 
*** SUMMARY ***
Total pot $0.32 | Rake $0.01 
Board [Qc 2h Jc 4h 9d]
Seat 2: lawlex_2 (button) collected ($0.31)
Seat 3: AlissonStein (small blind) folded on the River
Seat 5: zitrih (big blind) folded before Flop
Seat 6: TapeTarko folded before Flop (didn't bet)



PokerStars Hand #213577340854:  Hold'em No Limit ($0.01/$0.02 USD) - 2020/05/09 21:45:58 MSK [2020/05/09 14:45:58 ET]
Table 'Antiphos II' 6-max Seat #3 is the button
Seat 2: lawlex_2 ($2.62 in chips) 
Seat 3: AlissonStein ($1.56 in chips) 
Seat 5: zitrih ($1.98 in chips) 
Seat 6: TapeTarko ($3.64 in chips) 
zitrih: posts small blind $0.01
TapeTarko: posts big blind $0.02
INumb: sits out 
*** HOLE CARDS ***
Dealt to lawlex_2 [Tc 8d]
lawlex_2: folds 
AlissonStein: folds 
zitrih: raises $0.02 to $0.04
TapeTarko: calls $0.02
*** FLOP *** [3s 8c 7h]
zitrih: bets $0.04
TapeTarko: calls $0.04
*** TURN *** [3s 8c 7h] [4c]
zitrih: bets $0.08
TapeTarko: folds 
Uncalled bet ($0.08) returned to zitrih
zitrih collected $0.15 from pot
zitrih: doesn't show hand 
*** SUMMARY ***
Total pot $0.16 | Rake $0.01 
Board [3s 8c 7h 4c]
Seat 2: lawlex_2 folded before Flop (didn't bet)
Seat 3: AlissonStein (button) folded before Flop (didn't bet)
Seat 5: zitrih (small blind) collected ($0.15)
Seat 6: TapeTarko (big blind) folded on the Turn



PokerStars Hand #213577382448:  Hold'em No Limit ($0.01/$0.02 USD) - 2020/05/09 21:46:36 MSK [2020/05/09 14:46:36 ET]
Table 'Antiphos II' 6-max Seat #5 is the button
Seat 1: INumb ($2 in chips) 
Seat 2: lawlex_2 ($2.62 in chips) 
Seat 3: AlissonStein ($1.56 in chips) 
Seat 5: zitrih ($2.05 in chips) 
Seat 6: TapeTarko ($3.56 in chips) 
TapeTarko: posts small blind $0.01
INumb: posts big blind $0.02
LocoU 10: sits out 
*** HOLE CARDS ***
Dealt to lawlex_2 [8c 2h]
lawlex_2: folds 
AlissonStein: folds 
zitrih: folds 
TapeTarko: calls $0.01
INumb: checks 
*** FLOP *** [Kd Kc Tc]
TapeTarko: bets $0.02
INumb: folds 
Uncalled bet ($0.02) returned to TapeTarko
TapeTarko collected $0.04 from pot
TapeTarko: doesn't show hand 
*** SUMMARY ***
Total pot $0.04 | Rake $0 
Board [Kd Kc Tc]
Seat 1: INumb (big blind) folded on the Flop
Seat 2: lawlex_2 folded before Flop (didn't bet)
Seat 3: AlissonStein folded before Flop (didn't bet)
Seat 5: zitrih (button) folded before Flop (didn't bet)
Seat 6: TapeTarko (small blind) collected ($0.04)



PokerStars Hand #213577414950:  Hold'em No Limit ($0.01/$0.02 USD) - 2020/05/09 21:47:06 MSK [2020/05/09 14:47:06 ET]
Table 'Antiphos II' 6-max Seat #6 is the button
Seat 1: INumb ($2 in chips) 
Seat 2: lawlex_2 ($2.62 in chips) 
Seat 3: AlissonStein ($1.56 in chips) 
Seat 4: LocoU 10 ($3.34 in chips) 
Seat 5: zitrih ($2.05 in chips) 
Seat 6: TapeTarko ($3.58 in chips) 
INumb: posts small blind $0.01
lawlex_2: posts big blind $0.02
LocoU 10: posts small & big blinds $0.03
*** HOLE CARDS ***
Dealt to lawlex_2 [6h 7c]
AlissonStein: folds 
LocoU 10: checks 
AlissonStein leaves the table
zitrih: calls $0.02
TapeTarko: calls $0.02
INumb: raises $0.04 to $0.06
lawlex_2: folds 
LocoU 10: calls $0.04
zitrih: calls $0.04
TapeTarko: calls $0.04
*** FLOP *** [3h 5d Tc]
INumb: checks 
urmageren joins the table at seat #3 
LocoU 10: checks 
zitrih: checks 
TapeTarko: checks 
*** TURN *** [3h 5d Tc] [2c]
INumb: checks 
LocoU 10: bets $0.06
zitrih: calls $0.06
TapeTarko: calls $0.06
INumb: folds 
*** RIVER *** [3h 5d Tc 2c] [9c]
LocoU 10: bets $0.22
zitrih: folds 
TapeTarko: calls $0.22
*** SHOW DOWN ***
LocoU 10: shows [5c 5s] (three of a kind, Fives)
TapeTarko: mucks hand 
LocoU 10 collected $0.86 from pot
*** SUMMARY ***
Total pot $0.89 | Rake $0.03 
Board [3h 5d Tc 2c 9c]
Seat 1: INumb (small blind) folded on the Turn
Seat 2: lawlex_2 (big blind) folded before Flop
Seat 3: AlissonStein folded before Flop (didn't bet)
Seat 4: LocoU 10 showed [5c 5s] and won ($0.86) with three of a kind, Fives
Seat 5: zitrih folded on the River
Seat 6: TapeTarko (button) mucked [Ts 9h]



PokerStars Hand #213577505721:  Hold'em No Limit ($0.01/$0.02 USD) - 2020/05/09 21:48:30 MSK [2020/05/09 14:48:30 ET]
Table 'Antiphos II' 6-max Seat #1 is the button
Seat 1: INumb ($2 in chips) 
Seat 2: lawlex_2 ($2.60 in chips) 
Seat 3: urmageren ($0.86 in chips) 
Seat 4: LocoU 10 ($3.85 in chips) 
Seat 5: zitrih ($1.93 in chips) 
Seat 6: TapeTarko ($3.24 in chips) 
lawlex_2: posts small blind $0.01
urmageren: posts big blind $0.02
*** HOLE CARDS ***
Dealt to lawlex_2 [Tc Jd]
LocoU 10: folds 
zitrih: calls $0.02
TapeTarko: folds 
INumb: raises $0.03 to $0.05
lawlex_2: folds 
urmageren: calls $0.03
zitrih: calls $0.03
*** FLOP *** [7s 7c 4c]
urmageren: checks 
zitrih: bets $0.08
INumb: calls $0.08
urmageren: folds 
*** TURN *** [7s 7c 4c] [Ks]
zitrih: bets $0.16
INumb: folds 
Uncalled bet ($0.16) returned to zitrih
zitrih collected $0.31 from pot
zitrih: doesn't show hand 
*** SUMMARY ***
Total pot $0.32 | Rake $0.01 
Board [7s 7c 4c Ks]
Seat 1: INumb (button) folded on the Turn
Seat 2: lawlex_2 (small blind) folded before Flop
Seat 3: urmageren (big blind) folded on the Flop
Seat 4: LocoU 10 folded before Flop (didn't bet)
Seat 5: zitrih collected ($0.31)
Seat 6: TapeTarko folded before Flop (didn't bet)



PokerStars Hand #213577552755:  Hold'em No Limit ($0.01/$0.02 USD) - 2020/05/09 21:49:14 MSK [2020/05/09 14:49:14 ET]
Table 'Antiphos II' 6-max Seat #2 is the button
Seat 1: INumb ($2 in chips) 
Seat 2: lawlex_2 ($2.59 in chips) 
Seat 3: urmageren ($0.81 in chips) 
Seat 4: LocoU 10 ($3.85 in chips) 
Seat 5: zitrih ($2.11 in chips) 
Seat 6: TapeTarko ($3.24 in chips) 
urmageren: posts small blind $0.01
LocoU 10: posts big blind $0.02
*** HOLE CARDS ***
Dealt to lawlex_2 [Ad 7d]
zitrih: calls $0.02
TapeTarko: folds 
INumb: raises $0.06 to $0.08
lawlex_2: calls $0.08
urmageren: calls $0.07
LocoU 10: folds 
zitrih: calls $0.06
*** FLOP *** [Ac Qs 8c]
urmageren: checks 
zitrih: checks 
INumb: bets $0.17
lawlex_2: calls $0.17
urmageren: calls $0.17
zitrih: folds 
*** TURN *** [Ac Qs 8c] [Ts]
urmageren: checks 
INumb: checks 
lawlex_2: checks 
*** RIVER *** [Ac Qs 8c Ts] [Th]
urmageren: checks 
INumb: bets $0.62
lawlex_2: calls $0.62
urmageren: folds 
*** SHOW DOWN ***
INumb: shows [8s 8d] (a full house, Eights full of Tens)
lawlex_2: mucks hand 
INumb collected $2.02 from pot
*** SUMMARY ***
Total pot $2.09 | Rake $0.07 
Board [Ac Qs 8c Ts Th]
Seat 1: INumb showed [8s 8d] and won ($2.02) with a full house, Eights full of Tens
Seat 2: lawlex_2 (button) mucked [Ad 7d]
Seat 3: urmageren (small blind) folded on the River
Seat 4: LocoU 10 (big blind) folded before Flop
Seat 5: zitrih folded on the Flop
Seat 6: TapeTarko folded before Flop (didn't bet)



PokerStars Hand #213577633679:  Hold'em No Limit ($0.01/$0.02 USD) - 2020/05/09 21:50:28 MSK [2020/05/09 14:50:28 ET]
Table 'Antiphos II' 6-max Seat #3 is the button
Seat 1: INumb ($3.15 in chips) 
Seat 2: lawlex_2 ($1.72 in chips) 
Seat 3: urmageren ($0.56 in chips) 
Seat 4: LocoU 10 ($3.83 in chips) 
Seat 6: TapeTarko ($3.24 in chips) 
LocoU 10: posts small blind $0.01
TapeTarko: posts big blind $0.02
*** HOLE CARDS ***
Dealt to lawlex_2 [9h Qh]
INumb: folds 
lawlex_2: raises $0.04 to $0.06
urmageren: folds 
LocoU 10: raises $0.06 to $0.12
TapeTarko: folds 
lawlex_2: folds 
Uncalled bet ($0.06) returned to LocoU 10
LocoU 10 collected $0.14 from pot
LocoU 10: doesn't show hand 
*** SUMMARY ***
Total pot $0.14 | Rake $0 
Seat 1: INumb folded before Flop (didn't bet)
Seat 2: lawlex_2 folded before Flop
Seat 3: urmageren (button) folded before Flop (didn't bet)
Seat 4: LocoU 10 (small blind) collected ($0.14)
Seat 6: TapeTarko (big blind) folded before Flop



PokerStars Hand #213577658455:  Hold'em No Limit ($0.01/$0.02 USD) - 2020/05/09 21:50:51 MSK [2020/05/09 14:50:51 ET]
Table 'Antiphos II' 6-max Seat #4 is the button
Seat 1: INumb ($3.15 in chips) 
Seat 2: lawlex_2 ($1.66 in chips) 
Seat 3: urmageren ($0.56 in chips) 
Seat 4: LocoU 10 ($3.91 in chips) 
Seat 6: TapeTarko ($3.22 in chips) 
TapeTarko: posts small blind $0.01
INumb: posts big blind $0.02
*** HOLE CARDS ***
Dealt to lawlex_2 [4c Kh]
lawlex_2: folds 
urmageren: folds 
LocoU 10 has timed out
LocoU 10: folds 
TapeTarko: calls $0.01
INumb: raises $0.04 to $0.06
TapeTarko: calls $0.04
*** FLOP *** [9s 5d Jd]
TapeTarko: checks 
INumb: bets $0.06
TapeTarko: calls $0.06
*** TURN *** [9s 5d Jd] [Jh]
TapeTarko: checks 
INumb: bets $0.17
TapeTarko: calls $0.17
*** RIVER *** [9s 5d Jd Jh] [3d]
TapeTarko: bets $0.56
INumb: calls $0.56
*** SHOW DOWN ***
TapeTarko: shows [4d 7d] (a flush, Jack high)
INumb: mucks hand 
TapeTarko collected $1.64 from pot
*** SUMMARY ***
Total pot $1.70 | Rake $0.06 
Board [9s 5d Jd Jh 3d]
Seat 1: INumb (big blind) mucked [Js Ah]
Seat 2: lawlex_2 folded before Flop (didn't bet)
Seat 3: urmageren folded before Flop (didn't bet)
Seat 4: LocoU 10 (button) folded before Flop (didn't bet)
Seat 6: TapeTarko (small blind) showed [4d 7d] and won ($1.64) with a flush, Jack high



PokerStars Hand #213577729577:  Hold'em No Limit ($0.01/$0.02 USD) - 2020/05/09 21:51:56 MSK [2020/05/09 14:51:56 ET]
Table 'Antiphos II' 6-max Seat #6 is the button
Seat 1: INumb ($2.30 in chips) 
Seat 2: lawlex_2 ($1.66 in chips) 
Seat 3: urmageren ($0.56 in chips) 
Seat 6: TapeTarko ($4.01 in chips) 
INumb: posts small blind $0.01
lawlex_2: posts big blind $0.02
*** HOLE CARDS ***
Dealt to lawlex_2 [Tc As]
urmageren: calls $0.02
TapeTarko: folds 
INumb: raises $0.04 to $0.06
lawlex_2: calls $0.04
urmageren: calls $0.04
*** FLOP *** [4s Th 3d]
INumb: checks 
lawlex_2: bets $0.11
urmageren: calls $0.11
INumb: folds 
*** TURN *** [4s Th 3d] [9d]
lawlex_2: bets $0.26
urmageren: raises $0.13 to $0.39 and is all-in
lawlex_2: calls $0.13
*** RIVER *** [4s Th 3d 9d] [6h]
*** SHOW DOWN ***
lawlex_2: shows [Tc As] (a pair of Tens)
urmageren: shows [3s 3h] (three of a kind, Threes)
urmageren collected $1.14 from pot
*** SUMMARY ***
Total pot $1.18 | Rake $0.04 
Board [4s Th 3d 9d 6h]
Seat 1: INumb (small blind) folded on the Flop
Seat 2: lawlex_2 (big blind) showed [Tc As] and lost with a pair of Tens
Seat 3: urmageren showed [3s 3h] and won ($1.14) with three of a kind, Threes
Seat 6: TapeTarko (button) folded before Flop (didn't bet)



PokerStars Hand #213577775074:  Hold'em No Limit ($0.01/$0.02 USD) - 2020/05/09 21:52:38 MSK [2020/05/09 14:52:38 ET]
Table 'Antiphos II' 6-max Seat #1 is the button
Seat 1: INumb ($2.24 in chips) 
Seat 2: lawlex_2 ($1.10 in chips) 
Seat 3: urmageren ($1.14 in chips) 
Seat 4: LocoU 10 ($3.91 in chips) 
Seat 6: TapeTarko ($4.01 in chips) 
lawlex_2: posts small blind $0.01
urmageren: posts big blind $0.02
*** HOLE CARDS ***
Dealt to lawlex_2 [Jh 4d]
LocoU 10: raises $0.04 to $0.06
TapeTarko: folds 
INumb: folds 
lawlex_2: folds 
urmageren: calls $0.04
*** FLOP *** [Ac 6s 8d]
urmageren: checks 
LocoU 10: bets $0.12
urmageren: folds 
Uncalled bet ($0.12) returned to LocoU 10
LocoU 10 collected $0.13 from pot
LocoU 10: doesn't show hand 
*** SUMMARY ***
Total pot $0.13 | Rake $0 
Board [Ac 6s 8d]
Seat 1: INumb (button) folded before Flop (didn't bet)
Seat 2: lawlex_2 (small blind) folded before Flop
Seat 3: urmageren (big blind) folded on the Flop
Seat 4: LocoU 10 collected ($0.13)
Seat 6: TapeTarko folded before Flop (didn't bet)



PokerStars Hand #213577801451:  Hold'em No Limit ($0.01/$0.02 USD) - 2020/05/09 21:53:02 MSK [2020/05/09 14:53:02 ET]
Table 'Antiphos II' 6-max Seat #2 is the button
Seat 1: INumb ($2.24 in chips) 
Seat 2: lawlex_2 ($1.09 in chips) 
Seat 3: urmageren ($1.08 in chips) 
Seat 4: LocoU 10 ($3.98 in chips) 
Seat 6: TapeTarko ($4.01 in chips) 
urmageren: posts small blind $0.01
LocoU 10: posts big blind $0.02
*** HOLE CARDS ***
Dealt to lawlex_2 [Ac 3s]
TapeTarko: folds 
INumb: raises $0.03 to $0.05
lawlex_2: folds 
urmageren: calls $0.04
LocoU 10: calls $0.03
*** FLOP *** [2s 9c 4s]
urmageren: checks 
LocoU 10: checks 
INumb: checks 
*** TURN *** [2s 9c 4s] [4h]
urmageren: checks 
LocoU 10: checks 
INumb: checks 
*** RIVER *** [2s 9c 4s 4h] [8d]
urmageren: bets $0.14
LocoU 10: folds 
INumb: folds 
Uncalled bet ($0.14) returned to urmageren
urmageren collected $0.14 from pot
urmageren: doesn't show hand 
*** SUMMARY ***
Total pot $0.15 | Rake $0.01 
Board [2s 9c 4s 4h 8d]
Seat 1: INumb folded on the River
Seat 2: lawlex_2 (button) folded before Flop (didn't bet)
Seat 3: urmageren (small blind) collected ($0.14)
Seat 4: LocoU 10 (big blind) folded on the River
Seat 6: TapeTarko folded before Flop (didn't bet)



PokerStars Hand #213577868207:  Hold'em No Limit ($0.01/$0.02 USD) - 2020/05/09 21:54:04 MSK [2020/05/09 14:54:04 ET]
Table 'Antiphos II' 6-max Seat #3 is the button
Seat 1: INumb ($2.19 in chips) 
Seat 2: lawlex_2 ($1.09 in chips) 
Seat 3: urmageren ($1.17 in chips) 
Seat 4: LocoU 10 ($3.93 in chips) 
Seat 6: TapeTarko ($4.01 in chips) 
LocoU 10: posts small blind $0.01
TapeTarko: posts big blind $0.02
*** HOLE CARDS ***
Dealt to lawlex_2 [Td 9h]
INumb: folds 
lawlex_2 has timed out
lawlex_2: folds 
urmageren: calls $0.02
LocoU 10: folds 
TapeTarko: checks 
*** FLOP *** [Ks 9c Qs]
TapeTarko: checks 
urmageren: checks 
*** TURN *** [Ks 9c Qs] [6h]
TapeTarko: bets $0.04
urmageren: calls $0.04
*** RIVER *** [Ks 9c Qs 6h] [2d]
TapeTarko: bets $0.06
urmageren: folds 
Uncalled bet ($0.06) returned to TapeTarko
TapeTarko collected $0.13 from pot
TapeTarko: doesn't show hand 
*** SUMMARY ***
Total pot $0.13 | Rake $0 
Board [Ks 9c Qs 6h 2d]
Seat 1: INumb folded before Flop (didn't bet)
Seat 2: lawlex_2 folded before Flop (didn't bet)
Seat 3: urmageren (button) folded on the River
Seat 4: LocoU 10 (small blind) folded before Flop
Seat 6: TapeTarko (big blind) collected ($0.13)



PokerStars Hand #213577919057:  Hold'em No Limit ($0.01/$0.02 USD) - 2020/05/09 21:54:51 MSK [2020/05/09 14:54:51 ET]
Table 'Antiphos II' 6-max Seat #4 is the button
Seat 1: INumb ($2.19 in chips) 
Seat 2: lawlex_2 ($1.09 in chips) 
Seat 3: urmageren ($1.11 in chips) 
Seat 4: LocoU 10 ($3.92 in chips) 
Seat 6: TapeTarko ($4.08 in chips) 
TapeTarko: posts small blind $0.01
INumb: posts big blind $0.02
*** HOLE CARDS ***
Dealt to lawlex_2 [7s 2c]
lawlex_2: folds 
urmageren: calls $0.02
LocoU 10: folds 
TapeTarko: folds 
INumb: checks 
*** FLOP *** [3s Kc 9h]
INumb: checks 
urmageren: checks 
*** TURN *** [3s Kc 9h] [7c]
INumb: checks 
urmageren: bets $0.04
INumb: calls $0.04
*** RIVER *** [3s Kc 9h 7c] [8d]
INumb: checks 
urmageren: bets $0.13
INumb: folds 
Uncalled bet ($0.13) returned to urmageren
urmageren collected $0.13 from pot
urmageren: doesn't show hand 
*** SUMMARY ***
Total pot $0.13 | Rake $0 
Board [3s Kc 9h 7c 8d]
Seat 1: INumb (big blind) folded on the River
Seat 2: lawlex_2 folded before Flop (didn't bet)
Seat 3: urmageren collected ($0.13)
Seat 4: LocoU 10 (button) folded before Flop (didn't bet)
Seat 6: TapeTarko (small blind) folded before Flop



PokerStars Hand #213577967859:  Hold'em No Limit ($0.01/$0.02 USD) - 2020/05/09 21:55:41 MSK [2020/05/09 14:55:41 ET]
Table 'Antiphos II' 6-max Seat #6 is the button
Seat 1: INumb ($2.13 in chips) 
Seat 2: lawlex_2 ($1.09 in chips) 
Seat 3: urmageren ($1.18 in chips) 
Seat 4: LocoU 10 ($3.92 in chips) 
Seat 6: TapeTarko ($4.07 in chips) 
INumb: posts small blind $0.01
lawlex_2: posts big blind $0.02
*** HOLE CARDS ***
Dealt to lawlex_2 [3s 6s]
urmageren: folds 
LocoU 10: calls $0.02
TapeTarko: folds 
INumb: folds 
lawlex_2: checks 
*** FLOP *** [8h Tc Jh]
lawlex_2: checks 
LocoU 10: bets $0.04
lawlex_2: folds 
Uncalled bet ($0.04) returned to LocoU 10
LocoU 10 collected $0.05 from pot
*** SUMMARY ***
Total pot $0.05 | Rake $0 
Board [8h Tc Jh]
Seat 1: INumb (small blind) folded before Flop
Seat 2: lawlex_2 (big blind) folded on the Flop
Seat 3: urmageren folded before Flop (didn't bet)
Seat 4: LocoU 10 collected ($0.05)
Seat 6: TapeTarko (button) folded before Flop (didn't bet)



PokerStars Hand #213577997173:  Hold'em No Limit ($0.01/$0.02 USD) - 2020/05/09 21:56:22 MSK [2020/05/09 14:56:22 ET]
Table 'Antiphos II' 6-max Seat #1 is the button
Seat 1: INumb ($2.12 in chips) 
Seat 2: lawlex_2 ($1.07 in chips) 
Seat 4: LocoU 10 ($3.95 in chips) 
Seat 6: TapeTarko ($4.07 in chips) 
lawlex_2: posts small blind $0.01
LocoU 10: posts big blind $0.02
*** HOLE CARDS ***
Dealt to lawlex_2 [4s 4c]
TapeTarko: folds 
INumb: raises $0.03 to $0.05
lawlex_2: calls $0.04
LocoU 10: calls $0.03
*** FLOP *** [4d 7d 9s]
lawlex_2: checks 
LocoU 10: bets $0.06
INumb: calls $0.06
lawlex_2: calls $0.06
*** TURN *** [4d 7d 9s] [6d]
lawlex_2: checks 
LocoU 10: bets $0.16
INumb: calls $0.16
lawlex_2: calls $0.16
*** RIVER *** [4d 7d 9s 6d] [Ts]
lawlex_2: checks 
LocoU 10: bets $0.10
INumb: raises $0.74 to $0.84
lawlex_2: calls $0.80 and is all-in
LocoU 10: calls $0.74
*** SHOW DOWN ***
INumb: shows [3d Kd] (a flush, King high)
LocoU 10: mucks hand 
INumb collected $0.07 from side pot
lawlex_2: mucks hand 
INumb collected $3.10 from main pot
*** SUMMARY ***
Total pot $3.29 Main pot $3.10. Side pot $0.07. | Rake $0.12 
Board [4d 7d 9s 6d Ts]
Seat 1: INumb (button) showed [3d Kd] and won ($3.17) with a flush, King high
Seat 2: lawlex_2 (small blind) mucked [4s 4c]
Seat 4: LocoU 10 (big blind) mucked [9d 8d]
Seat 6: TapeTarko folded before Flop (didn't bet)



PokerStars Hand #213578093425:  Hold'em No Limit ($0.01/$0.02 USD) - 2020/05/09 21:58:25 MSK [2020/05/09 14:58:25 ET]
Table 'Antiphos II' 6-max Seat #6 is the button
Seat 1: INumb ($4.37 in chips) 
Seat 2: lawlex_2 ($2 in chips) 
Seat 3: urmageren ($1.18 in chips) 
Seat 4: LocoU 10 ($2.74 in chips) 
Seat 6: TapeTarko ($3.97 in chips) 
INumb: posts small blind $0.01
lawlex_2: posts big blind $0.02
urmageren: posts big blind $0.02
*** HOLE CARDS ***
Dealt to lawlex_2 [2s Ks]
urmageren: checks 
LocoU 10: folds 
TapeTarko: folds 
INumb: raises $0.03 to $0.05
LocoU 10 leaves the table
lawlex_2: folds 
urmageren: calls $0.03
*** FLOP *** [5s 2c 7s]
INumb: checks 
redditchuk20 joins the table at seat #4 
urmageren: checks 
*** TURN *** [5s 2c 7s] [8h]
INumb: folds 
INumb leaves the table
urmageren collected $0.12 from pot
urmageren: doesn't show hand 
*** SUMMARY ***
Total pot $0.12 | Rake $0 
Board [5s 2c 7s 8h]
Seat 1: INumb (small blind) folded on the Turn
Seat 2: lawlex_2 (big blind) folded before Flop
Seat 3: urmageren collected ($0.12)
Seat 4: LocoU 10 folded before Flop (didn't bet)
Seat 6: TapeTarko (button) folded before Flop (didn't bet)



PokerStars Hand #213578110550:  Hold'em No Limit ($0.01/$0.02 USD) - 2020/05/09 21:58:49 MSK [2020/05/09 14:58:49 ET]
Table 'Antiphos II' 6-max Seat #2 is the button
Seat 2: lawlex_2 ($1.98 in chips) 
Seat 3: urmageren ($1.25 in chips) 
Seat 4: redditchuk20 ($2 in chips) 
Seat 6: TapeTarko ($3.97 in chips) 
urmageren: posts small blind $0.01
redditchuk20: posts big blind $0.02
*** HOLE CARDS ***
Dealt to lawlex_2 [9s 9d]
TapeTarko: folds 
lawlex_2: raises $0.04 to $0.06
urmageren: calls $0.05
redditchuk20: folds 
*** FLOP *** [Td Qc Js]
urmageren: checks 
mpk-49 joins the table at seat #1 
lawlex_2: bets $0.09
urmageren: calls $0.09
*** TURN *** [Td Qc Js] [9c]
urmageren: checks 
lawlex_2: checks 
*** RIVER *** [Td Qc Js 9c] [4h]
urmageren: bets $0.15
lawlex_2: calls $0.15
*** SHOW DOWN ***
urmageren: shows [Ts Th] (three of a kind, Tens)
lawlex_2: mucks hand 
urmageren collected $0.60 from pot
*** SUMMARY ***
Total pot $0.62 | Rake $0.02 
Board [Td Qc Js 9c 4h]
Seat 2: lawlex_2 (button) mucked [9s 9d]
Seat 3: urmageren (small blind) showed [Ts Th] and won ($0.60) with three of a kind, Tens
Seat 4: redditchuk20 (big blind) folded before Flop
Seat 6: TapeTarko folded before Flop (didn't bet)



PokerStars Hand #213578142064:  Hold'em No Limit ($0.01/$0.02 USD) - 2020/05/09 21:59:33 MSK [2020/05/09 14:59:33 ET]
Table 'Antiphos II' 6-max Seat #3 is the button
Seat 2: lawlex_2 ($1.68 in chips) 
Seat 3: urmageren ($1.55 in chips) 
Seat 4: redditchuk20 ($2 in chips) 
Seat 6: TapeTarko ($3.97 in chips) 
redditchuk20: posts small blind $0.01
TapeTarko: posts big blind $0.02
mpk-49: sits out 
*** HOLE CARDS ***
Dealt to lawlex_2 [2d 5s]
lawlex_2: folds 
urmageren: folds 
redditchuk20: folds 
Uncalled bet ($0.01) returned to TapeTarko
TapeTarko collected $0.02 from pot
zitrih was removed from the table for failing to post
zitrih leaves the table
TapeTarko: doesn't show hand 
*** SUMMARY ***
Total pot $0.02 | Rake $0 
Seat 2: lawlex_2 folded before Flop (didn't bet)
Seat 3: urmageren (button) folded before Flop (didn't bet)
Seat 4: redditchuk20 (small blind) folded before Flop
Seat 6: TapeTarko (big blind) collected ($0.02)



PokerStars Hand #213578151723:  Hold'em No Limit ($0.01/$0.02 USD) - 2020/05/09 21:59:46 MSK [2020/05/09 14:59:46 ET]
Table 'Antiphos II' 6-max Seat #4 is the button
Seat 1: mpk-49 ($1.60 in chips) 
Seat 2: lawlex_2 ($1.68 in chips) 
Seat 3: urmageren ($1.55 in chips) 
Seat 4: redditchuk20 ($2 in chips) 
Seat 6: TapeTarko ($3.98 in chips) 
TapeTarko: posts small blind $0.01
mpk-49: posts big blind $0.02
*** HOLE CARDS ***
Dealt to lawlex_2 [3h 5d]
lawlex_2: folds 
urmageren: folds 
redditchuk20: raises $0.04 to $0.06
TapeTarko: folds 
retyq71 joins the table at seat #5 
mpk-49: folds 
Uncalled bet ($0.04) returned to redditchuk20
redditchuk20 collected $0.05 from pot
redditchuk20: doesn't show hand 
*** SUMMARY ***
Total pot $0.05 | Rake $0 
Seat 1: mpk-49 (big blind) folded before Flop
Seat 2: lawlex_2 folded before Flop (didn't bet)
Seat 3: urmageren folded before Flop (didn't bet)
Seat 4: redditchuk20 (button) collected ($0.05)
Seat 6: TapeTarko (small blind) folded before Flop



PokerStars Hand #213578167118:  Hold'em No Limit ($0.01/$0.02 USD) - 2020/05/09 22:00:04 MSK [2020/05/09 15:00:04 ET]
Table 'Antiphos II' 6-max Seat #6 is the button
Seat 1: mpk-49 ($1.58 in chips) 
Seat 2: lawlex_2 ($1.68 in chips) 
Seat 3: urmageren ($1.55 in chips) 
Seat 4: redditchuk20 ($2.03 in chips) 
Seat 6: TapeTarko ($3.97 in chips) 
mpk-49: posts small blind $0.01
lawlex_2: posts big blind $0.02
retyq71: sits out 
*** HOLE CARDS ***
Dealt to lawlex_2 [7c Jh]
urmageren: raises $0.02 to $0.04
redditchuk20: folds 
TapeTarko: folds 
mpk-49: folds 
lawlex_2: folds 
Uncalled bet ($0.02) returned to urmageren
urmageren collected $0.05 from pot
urmageren: doesn't show hand 
*** SUMMARY ***
Total pot $0.05 | Rake $0 
Seat 1: mpk-49 (small blind) folded before Flop
Seat 2: lawlex_2 (big blind) folded before Flop
Seat 3: urmageren collected ($0.05)
Seat 4: redditchuk20 folded before Flop (didn't bet)
Seat 6: TapeTarko (button) folded before Flop (didn't bet)



PokerStars Hand #213578179380:  Hold'em No Limit ($0.01/$0.02 USD) - 2020/05/09 22:00:20 MSK [2020/05/09 15:00:20 ET]
Table 'Antiphos II' 6-max Seat #1 is the button
Seat 1: mpk-49 ($1.57 in chips) 
Seat 2: lawlex_2 ($1.66 in chips) 
Seat 3: urmageren ($1.58 in chips) 
Seat 4: redditchuk20 ($2.03 in chips) 
Seat 6: TapeTarko ($3.97 in chips) 
lawlex_2: posts small blind $0.01
urmageren: posts big blind $0.02
retyq71: sits out 
*** HOLE CARDS ***
Dealt to lawlex_2 [4d 2d]
redditchuk20: raises $0.04 to $0.06
TapeTarko: folds 
mpk-49: folds 
lawlex_2: folds 
urmageren: folds 
Uncalled bet ($0.04) returned to redditchuk20
redditchuk20 collected $0.05 from pot
redditchuk20: doesn't show hand 
*** SUMMARY ***
Total pot $0.05 | Rake $0 
Seat 1: mpk-49 (button) folded before Flop (didn't bet)
Seat 2: lawlex_2 (small blind) folded before Flop
Seat 3: urmageren (big blind) folded before Flop
Seat 4: redditchuk20 collected ($0.05)
Seat 6: TapeTarko folded before Flop (didn't bet)



PokerStars Hand #213578187425:  Hold'em No Limit ($0.01/$0.02 USD) - 2020/05/09 22:00:30 MSK [2020/05/09 15:00:30 ET]
Table 'Antiphos II' 6-max Seat #2 is the button
Seat 1: mpk-49 ($1.57 in chips) 
Seat 2: lawlex_2 ($1.65 in chips) 
Seat 3: urmageren ($1.56 in chips) 
Seat 4: redditchuk20 ($2.06 in chips) 
Seat 6: TapeTarko ($3.97 in chips) 
urmageren: posts small blind $0.01
redditchuk20: posts big blind $0.02
retyq71: sits out 
*** HOLE CARDS ***
Dealt to lawlex_2 [5c 5s]
TapeTarko: folds 
mpk-49: calls $0.02
lawlex_2: raises $0.03 to $0.05
urmageren: calls $0.04
redditchuk20: raises $0.19 to $0.24
mpk-49: folds 
lawlex_2: folds 
urmageren: calls $0.19
*** FLOP *** [4s 6s Ts]
urmageren: checks 
redditchuk20: checks 
*** TURN *** [4s 6s Ts] [Qh]
urmageren: checks 
redditchuk20: bets $0.24
urmageren: calls $0.24
*** RIVER *** [4s 6s Ts Qh] [9s]
urmageren: checks 
redditchuk20: bets $1.24
urmageren: calls $1.08 and is all-in
Uncalled bet ($0.16) returned to redditchuk20
*** SHOW DOWN ***
redditchuk20: shows [Qs Kd] (a flush, Queen high)
urmageren: shows [8c As] (a flush, Ace high)
urmageren collected $3.08 from pot
*** SUMMARY ***
Total pot $3.19 | Rake $0.11 
Board [4s 6s Ts Qh 9s]
Seat 1: mpk-49 folded before Flop
Seat 2: lawlex_2 (button) folded before Flop
Seat 3: urmageren (small blind) showed [8c As] and won ($3.08) with a flush, Ace high
Seat 4: redditchuk20 (big blind) showed [Qs Kd] and lost with a flush, Queen high
Seat 6: TapeTarko folded before Flop (didn't bet)



PokerStars Hand #213578235934:  Hold'em No Limit ($0.01/$0.02 USD) - 2020/05/09 22:01:27 MSK [2020/05/09 15:01:27 ET]
Table 'Antiphos II' 6-max Seat #3 is the button
Seat 1: mpk-49 ($1.55 in chips) 
Seat 2: lawlex_2 ($1.60 in chips) 
Seat 3: urmageren ($3.08 in chips) 
Seat 4: redditchuk20 ($2 in chips) 
Seat 5: retyq71 ($2 in chips) 
Seat 6: TapeTarko ($3.97 in chips) 
redditchuk20: posts small blind $0.01
retyq71: posts big blind $0.02
*** HOLE CARDS ***
Dealt to lawlex_2 [3c Ah]
TapeTarko: folds 
mpk-49: calls $0.02
lawlex_2: raises $0.03 to $0.05
urmageren: calls $0.05
redditchuk20: folds 
retyq71: calls $0.03
mpk-49: calls $0.03
*** FLOP *** [3s 6h 4s]
retyq71: bets $0.04
mpk-49: folds 
lawlex_2: calls $0.04
urmageren: calls $0.04
*** TURN *** [3s 6h 4s] [8c]
retyq71: checks 
lawlex_2: checks 
urmageren: checks 
*** RIVER *** [3s 6h 4s 8c] [Qh]
retyq71: checks 
lawlex_2: checks 
urmageren: bets $0.16
retyq71: folds 
lawlex_2: folds 
Uncalled bet ($0.16) returned to urmageren
urmageren collected $0.32 from pot
urmageren: doesn't show hand 
*** SUMMARY ***
Total pot $0.33 | Rake $0.01 
Board [3s 6h 4s 8c Qh]
Seat 1: mpk-49 folded on the Flop
Seat 2: lawlex_2 folded on the River
Seat 3: urmageren (button) collected ($0.32)
Seat 4: redditchuk20 (small blind) folded before Flop
Seat 5: retyq71 (big blind) folded on the River
Seat 6: TapeTarko folded before Flop (didn't bet)



PokerStars Hand #213578302520:  Hold'em No Limit ($0.01/$0.02 USD) - 2020/05/09 22:02:35 MSK [2020/05/09 15:02:35 ET]
Table 'Antiphos II' 6-max Seat #4 is the button
Seat 1: mpk-49 ($1.50 in chips) 
Seat 2: lawlex_2 ($1.51 in chips) 
Seat 3: urmageren ($3.31 in chips) 
Seat 4: redditchuk20 ($2 in chips) 
Seat 5: retyq71 ($1.91 in chips) 
Seat 6: TapeTarko ($3.97 in chips) 
retyq71: posts small blind $0.01
TapeTarko: posts big blind $0.02
*** HOLE CARDS ***
Dealt to lawlex_2 [Jd 2d]
mpk-49: folds 
lawlex_2: folds 
urmageren: raises $0.02 to $0.04
redditchuk20: folds 
retyq71: calls $0.03
TapeTarko: calls $0.02
*** FLOP *** [5s 7c 5h]
retyq71: checks 
TapeTarko: checks 
urmageren: bets $0.02
retyq71: calls $0.02
TapeTarko: calls $0.02
*** TURN *** [5s 7c 5h] [6s]
retyq71: bets $0.04
TapeTarko: folds 
urmageren: calls $0.04
*** RIVER *** [5s 7c 5h 6s] [2h]
retyq71: bets $0.06
urmageren: calls $0.06
*** SHOW DOWN ***
retyq71: shows [5d 4c] (three of a kind, Fives)
urmageren: mucks hand 
retyq71 collected $0.37 from pot
*** SUMMARY ***
Total pot $0.38 | Rake $0.01 
Board [5s 7c 5h 6s 2h]
Seat 1: mpk-49 folded before Flop (didn't bet)
Seat 2: lawlex_2 folded before Flop (didn't bet)
Seat 3: urmageren mucked [Ac Ah]
Seat 4: redditchuk20 (button) folded before Flop (didn't bet)
Seat 5: retyq71 (small blind) showed [5d 4c] and won ($0.37) with three of a kind, Fives
Seat 6: TapeTarko (big blind) folded on the Turn



PokerStars Hand #213578358321:  Hold'em No Limit ($0.01/$0.02 USD) - 2020/05/09 22:03:23 MSK [2020/05/09 15:03:23 ET]
Table 'Antiphos II' 6-max Seat #5 is the button
Seat 1: mpk-49 ($1.50 in chips) 
Seat 2: lawlex_2 ($1.51 in chips) 
Seat 3: urmageren ($3.15 in chips) 
Seat 4: redditchuk20 ($2 in chips) 
Seat 5: retyq71 ($2.12 in chips) 
Seat 6: TapeTarko ($3.91 in chips) 
TapeTarko: posts small blind $0.01
mpk-49: posts big blind $0.02
*** HOLE CARDS ***
Dealt to lawlex_2 [Ts 5s]
lawlex_2: folds 
urmageren: calls $0.02
redditchuk20: folds 
retyq71: folds 
TapeTarko: calls $0.01
mpk-49: checks 
*** FLOP *** [Kc Qs 6h]
TapeTarko: checks 
mpk-49: checks 
urmageren: checks 
*** TURN *** [Kc Qs 6h] [9s]
TapeTarko: checks 
mpk-49: checks 
urmageren: checks 
*** RIVER *** [Kc Qs 6h 9s] [5c]
TapeTarko: checks 
mpk-49: checks 
urmageren: checks 
*** SHOW DOWN ***
TapeTarko: shows [7d 3d] (high card King)
mpk-49: shows [9d Th] (a pair of Nines)
urmageren: mucks hand 
mpk-49 collected $0.06 from pot
*** SUMMARY ***
Total pot $0.06 | Rake $0 
Board [Kc Qs 6h 9s 5c]
Seat 1: mpk-49 (big blind) showed [9d Th] and won ($0.06) with a pair of Nines
Seat 2: lawlex_2 folded before Flop (didn't bet)
Seat 3: urmageren mucked [Ah 7h]
Seat 4: redditchuk20 folded before Flop (didn't bet)
Seat 5: retyq71 (button) folded before Flop (didn't bet)
Seat 6: TapeTarko (small blind) showed [7d 3d] and lost with high card King



PokerStars Hand #213578425960:  Hold'em No Limit ($0.01/$0.02 USD) - 2020/05/09 22:04:26 MSK [2020/05/09 15:04:26 ET]
Table 'Antiphos II' 6-max Seat #6 is the button
Seat 1: mpk-49 ($1.54 in chips) 
Seat 2: lawlex_2 ($1.51 in chips) 
Seat 3: urmageren ($3.13 in chips) 
Seat 4: redditchuk20 ($2 in chips) 
Seat 5: retyq71 ($2.12 in chips) 
Seat 6: TapeTarko ($3.89 in chips) 
mpk-49: posts small blind $0.01
lawlex_2: posts big blind $0.02
*** HOLE CARDS ***
Dealt to lawlex_2 [2d 7s]
urmageren: folds 
redditchuk20: folds 
retyq71: calls $0.02
TapeTarko: folds 
mpk-49: calls $0.01
lawlex_2: checks 
*** FLOP *** [8s Qh Kd]
mpk-49: checks 
lawlex_2: checks 
retyq71: checks 
*** TURN *** [8s Qh Kd] [6c]
mpk-49: checks 
lawlex_2: checks 
retyq71: checks 
*** RIVER *** [8s Qh Kd 6c] [5d]
mpk-49: checks 
lawlex_2: checks 
retyq71: checks 
*** SHOW DOWN ***
mpk-49: shows [Ts Js] (high card King)
lawlex_2: mucks hand 
retyq71: mucks hand 
mpk-49 collected $0.06 from pot
*** SUMMARY ***
Total pot $0.06 | Rake $0 
Board [8s Qh Kd 6c 5d]
Seat 1: mpk-49 (small blind) showed [Ts Js] and won ($0.06) with high card King
Seat 2: lawlex_2 (big blind) mucked [2d 7s]
Seat 3: urmageren folded before Flop (didn't bet)
Seat 4: redditchuk20 folded before Flop (didn't bet)
Seat 5: retyq71 mucked [4s 2h]
Seat 6: TapeTarko (button) folded before Flop (didn't bet)



PokerStars Hand #213578479079:  Hold'em No Limit ($0.01/$0.02 USD) - 2020/05/09 22:05:12 MSK [2020/05/09 15:05:12 ET]
Table 'Antiphos II' 6-max Seat #1 is the button
Seat 1: mpk-49 ($1.58 in chips) 
Seat 2: lawlex_2 ($1.49 in chips) 
Seat 3: urmageren ($3.13 in chips) 
Seat 4: redditchuk20 ($2 in chips) 
Seat 5: retyq71 ($2.10 in chips) 
Seat 6: TapeTarko ($3.89 in chips) 
lawlex_2: posts small blind $0.01
urmageren: posts big blind $0.02
*** HOLE CARDS ***
Dealt to lawlex_2 [Td 9h]
redditchuk20: folds 
retyq71: folds 
TapeTarko: raises $0.04 to $0.06
mpk-49: folds 
lawlex_2: folds 
urmageren: calls $0.04
*** FLOP *** [8s Tc Jh]
urmageren: checks 
TapeTarko: bets $0.06
urmageren: folds 
Uncalled bet ($0.06) returned to TapeTarko
TapeTarko collected $0.13 from pot
TapeTarko: doesn't show hand 
*** SUMMARY ***
Total pot $0.13 | Rake $0 
Board [8s Tc Jh]
Seat 1: mpk-49 (button) folded before Flop (didn't bet)
Seat 2: lawlex_2 (small blind) folded before Flop
Seat 3: urmageren (big blind) folded on the Flop
Seat 4: redditchuk20 folded before Flop (didn't bet)
Seat 5: retyq71 folded before Flop (didn't bet)
Seat 6: TapeTarko collected ($0.13)



PokerStars Hand #213578528145:  Hold'em No Limit ($0.01/$0.02 USD) - 2020/05/09 22:05:55 MSK [2020/05/09 15:05:55 ET]
Table 'Antiphos II' 6-max Seat #2 is the button
Seat 1: mpk-49 ($1.58 in chips) 
Seat 2: lawlex_2 ($1.48 in chips) 
Seat 3: urmageren ($3.07 in chips) 
Seat 4: redditchuk20 ($2 in chips) 
Seat 5: retyq71 ($2.10 in chips) 
Seat 6: TapeTarko ($3.96 in chips) 
urmageren: posts small blind $0.01
redditchuk20: posts big blind $0.02
*** HOLE CARDS ***
Dealt to lawlex_2 [7h 6d]
retyq71: folds 
TapeTarko: raises $0.04 to $0.06
mpk-49: folds 
lawlex_2: folds 
urmageren: calls $0.05
redditchuk20: folds 
*** FLOP *** [9h Qc Ad]
urmageren: checks 
TapeTarko: bets $0.06
urmageren: folds 
Uncalled bet ($0.06) returned to TapeTarko
TapeTarko collected $0.14 from pot
TapeTarko: doesn't show hand 
*** SUMMARY ***
Total pot $0.14 | Rake $0 
Board [9h Qc Ad]
Seat 1: mpk-49 folded before Flop (didn't bet)
Seat 2: lawlex_2 (button) folded before Flop (didn't bet)
Seat 3: urmageren (small blind) folded on the Flop
Seat 4: redditchuk20 (big blind) folded before Flop
Seat 5: retyq71 folded before Flop (didn't bet)
Seat 6: TapeTarko collected ($0.14)



PokerStars Hand #213578558447:  Hold'em No Limit ($0.01/$0.02 USD) - 2020/05/09 22:06:22 MSK [2020/05/09 15:06:22 ET]
Table 'Antiphos II' 6-max Seat #3 is the button
Seat 1: mpk-49 ($1.58 in chips) 
Seat 2: lawlex_2 ($1.48 in chips) 
Seat 3: urmageren ($3.01 in chips) 
Seat 4: redditchuk20 ($2 in chips) 
Seat 5: retyq71 ($2.10 in chips) 
Seat 6: TapeTarko ($4.04 in chips) 
redditchuk20: posts small blind $0.01
retyq71: posts big blind $0.02
*** HOLE CARDS ***
Dealt to lawlex_2 [Kc Qs]
TapeTarko: folds 
mpk-49: folds 
lawlex_2: raises $0.03 to $0.05
urmageren: folds 
urmageren leaves the table
redditchuk20: folds 
Fella30a joins the table at seat #3 
retyq71: calls $0.03
*** FLOP *** [Qh Kh Js]
retyq71: checks 
lawlex_2: bets $0.07
retyq71: folds 
Uncalled bet ($0.07) returned to lawlex_2
lawlex_2 collected $0.11 from pot
lawlex_2: doesn't show hand 
*** SUMMARY ***
Total pot $0.11 | Rake $0 
Board [Qh Kh Js]
Seat 1: mpk-49 folded before Flop (didn't bet)
Seat 2: lawlex_2 collected ($0.11)
Seat 3: urmageren (button) folded before Flop (didn't bet)
Seat 4: redditchuk20 (small blind) folded before Flop
Seat 5: retyq71 (big blind) folded on the Flop
Seat 6: TapeTarko folded before Flop (didn't bet)



PokerStars Hand #213578592913:  Hold'em No Limit ($0.01/$0.02 USD) - 2020/05/09 22:06:46 MSK [2020/05/09 15:06:46 ET]
Table 'Antiphos II' 6-max Seat #4 is the button
Seat 1: mpk-49 ($1.58 in chips) 
Seat 2: lawlex_2 ($1.54 in chips) 
Seat 3: Fella30a ($2 in chips) 
Seat 4: redditchuk20 ($2 in chips) 
Seat 5: retyq71 ($2.05 in chips) 
Seat 6: TapeTarko ($4.04 in chips) 
retyq71: posts small blind $0.01
TapeTarko: posts big blind $0.02
Fella30a: posts big blind $0.02
*** HOLE CARDS ***
Dealt to lawlex_2 [Ts Ks]
mpk-49: folds 
lawlex_2: raises $0.03 to $0.05
Fella30a: calls $0.03
redditchuk20: folds 
retyq71: folds 
TapeTarko: calls $0.03
*** FLOP *** [Jd 7s Td]
TapeTarko: checks 
lawlex_2: bets $0.10
Fella30a: calls $0.10
TapeTarko: folds 
*** TURN *** [Jd 7s Td] [Tc]
lawlex_2: checks 
Fella30a: bets $0.02
lawlex_2: calls $0.02
*** RIVER *** [Jd 7s Td Tc] [7c]
lawlex_2: checks 
Fella30a: checks 
*** SHOW DOWN ***
lawlex_2: shows [Ts Ks] (a full house, Tens full of Sevens)
Fella30a: mucks hand 
lawlex_2 collected $0.39 from pot
*** SUMMARY ***
Total pot $0.40 | Rake $0.01 
Board [Jd 7s Td Tc 7c]
Seat 1: mpk-49 folded before Flop (didn't bet)
Seat 2: lawlex_2 showed [Ts Ks] and won ($0.39) with a full house, Tens full of Sevens
Seat 3: Fella30a mucked [9c Ad]
Seat 4: redditchuk20 (button) folded before Flop (didn't bet)
Seat 5: retyq71 (small blind) folded before Flop
Seat 6: TapeTarko (big blind) folded on the Flop



PokerStars Hand #213578653294:  Hold'em No Limit ($0.01/$0.02 USD) - 2020/05/09 22:07:38 MSK [2020/05/09 15:07:38 ET]
Table 'Antiphos II' 6-max Seat #5 is the button
Seat 1: mpk-49 ($1.58 in chips) 
Seat 2: lawlex_2 ($1.76 in chips) 
Seat 3: Fella30a ($1.83 in chips) 
Seat 4: redditchuk20 ($2 in chips) 
Seat 5: retyq71 ($2.04 in chips) 
Seat 6: TapeTarko ($3.99 in chips) 
TapeTarko: posts small blind $0.01
mpk-49: posts big blind $0.02
*** HOLE CARDS ***
Dealt to lawlex_2 [Ks Th]
lawlex_2: raises $0.03 to $0.05
Fella30a: calls $0.05
redditchuk20: folds 
retyq71: raises $0.05 to $0.10
TapeTarko: folds 
mpk-49: folds 
lawlex_2: folds 
Fella30a: calls $0.05
*** FLOP *** [2c 5h 7d]
Fella30a: checks 
retyq71: bets $0.12
Fella30a: folds 
Uncalled bet ($0.12) returned to retyq71
retyq71 collected $0.27 from pot
retyq71: doesn't show hand 
*** SUMMARY ***
Total pot $0.28 | Rake $0.01 
Board [2c 5h 7d]
Seat 1: mpk-49 (big blind) folded before Flop
Seat 2: lawlex_2 folded before Flop
Seat 3: Fella30a folded on the Flop
Seat 4: redditchuk20 folded before Flop (didn't bet)
Seat 5: retyq71 (button) collected ($0.27)
Seat 6: TapeTarko (small blind) folded before Flop



PokerStars Hand #213578690962:  Hold'em No Limit ($0.01/$0.02 USD) - 2020/05/09 22:08:11 MSK [2020/05/09 15:08:11 ET]
Table 'Antiphos II' 6-max Seat #6 is the button
Seat 1: mpk-49 ($1.56 in chips) 
Seat 2: lawlex_2 ($1.71 in chips) 
Seat 3: Fella30a ($1.73 in chips) 
Seat 4: redditchuk20 ($2 in chips) 
Seat 5: retyq71 ($2.21 in chips) 
Seat 6: TapeTarko ($3.98 in chips) 
mpk-49: posts small blind $0.01
lawlex_2: posts big blind $0.02
*** HOLE CARDS ***
Dealt to lawlex_2 [Qd Ts]
Fella30a: calls $0.02
redditchuk20: folds 
retyq71: folds 
TapeTarko: raises $0.06 to $0.08
mpk-49: folds 
lawlex_2: folds 
Fella30a: folds 
Uncalled bet ($0.06) returned to TapeTarko
TapeTarko collected $0.07 from pot
TapeTarko: doesn't show hand 
*** SUMMARY ***
Total pot $0.07 | Rake $0 
Seat 1: mpk-49 (small blind) folded before Flop
Seat 2: lawlex_2 (big blind) folded before Flop
Seat 3: Fella30a folded before Flop
Seat 4: redditchuk20 folded before Flop (didn't bet)
Seat 5: retyq71 folded before Flop (didn't bet)
Seat 6: TapeTarko (button) collected ($0.07)



PokerStars Hand #213578712041:  Hold'em No Limit ($0.01/$0.02 USD) - 2020/05/09 22:08:30 MSK [2020/05/09 15:08:30 ET]
Table 'Antiphos II' 6-max Seat #1 is the button
Seat 1: mpk-49 ($1.55 in chips) 
Seat 2: lawlex_2 ($1.69 in chips) 
Seat 3: Fella30a ($1.71 in chips) 
Seat 4: redditchuk20 ($2 in chips) 
Seat 5: retyq71 ($2.21 in chips) 
Seat 6: TapeTarko ($4.03 in chips) 
lawlex_2: posts small blind $0.01
Fella30a: posts big blind $0.02
*** HOLE CARDS ***
Dealt to lawlex_2 [7d Qs]
redditchuk20: folds 
retyq71: calls $0.02
TapeTarko: folds 
mpk-49: folds 
lawlex_2: folds 
Fella30a: checks 
*** FLOP *** [3s Ks 5d]
Fella30a: checks 
retyq71: bets $0.10
Fella30a: folds 
Uncalled bet ($0.10) returned to retyq71
retyq71 collected $0.05 from pot
retyq71: doesn't show hand 
*** SUMMARY ***
Total pot $0.05 | Rake $0 
Board [3s Ks 5d]
Seat 1: mpk-49 (button) folded before Flop (didn't bet)
Seat 2: lawlex_2 (small blind) folded before Flop
Seat 3: Fella30a (big blind) folded on the Flop
Seat 4: redditchuk20 folded before Flop (didn't bet)
Seat 5: retyq71 collected ($0.05)
Seat 6: TapeTarko folded before Flop (didn't bet)



PokerStars Hand #213578738502:  Hold'em No Limit ($0.01/$0.02 USD) - 2020/05/09 22:08:53 MSK [2020/05/09 15:08:53 ET]
Table 'Antiphos II' 6-max Seat #2 is the button
Seat 1: mpk-49 ($1.55 in chips) 
Seat 2: lawlex_2 ($1.68 in chips) 
Seat 3: Fella30a ($1.69 in chips) 
Seat 4: redditchuk20 ($2 in chips) 
Seat 5: retyq71 ($2.24 in chips) 
Seat 6: TapeTarko ($4.03 in chips) 
Fella30a: posts small blind $0.01
redditchuk20: posts big blind $0.02
*** HOLE CARDS ***
Dealt to lawlex_2 [4s 9s]
retyq71: calls $0.02
TapeTarko: folds 
mpk-49: calls $0.02
lawlex_2: folds 
Fella30a: calls $0.01
redditchuk20: checks 
*** FLOP *** [2s Kd 3h]
Fella30a: checks 
redditchuk20: checks 
retyq71: bets $0.02
mpk-49: calls $0.02
Fella30a: folds 
redditchuk20: folds 
*** TURN *** [2s Kd 3h] [Qd]
retyq71: bets $0.02
mpk-49: calls $0.02
*** RIVER *** [2s Kd 3h Qd] [4c]
retyq71: bets $0.14
mpk-49: raises $0.43 to $0.57
retyq71: folds 
Uncalled bet ($0.43) returned to mpk-49
mpk-49 collected $0.42 from pot
mpk-49: doesn't show hand 
*** SUMMARY ***
Total pot $0.44 | Rake $0.02 
Board [2s Kd 3h Qd 4c]
Seat 1: mpk-49 collected ($0.42)
Seat 2: lawlex_2 (button) folded before Flop (didn't bet)
Seat 3: Fella30a (small blind) folded on the Flop
Seat 4: redditchuk20 (big blind) folded on the Flop
Seat 5: retyq71 folded on the River
Seat 6: TapeTarko folded before Flop (didn't bet)



PokerStars Hand #213578814629:  Hold'em No Limit ($0.01/$0.02 USD) - 2020/05/09 22:09:59 MSK [2020/05/09 15:09:59 ET]
Table 'Antiphos II' 6-max Seat #3 is the button
Seat 1: mpk-49 ($1.77 in chips) 
Seat 2: lawlex_2 ($1.68 in chips) 
Seat 3: Fella30a ($1.67 in chips) 
Seat 4: redditchuk20 ($2 in chips) 
Seat 5: retyq71 ($2.04 in chips) 
Seat 6: TapeTarko ($4.03 in chips) 
redditchuk20: posts small blind $0.01
retyq71: posts big blind $0.02
*** HOLE CARDS ***
Dealt to lawlex_2 [9c 7s]
TapeTarko: folds 
mpk-49: folds 
lawlex_2: folds 
Fella30a: folds 
redditchuk20: raises $0.04 to $0.06
retyq71: calls $0.04
*** FLOP *** [Qh 9d 5h]
redditchuk20: bets $0.06
retyq71: folds 
Uncalled bet ($0.06) returned to redditchuk20
redditchuk20 collected $0.12 from pot
redditchuk20: doesn't show hand 
*** SUMMARY ***
Total pot $0.12 | Rake $0 
Board [Qh 9d 5h]
Seat 1: mpk-49 folded before Flop (didn't bet)
Seat 2: lawlex_2 folded before Flop (didn't bet)
Seat 3: Fella30a (button) folded before Flop (didn't bet)
Seat 4: redditchuk20 (small blind) collected ($0.12)
Seat 5: retyq71 (big blind) folded on the Flop
Seat 6: TapeTarko folded before Flop (didn't bet)



PokerStars Hand #213578838084:  Hold'em No Limit ($0.01/$0.02 USD) - 2020/05/09 22:10:19 MSK [2020/05/09 15:10:19 ET]
Table 'Antiphos II' 6-max Seat #4 is the button
Seat 1: mpk-49 ($1.77 in chips) 
Seat 2: lawlex_2 ($1.68 in chips) 
Seat 3: Fella30a ($1.67 in chips) 
Seat 4: redditchuk20 ($2.06 in chips) 
Seat 5: retyq71 ($1.98 in chips) 
Seat 6: TapeTarko ($4.03 in chips) 
retyq71: posts small blind $0.01
TapeTarko: posts big blind $0.02
*** HOLE CARDS ***
Dealt to lawlex_2 [7h Kh]
mpk-49: folds 
mpk-49 leaves the table
lawlex_2 has timed out
lawlex_2: folds 
Fella30a: calls $0.02
redditchuk20: folds 
retyq71: calls $0.01
TapeTarko: checks 
*** FLOP *** [Kc 6s Ah]
retyq71: checks 
redditchuk20 leaves the table
TapeTarko: checks 
Fella30a: checks 
*** TURN *** [Kc 6s Ah] [7s]
retyq71: checks 
TapeTarko: checks 
Fella30a: bets $0.02
retyq71: folds 
Jammywhisker joins the table at seat #4 
TapeTarko: folds 
Uncalled bet ($0.02) returned to Fella30a
Fella30a collected $0.06 from pot
Fella30a: doesn't show hand 
*** SUMMARY ***
Total pot $0.06 | Rake $0 
Board [Kc 6s Ah 7s]
Seat 1: mpk-49 folded before Flop (didn't bet)
Seat 2: lawlex_2 folded before Flop (didn't bet)
Seat 3: Fella30a collected ($0.06)
Seat 4: redditchuk20 (button) folded before Flop (didn't bet)
Seat 5: retyq71 (small blind) folded on the Turn
Seat 6: TapeTarko (big blind) folded on the Turn



PokerStars Hand #213578891336:  Hold'em No Limit ($0.01/$0.02 USD) - 2020/05/09 22:11:05 MSK [2020/05/09 15:11:05 ET]
Table 'Antiphos II' 6-max Seat #5 is the button
Seat 2: lawlex_2 ($1.68 in chips) 
Seat 3: Fella30a ($1.71 in chips) 
Seat 5: retyq71 ($1.96 in chips) 
Seat 6: TapeTarko ($4.01 in chips) 
TapeTarko: posts small blind $0.01
lawlex_2: posts big blind $0.02
Jammywhisker: sits out 
*** HOLE CARDS ***
Dealt to lawlex_2 [Qd Ah]
Fella30a: calls $0.02
retyq71: raises $0.04 to $0.06
TapeTarko: folds 
lawlex_2: calls $0.04
Fella30a: calls $0.04
*** FLOP *** [2c 9s Ks]
lawlex_2: checks 
Fella30a: checks 
retyq71: checks 
*** TURN *** [2c 9s Ks] [8s]
lawlex_2: checks 
Fella30a: bets $0.02
retyq71: calls $0.02
lawlex_2: folds 
*** RIVER *** [2c 9s Ks 8s] [Th]
Fella30a: checks 
retyq71: bets $0.08
Fella30a: folds 
Uncalled bet ($0.08) returned to retyq71
retyq71 collected $0.22 from pot
retyq71: doesn't show hand 
*** SUMMARY ***
Total pot $0.23 | Rake $0.01 
Board [2c 9s Ks 8s Th]
Seat 2: lawlex_2 (big blind) folded on the Turn
Seat 3: Fella30a folded on the River
Seat 5: retyq71 (button) collected ($0.22)
Seat 6: TapeTarko (small blind) folded before Flop



PokerStars Hand #213578952364:  Hold'em No Limit ($0.01/$0.02 USD) - 2020/05/09 22:11:58 MSK [2020/05/09 15:11:58 ET]
Table 'Antiphos II' 6-max Seat #6 is the button
Seat 2: lawlex_2 ($1.62 in chips) 
Seat 3: Fella30a ($1.63 in chips) 
Seat 5: retyq71 ($2.10 in chips) 
Seat 6: TapeTarko ($4 in chips) 
lawlex_2: posts small blind $0.01
Fella30a: posts big blind $0.02
Jammywhisker: sits out 
*** HOLE CARDS ***
Dealt to lawlex_2 [9c 4d]
retyq71: folds 
TapeTarko: raises $0.04 to $0.06
lawlex_2: folds 
Fella30a: calls $0.04
*** FLOP *** [9s 5c Ts]
Fella30a: bets $0.02
TapeTarko: raises $0.06 to $0.08
Fella30a: calls $0.06
*** TURN *** [9s 5c Ts] [3d]
Fella30a: checks 
TapeTarko: bets $0.20
Fella30a: calls $0.20
*** RIVER *** [9s 5c Ts 3d] [3c]
visiit joins the table at seat #1 
Fella30a: checks 
TapeTarko: checks 
*** SHOW DOWN ***
Fella30a: shows [4s As] (a pair of Threes)
TapeTarko: shows [8d 9d] (two pair, Nines and Threes)
TapeTarko collected $0.67 from pot
*** SUMMARY ***
Total pot $0.69 | Rake $0.02 
Board [9s 5c Ts 3d 3c]
Seat 2: lawlex_2 (small blind) folded before Flop
Seat 3: Fella30a (big blind) showed [4s As] and lost with a pair of Threes
Seat 5: retyq71 folded before Flop (didn't bet)
Seat 6: TapeTarko (button) showed [8d 9d] and won ($0.67) with two pair, Nines and Threes



PokerStars Hand #213579019055:  Hold'em No Limit ($0.01/$0.02 USD) - 2020/05/09 22:12:56 MSK [2020/05/09 15:12:56 ET]
Table 'Antiphos II' 6-max Seat #2 is the button
Seat 2: lawlex_2 ($1.61 in chips) 
Seat 3: Fella30a ($1.29 in chips) 
Seat 4: Jammywhisker ($2 in chips) 
Seat 5: retyq71 ($2.10 in chips) 
Seat 6: TapeTarko ($4.33 in chips) 
Fella30a: posts small blind $0.01
Jammywhisker: posts big blind $0.02
visiit: sits out 
*** HOLE CARDS ***
Dealt to lawlex_2 [2s 7h]
retyq71: raises $0.04 to $0.06
TapeTarko: folds 
lawlex_2: folds 
Fella30a: calls $0.05
Jammywhisker: folds 
*** FLOP *** [9d 5c 4h]
Fella30a: checks 
retyq71: bets $0.06
Fella30a: folds 
Uncalled bet ($0.06) returned to retyq71
retyq71 collected $0.14 from pot
retyq71: doesn't show hand 
*** SUMMARY ***
Total pot $0.14 | Rake $0 
Board [9d 5c 4h]
Seat 2: lawlex_2 (button) folded before Flop (didn't bet)
Seat 3: Fella30a (small blind) folded on the Flop
Seat 4: Jammywhisker (big blind) folded before Flop
Seat 5: retyq71 collected ($0.14)
Seat 6: TapeTarko folded before Flop (didn't bet)



PokerStars Hand #213579049894:  Hold'em No Limit ($0.01/$0.02 USD) - 2020/05/09 22:13:22 MSK [2020/05/09 15:13:22 ET]
Table 'Antiphos II' 6-max Seat #3 is the button
Seat 2: lawlex_2 ($1.61 in chips) 
Seat 3: Fella30a ($1.23 in chips) 
Seat 4: Jammywhisker ($2 in chips) 
Seat 5: retyq71 ($2.18 in chips) 
Seat 6: TapeTarko ($4.33 in chips) 
Jammywhisker: posts small blind $0.01
retyq71: posts big blind $0.02
visiit: sits out 
*** HOLE CARDS ***
Dealt to lawlex_2 [7c Ac]
TapeTarko: folds 
lawlex_2: raises $0.03 to $0.05
Fella30a: folds 
Jammywhisker: folds 
retyq71: calls $0.03
*** FLOP *** [3s 8d 2h]
retyq71: checks 
lawlex_2: checks 
*** TURN *** [3s 8d 2h] [2c]
retyq71: bets $0.04
visiit is disconnected 
lawlex_2: calls $0.04
*** RIVER *** [3s 8d 2h 2c] [4c]
retyq71: bets $0.06
lawlex_2: folds 
Uncalled bet ($0.06) returned to retyq71
retyq71 collected $0.18 from pot
*** SUMMARY ***
Total pot $0.19 | Rake $0.01 
Board [3s 8d 2h 2c 4c]
Seat 2: lawlex_2 folded on the River
Seat 3: Fella30a (button) folded before Flop (didn't bet)
Seat 4: Jammywhisker (small blind) folded before Flop
Seat 5: retyq71 (big blind) collected ($0.18)
Seat 6: TapeTarko folded before Flop (didn't bet)



PokerStars Hand #213579109131:  Hold'em No Limit ($0.01/$0.02 USD) - 2020/05/09 22:14:13 MSK [2020/05/09 15:14:13 ET]
Table 'Antiphos II' 6-max Seat #4 is the button
Seat 2: lawlex_2 ($1.52 in chips) 
Seat 3: Fella30a ($1.23 in chips) 
Seat 4: Jammywhisker ($2 in chips) 
Seat 5: retyq71 ($2.27 in chips) 
Seat 6: TapeTarko ($4.33 in chips) 
retyq71: posts small blind $0.01
TapeTarko: posts big blind $0.02
visiit has timed out while disconnected
visiit: is sitting out 
*** HOLE CARDS ***
Dealt to lawlex_2 [As 5c]
lawlex_2: raises $0.03 to $0.05
Fella30a: folds 
Jammywhisker: folds 
retyq71: calls $0.04
TapeTarko: calls $0.03
*** FLOP *** [Kd 8d Kh]
retyq71: bets $0.04
TapeTarko: folds 
lawlex_2: folds 
Uncalled bet ($0.04) returned to retyq71
retyq71 collected $0.14 from pot
retyq71: doesn't show hand 
*** SUMMARY ***
Total pot $0.15 | Rake $0.01 
Board [Kd 8d Kh]
Seat 2: lawlex_2 folded on the Flop
Seat 3: Fella30a folded before Flop (didn't bet)
Seat 4: Jammywhisker (button) folded before Flop (didn't bet)
Seat 5: retyq71 (small blind) collected ($0.14)
Seat 6: TapeTarko (big blind) folded on the Flop



PokerStars Hand #213579153755:  Hold'em No Limit ($0.01/$0.02 USD) - 2020/05/09 22:14:47 MSK [2020/05/09 15:14:47 ET]
Table 'Antiphos II' 6-max Seat #5 is the button
Seat 2: lawlex_2 ($1.47 in chips) 
Seat 3: Fella30a ($1.23 in chips) 
Seat 4: Jammywhisker ($2 in chips) 
Seat 5: retyq71 ($2.36 in chips) 
Seat 6: TapeTarko ($4.28 in chips) 
TapeTarko: posts small blind $0.01
lawlex_2: posts big blind $0.02
*** HOLE CARDS ***
Dealt to lawlex_2 [Ks 7s]
Fella30a: calls $0.02
Jammywhisker: raises $0.04 to $0.06
retyq71: folds 
TapeTarko: folds 
lawlex_2: calls $0.04
Fella30a: calls $0.04
*** FLOP *** [Js 7c 9d]
lawlex_2: checks 
Fella30a: checks 
Jammywhisker: bets $0.14
lawlex_2: folds 
Fella30a: folds 
Uncalled bet ($0.14) returned to Jammywhisker
Jammywhisker collected $0.18 from pot
Jammywhisker: doesn't show hand 
*** SUMMARY ***
Total pot $0.19 | Rake $0.01 
Board [Js 7c 9d]
Seat 2: lawlex_2 (big blind) folded on the Flop
Seat 3: Fella30a folded on the Flop
Seat 4: Jammywhisker collected ($0.18)
Seat 5: retyq71 (button) folded before Flop (didn't bet)
Seat 6: TapeTarko (small blind) folded before Flop



PokerStars Hand #213579191394:  Hold'em No Limit ($0.01/$0.02 USD) - 2020/05/09 22:15:19 MSK [2020/05/09 15:15:19 ET]
Table 'Antiphos II' 6-max Seat #6 is the button
Seat 2: lawlex_2 ($1.41 in chips) 
Seat 3: Fella30a ($1.17 in chips) 
Seat 4: Jammywhisker ($2.12 in chips) 
Seat 5: retyq71 ($2.36 in chips) 
Seat 6: TapeTarko ($4.27 in chips) 
lawlex_2: posts small blind $0.01
Fella30a: posts big blind $0.02
*** HOLE CARDS ***
Dealt to lawlex_2 [8c 2c]
Jammywhisker: folds 
retyq71: folds 
TapeTarko: folds 
lawlex_2: folds 
Uncalled bet ($0.01) returned to Fella30a
Fella30a collected $0.02 from pot
Fella30a: doesn't show hand 
*** SUMMARY ***
Total pot $0.02 | Rake $0 
Seat 2: lawlex_2 (small blind) folded before Flop
Seat 3: Fella30a (big blind) collected ($0.02)
Seat 4: Jammywhisker folded before Flop (didn't bet)
Seat 5: retyq71 folded before Flop (didn't bet)
Seat 6: TapeTarko (button) folded before Flop (didn't bet)



PokerStars Hand #213579208462:  Hold'em No Limit ($0.01/$0.02 USD) - 2020/05/09 22:15:34 MSK [2020/05/09 15:15:34 ET]
Table 'Antiphos II' 6-max Seat #2 is the button
Seat 2: lawlex_2 ($1.40 in chips) 
Seat 3: Fella30a ($1.18 in chips) 
Seat 4: Jammywhisker ($2.12 in chips) 
Seat 5: retyq71 ($2.36 in chips) 
Seat 6: TapeTarko ($4.27 in chips) 
Fella30a: posts small blind $0.01
Jammywhisker: posts big blind $0.02
visiit: sits out 
*** HOLE CARDS ***
Dealt to lawlex_2 [Th 6d]
retyq71: folds 
TapeTarko: folds 
lawlex_2: folds 
Fella30a: calls $0.01
Jammywhisker: checks 
*** FLOP *** [2s 4c 9c]
Fella30a: checks 
Jammywhisker: bets $0.02
Fella30a: folds 
Uncalled bet ($0.02) returned to Jammywhisker
Jammywhisker collected $0.04 from pot
Jammywhisker: doesn't show hand 
*** SUMMARY ***
Total pot $0.04 | Rake $0 
Board [2s 4c 9c]
Seat 2: lawlex_2 (button) folded before Flop (didn't bet)
Seat 3: Fella30a (small blind) folded on the Flop
Seat 4: Jammywhisker (big blind) collected ($0.04)
Seat 5: retyq71 folded before Flop (didn't bet)
Seat 6: TapeTarko folded before Flop (didn't bet)



PokerStars Hand #213579240467:  Hold'em No Limit ($0.01/$0.02 USD) - 2020/05/09 22:15:56 MSK [2020/05/09 15:15:56 ET]
Table 'Antiphos II' 6-max Seat #3 is the button
Seat 2: lawlex_2 ($1.40 in chips) 
Seat 3: Fella30a ($1.16 in chips) 
Seat 4: Jammywhisker ($2.14 in chips) 
Seat 5: retyq71 ($2.36 in chips) 
Seat 6: TapeTarko ($4.27 in chips) 
Jammywhisker: posts small blind $0.01
retyq71: posts big blind $0.02
visiit: sits out 
*** HOLE CARDS ***
Dealt to lawlex_2 [4s 6s]
TapeTarko: raises $0.04 to $0.06
lawlex_2: folds 
Fella30a: calls $0.06
Jammywhisker: raises $0.06 to $0.12
retyq71: folds 
TapeTarko: calls $0.06
Fella30a: raises $0.06 to $0.18
Jammywhisker: raises $0.50 to $0.68
TapeTarko: folds 
Fella30a: raises $0.48 to $1.16 and is all-in
Jammywhisker: calls $0.48
*** FLOP *** [9s Tc 7h]
*** TURN *** [9s Tc 7h] [5h]
*** RIVER *** [9s Tc 7h 5h] [4d]
*** SHOW DOWN ***
Jammywhisker: shows [Ah Ac] (a pair of Aces)
Fella30a: shows [Qd Qc] (a pair of Queens)
Jammywhisker collected $2.37 from pot
*** SUMMARY ***
Total pot $2.46 | Rake $0.09 
Board [9s Tc 7h 5h 4d]
Seat 2: lawlex_2 folded before Flop (didn't bet)
Seat 3: Fella30a (button) showed [Qd Qc] and lost with a pair of Queens
Seat 4: Jammywhisker (small blind) showed [Ah Ac] and won ($2.37) with a pair of Aces
Seat 5: retyq71 (big blind) folded before Flop
Seat 6: TapeTarko folded before Flop



PokerStars Hand #213579295901:  Hold'em No Limit ($0.01/$0.02 USD) - 2020/05/09 22:16:44 MSK [2020/05/09 15:16:44 ET]
Table 'Antiphos II' 6-max Seat #4 is the button
Seat 2: lawlex_2 ($1.40 in chips) 
Seat 4: Jammywhisker ($3.35 in chips) 
Seat 5: retyq71 ($2.34 in chips) 
Seat 6: TapeTarko ($4.15 in chips) 
retyq71: posts small blind $0.01
TapeTarko: posts big blind $0.02
visiit: sits out 
*** HOLE CARDS ***
Dealt to lawlex_2 [4s Tc]
lawlex_2: folds 
Jammywhisker said, "XD"
Jammywhisker: folds 
retyq71: calls $0.01
TapeTarko: checks 
*** FLOP *** [Kc 5d 4c]
retyq71: checks 
TapeTarko: bets $0.02
retyq71: folds 
Uncalled bet ($0.02) returned to TapeTarko
TapeTarko collected $0.04 from pot
TapeTarko: doesn't show hand 
*** SUMMARY ***
Total pot $0.04 | Rake $0 
Board [Kc 5d 4c]
Seat 2: lawlex_2 folded before Flop (didn't bet)
Seat 4: Jammywhisker (button) folded before Flop (didn't bet)
Seat 5: retyq71 (small blind) folded on the Flop
Seat 6: TapeTarko (big blind) collected ($0.04)



PokerStars Hand #213579323631:  Hold'em No Limit ($0.01/$0.02 USD) - 2020/05/09 22:17:07 MSK [2020/05/09 15:17:07 ET]
Table 'Antiphos II' 6-max Seat #5 is the button
Seat 1: visiit ($0.80 in chips) 
Seat 2: lawlex_2 ($1.40 in chips) 
Seat 4: Jammywhisker ($3.35 in chips) 
Seat 5: retyq71 ($2.32 in chips) 
Seat 6: TapeTarko ($4.17 in chips) 
TapeTarko: posts small blind $0.01
visiit: posts big blind $0.02
*** HOLE CARDS ***
Dealt to lawlex_2 [9s 5s]
lawlex_2: folds 
Jammywhisker: folds 
retyq71: calls $0.02
TapeTarko: raises $0.04 to $0.06
visiit: calls $0.04
retyq71: calls $0.04
*** FLOP *** [Tc Kd 2d]
TapeTarko: bets $0.06
visiit: folds 
retyq71: calls $0.06
*** TURN *** [Tc Kd 2d] [9d]
TapeTarko: bets $0.10
Fella30a leaves the table
retyq71: raises $0.10 to $0.20
TapeTarko: calls $0.10
*** RIVER *** [Tc Kd 2d 9d] [8d]
kunicina13 joins the table at seat #3 
TapeTarko: checks 
retyq71: checks 
*** SHOW DOWN ***
TapeTarko: shows [Ah Qh] (high card Ace)
retyq71: shows [Ks 2s] (two pair, Kings and Deuces)
retyq71 collected $0.68 from pot
*** SUMMARY ***
Total pot $0.70 | Rake $0.02 
Board [Tc Kd 2d 9d 8d]
Seat 1: visiit (big blind) folded on the Flop
Seat 2: lawlex_2 folded before Flop (didn't bet)
Seat 4: Jammywhisker folded before Flop (didn't bet)
Seat 5: retyq71 (button) showed [Ks 2s] and won ($0.68) with two pair, Kings and Deuces
Seat 6: TapeTarko (small blind) showed [Ah Qh] and lost with high card Ace



PokerStars Hand #213579389210:  Hold'em No Limit ($0.01/$0.02 USD) - 2020/05/09 22:18:03 MSK [2020/05/09 15:18:03 ET]
Table 'Antiphos II' 6-max Seat #6 is the button
Seat 1: visiit ($0.74 in chips) 
Seat 2: lawlex_2 ($1.40 in chips) 
Seat 4: Jammywhisker ($3.35 in chips) 
Seat 5: retyq71 ($2.68 in chips) 
Seat 6: TapeTarko ($3.85 in chips) 
visiit: posts small blind $0.01
lawlex_2: posts big blind $0.02
kunicina13: sits out 
*** HOLE CARDS ***
Dealt to lawlex_2 [7h Ac]
Jammywhisker: folds 
retyq71: calls $0.02
TapeTarko: calls $0.02
visiit: calls $0.01
lawlex_2: raises $0.03 to $0.05
retyq71: calls $0.03
TapeTarko: calls $0.03
visiit: calls $0.03
*** FLOP *** [4c 7s Td]
visiit: bets $0.02
lawlex_2: calls $0.02
retyq71: folds 
TapeTarko: calls $0.02
*** TURN *** [4c 7s Td] [9h]
visiit: bets $0.02
lawlex_2: calls $0.02
TapeTarko: raises $0.10 to $0.12
visiit: folds 
lawlex_2: folds 
Uncalled bet ($0.10) returned to TapeTarko
TapeTarko collected $0.31 from pot
TapeTarko: doesn't show hand 
*** SUMMARY ***
Total pot $0.32 | Rake $0.01 
Board [4c 7s Td 9h]
Seat 1: visiit (small blind) folded on the Turn
Seat 2: lawlex_2 (big blind) folded on the Turn
Seat 4: Jammywhisker folded before Flop (didn't bet)
Seat 5: retyq71 folded on the Flop
Seat 6: TapeTarko (button) collected ($0.31)



PokerStars Hand #213579486968:  Hold'em No Limit ($0.01/$0.02 USD) - 2020/05/09 22:19:27 MSK [2020/05/09 15:19:27 ET]
Table 'Antiphos II' 6-max Seat #1 is the button
Seat 1: visiit ($0.65 in chips) 
Seat 2: lawlex_2 ($1.31 in chips) 
Seat 3: kunicina13 ($2 in chips) 
Seat 4: Jammywhisker ($3.35 in chips) 
Seat 5: retyq71 ($2.63 in chips) 
Seat 6: TapeTarko ($4.07 in chips) 
lawlex_2: posts small blind $0.01
kunicina13: posts big blind $0.02
*** HOLE CARDS ***
Dealt to lawlex_2 [Kc 4c]
Jammywhisker: folds 
retyq71: folds 
TapeTarko: folds 
visiit: raises $0.10 to $0.12
lawlex_2: folds 
kunicina13: folds 
Uncalled bet ($0.10) returned to visiit
visiit collected $0.05 from pot
visiit: doesn't show hand 
*** SUMMARY ***
Total pot $0.05 | Rake $0 
Seat 1: visiit (button) collected ($0.05)
Seat 2: lawlex_2 (small blind) folded before Flop
Seat 3: kunicina13 (big blind) folded before Flop
Seat 4: Jammywhisker folded before Flop (didn't bet)
Seat 5: retyq71 folded before Flop (didn't bet)
Seat 6: TapeTarko folded before Flop (didn't bet)



PokerStars Hand #213579506232:  Hold'em No Limit ($0.01/$0.02 USD) - 2020/05/09 22:19:43 MSK [2020/05/09 15:19:43 ET]
Table 'Antiphos II' 6-max Seat #2 is the button
Seat 1: visiit ($0.68 in chips) 
Seat 2: lawlex_2 ($1.30 in chips) 
Seat 3: kunicina13 ($1.98 in chips) 
Seat 4: Jammywhisker ($3.35 in chips) 
Seat 5: retyq71 ($2.63 in chips) 
Seat 6: TapeTarko ($4.07 in chips) 
kunicina13: posts small blind $0.01
Jammywhisker: posts big blind $0.02
*** HOLE CARDS ***
Dealt to lawlex_2 [Td 7s]
retyq71: folds 
TapeTarko: folds 
visiit: calls $0.02
lawlex_2: folds 
kunicina13: raises $0.02 to $0.04
Jammywhisker: calls $0.02
visiit: calls $0.02
*** FLOP *** [2d 5s 2s]
kunicina13: checks 
Jammywhisker: bets $0.06
visiit: folds 
kunicina13: folds 
Uncalled bet ($0.06) returned to Jammywhisker
Jammywhisker collected $0.12 from pot
Jammywhisker: doesn't show hand 
*** SUMMARY ***
Total pot $0.12 | Rake $0 
Board [2d 5s 2s]
Seat 1: visiit folded on the Flop
Seat 2: lawlex_2 (button) folded before Flop (didn't bet)
Seat 3: kunicina13 (small blind) folded on the Flop
Seat 4: Jammywhisker (big blind) collected ($0.12)
Seat 5: retyq71 folded before Flop (didn't bet)
Seat 6: TapeTarko folded before Flop (didn't bet)



PokerStars Hand #213579561186:  Hold'em No Limit ($0.01/$0.02 USD) - 2020/05/09 22:20:30 MSK [2020/05/09 15:20:30 ET]
Table 'Antiphos II' 6-max Seat #3 is the button
Seat 1: visiit ($0.64 in chips) 
Seat 2: lawlex_2 ($1.30 in chips) 
Seat 3: kunicina13 ($1.94 in chips) 
Seat 4: Jammywhisker ($3.43 in chips) 
Seat 5: retyq71 ($2.63 in chips) 
Seat 6: TapeTarko ($4.07 in chips) 
Jammywhisker: posts small blind $0.01
retyq71: posts big blind $0.02
*** HOLE CARDS ***
Dealt to lawlex_2 [9c 7c]
TapeTarko: folds 
visiit: calls $0.02
lawlex_2: folds 
kunicina13: folds 
Jammywhisker: folds 
retyq71: raises $0.04 to $0.06
visiit: calls $0.04
*** FLOP *** [3h 5d 7d]
retyq71: bets $0.02
visiit: calls $0.02
*** TURN *** [3h 5d 7d] [5c]
retyq71: bets $0.06
visiit: folds 
Uncalled bet ($0.06) returned to retyq71
retyq71 collected $0.16 from pot
retyq71: doesn't show hand 
*** SUMMARY ***
Total pot $0.17 | Rake $0.01 
Board [3h 5d 7d 5c]
Seat 1: visiit folded on the Turn
Seat 2: lawlex_2 folded before Flop (didn't bet)
Seat 3: kunicina13 (button) folded before Flop (didn't bet)
Seat 4: Jammywhisker (small blind) folded before Flop
Seat 5: retyq71 (big blind) collected ($0.16)
Seat 6: TapeTarko folded before Flop (didn't bet)



PokerStars Hand #213579612104:  Hold'em No Limit ($0.01/$0.02 USD) - 2020/05/09 22:21:14 MSK [2020/05/09 15:21:14 ET]
Table 'Antiphos II' 6-max Seat #4 is the button
Seat 1: visiit ($0.56 in chips) 
Seat 2: lawlex_2 ($1.30 in chips) 
Seat 3: kunicina13 ($1.94 in chips) 
Seat 4: Jammywhisker ($3.42 in chips) 
Seat 5: retyq71 ($2.71 in chips) 
Seat 6: TapeTarko ($4.07 in chips) 
retyq71: posts small blind $0.01
TapeTarko: posts big blind $0.02
*** HOLE CARDS ***
Dealt to lawlex_2 [Qs Qc]
visiit: calls $0.02
lawlex_2: calls $0.02
kunicina13: folds 
Jammywhisker: folds 
retyq71: calls $0.01
TapeTarko: checks 
*** FLOP *** [7c 3s 6h]
retyq71: checks 
TapeTarko: bets $0.04
visiit: calls $0.04
lawlex_2: calls $0.04
retyq71: folds 
*** TURN *** [7c 3s 6h] [2h]
TapeTarko: bets $0.10
visiit: calls $0.10
lawlex_2: calls $0.10
*** RIVER *** [7c 3s 6h 2h] [6c]
TapeTarko: bets $0.08
visiit: raises $0.14 to $0.22
lawlex_2: calls $0.22
TapeTarko: folds 
*** SHOW DOWN ***
visiit: shows [5d 6d] (three of a kind, Sixes)
lawlex_2: mucks hand 
visiit collected $0.98 from pot
*** SUMMARY ***
Total pot $1.02 | Rake $0.04 
Board [7c 3s 6h 2h 6c]
Seat 1: visiit showed [5d 6d] and won ($0.98) with three of a kind, Sixes
Seat 2: lawlex_2 mucked [Qs Qc]
Seat 3: kunicina13 folded before Flop (didn't bet)
Seat 4: Jammywhisker (button) folded before Flop (didn't bet)
Seat 5: retyq71 (small blind) folded on the Flop
Seat 6: TapeTarko (big blind) folded on the River



PokerStars Hand #213579675083:  Hold'em No Limit ($0.01/$0.02 USD) - 2020/05/09 22:22:08 MSK [2020/05/09 15:22:08 ET]
Table 'Antiphos II' 6-max Seat #5 is the button
Seat 1: visiit ($1.16 in chips) 
Seat 2: lawlex_2 ($0.92 in chips) 
Seat 3: kunicina13 ($1.94 in chips) 
Seat 4: Jammywhisker ($3.42 in chips) 
Seat 5: retyq71 ($2.69 in chips) 
Seat 6: TapeTarko ($3.83 in chips) 
TapeTarko: posts small blind $0.01
visiit: posts big blind $0.02
*** HOLE CARDS ***
Dealt to lawlex_2 [Jd 4c]
lawlex_2: folds 
kunicina13: folds 
Jammywhisker: folds 
retyq71: folds 
TapeTarko: calls $0.01
visiit: raises $0.02 to $0.04
TapeTarko: calls $0.02
*** FLOP *** [6d 6h 4s]
TapeTarko: checks 
visiit: bets $0.22
TapeTarko: folds 
Uncalled bet ($0.22) returned to visiit
visiit collected $0.08 from pot
visiit: doesn't show hand 
*** SUMMARY ***
Total pot $0.08 | Rake $0 
Board [6d 6h 4s]
Seat 1: visiit (big blind) collected ($0.08)
Seat 2: lawlex_2 folded before Flop (didn't bet)
Seat 3: kunicina13 folded before Flop (didn't bet)
Seat 4: Jammywhisker folded before Flop (didn't bet)
Seat 5: retyq71 (button) folded before Flop (didn't bet)
Seat 6: TapeTarko (small blind) folded on the Flop



PokerStars Hand #213579720264:  Hold'em No Limit ($0.01/$0.02 USD) - 2020/05/09 22:22:38 MSK [2020/05/09 15:22:38 ET]
Table 'Antiphos II' 6-max Seat #6 is the button
Seat 1: visiit ($1.20 in chips) 
Seat 2: lawlex_2 ($0.92 in chips) 
Seat 3: kunicina13 ($1.94 in chips) 
Seat 4: Jammywhisker ($3.42 in chips) 
Seat 5: retyq71 ($2.69 in chips) 
Seat 6: TapeTarko ($3.79 in chips) 
visiit: posts small blind $0.01
lawlex_2: posts big blind $0.02
*** HOLE CARDS ***
Dealt to lawlex_2 [8s Ah]
kunicina13 has timed out
kunicina13: folds 
Jammywhisker: raises $0.04 to $0.06
retyq71: calls $0.06
TapeTarko: folds 
visiit: folds 
lawlex_2: raises $0.19 to $0.25
Jammywhisker: folds 
retyq71: calls $0.19
*** FLOP *** [6d 7c Qd]
lawlex_2: checks 
retyq71: bets $2.44 and is all-in
lawlex_2: calls $0.67 and is all-in
Uncalled bet ($1.77) returned to retyq71
*** TURN *** [6d 7c Qd] [Ks]
*** RIVER *** [6d 7c Qd Ks] [Tc]
*** SHOW DOWN ***
lawlex_2: shows [8s Ah] (high card Ace)
retyq71: shows [2c Ac] (high card Ace - lower kicker)
lawlex_2 collected $1.84 from pot
*** SUMMARY ***
Total pot $1.91 | Rake $0.07 
Board [6d 7c Qd Ks Tc]
Seat 1: visiit (small blind) folded before Flop
Seat 2: lawlex_2 (big blind) showed [8s Ah] and won ($1.84) with high card Ace
Seat 3: kunicina13 folded before Flop (didn't bet)
Seat 4: Jammywhisker folded before Flop
Seat 5: retyq71 showed [2c Ac] and lost with high card Ace
Seat 6: TapeTarko (button) folded before Flop (didn't bet)



PokerStars Hand #213579794446:  Hold'em No Limit ($0.01/$0.02 USD) - 2020/05/09 22:23:42 MSK [2020/05/09 15:23:42 ET]
Table 'Antiphos II' 6-max Seat #1 is the button
Seat 1: visiit ($1.19 in chips) 
Seat 2: lawlex_2 ($1.84 in chips) 
Seat 3: kunicina13 ($1.94 in chips) 
Seat 4: Jammywhisker ($3.36 in chips) 
Seat 5: retyq71 ($1.77 in chips) 
Seat 6: TapeTarko ($3.79 in chips) 
lawlex_2: posts small blind $0.01
kunicina13: posts big blind $0.02
*** HOLE CARDS ***
Dealt to lawlex_2 [2s Jc]
Jammywhisker: folds 
retyq71: raises $0.05 to $0.07
TapeTarko: folds 
visiit: calls $0.07
lawlex_2: folds 
kunicina13: folds 
*** FLOP *** [6s 8s 9h]
retyq71: checks 
visiit: bets $0.02
retyq71: calls $0.02
*** TURN *** [6s 8s 9h] [3s]
retyq71: checks 
visiit: bets $0.10
retyq71: folds 
Uncalled bet ($0.10) returned to visiit
visiit collected $0.20 from pot
visiit: doesn't show hand 
*** SUMMARY ***
Total pot $0.21 | Rake $0.01 
Board [6s 8s 9h 3s]
Seat 1: visiit (button) collected ($0.20)
Seat 2: lawlex_2 (small blind) folded before Flop
Seat 3: kunicina13 (big blind) folded before Flop
Seat 4: Jammywhisker folded before Flop (didn't bet)
Seat 5: retyq71 folded on the Turn
Seat 6: TapeTarko folded before Flop (didn't bet)



PokerStars Hand #213579850022:  Hold'em No Limit ($0.01/$0.02 USD) - 2020/05/09 22:24:29 MSK [2020/05/09 15:24:29 ET]
Table 'Antiphos II' 6-max Seat #2 is the button
Seat 1: visiit ($1.30 in chips) 
Seat 2: lawlex_2 ($1.83 in chips) 
Seat 3: kunicina13 ($1.92 in chips) 
Seat 4: Jammywhisker ($3.36 in chips) 
Seat 5: retyq71 ($1.68 in chips) 
Seat 6: TapeTarko ($3.79 in chips) 
kunicina13: posts small blind $0.01
Jammywhisker: posts big blind $0.02
*** HOLE CARDS ***
Dealt to lawlex_2 [7d 6h]
retyq71: folds 
TapeTarko: folds 
visiit: calls $0.02
lawlex_2: folds 
kunicina13: folds 
Jammywhisker: checks 
*** FLOP *** [Jh 9s 8d]
Jammywhisker: checks 
visiit: checks 
*** TURN *** [Jh 9s 8d] [Qh]
Jammywhisker: checks 
visiit: checks 
*** RIVER *** [Jh 9s 8d Qh] [4s]
Jammywhisker: checks 
visiit: checks 
*** SHOW DOWN ***
Jammywhisker: shows [7s 6c] (high card Queen)
visiit: mucks hand 
Jammywhisker collected $0.05 from pot
*** SUMMARY ***
Total pot $0.05 | Rake $0 
Board [Jh 9s 8d Qh 4s]
Seat 1: visiit mucked [6d 5s]
Seat 2: lawlex_2 (button) folded before Flop (didn't bet)
Seat 3: kunicina13 (small blind) folded before Flop
Seat 4: Jammywhisker (big blind) showed [7s 6c] and won ($0.05) with high card Queen
Seat 5: retyq71 folded before Flop (didn't bet)
Seat 6: TapeTarko folded before Flop (didn't bet)



PokerStars Hand #213579889912:  Hold'em No Limit ($0.01/$0.02 USD) - 2020/05/09 22:25:03 MSK [2020/05/09 15:25:03 ET]
Table 'Antiphos II' 6-max Seat #3 is the button
Seat 1: visiit ($1.28 in chips) 
Seat 2: lawlex_2 ($1.83 in chips) 
Seat 3: kunicina13 ($1.91 in chips) 
Seat 4: Jammywhisker ($3.39 in chips) 
Seat 5: retyq71 ($1.68 in chips) 
Seat 6: TapeTarko ($3.79 in chips) 
Jammywhisker: posts small blind $0.01
retyq71: posts big blind $0.02
*** HOLE CARDS ***
Dealt to lawlex_2 [4h Tc]
TapeTarko: folds 
visiit: calls $0.02
lawlex_2: folds 
kunicina13: folds 
Jammywhisker: folds 
retyq71: checks 
*** FLOP *** [Jh 5h Ad]
retyq71: bets $0.04
visiit: folds 
Uncalled bet ($0.04) returned to retyq71
retyq71 collected $0.05 from pot
retyq71: doesn't show hand 
*** SUMMARY ***
Total pot $0.05 | Rake $0 
Board [Jh 5h Ad]
Seat 1: visiit folded on the Flop
Seat 2: lawlex_2 folded before Flop (didn't bet)
Seat 3: kunicina13 (button) folded before Flop (didn't bet)
Seat 4: Jammywhisker (small blind) folded before Flop
Seat 5: retyq71 (big blind) collected ($0.05)
Seat 6: TapeTarko folded before Flop (didn't bet)



PokerStars Hand #213579940901:  Hold'em No Limit ($0.01/$0.02 USD) - 2020/05/09 22:25:46 MSK [2020/05/09 15:25:46 ET]
Table 'Antiphos II' 6-max Seat #4 is the button
Seat 1: visiit ($1.26 in chips) 
Seat 2: lawlex_2 ($1.83 in chips) 
Seat 3: kunicina13 ($1.91 in chips) 
Seat 4: Jammywhisker ($3.38 in chips) 
Seat 5: retyq71 ($1.71 in chips) 
Seat 6: TapeTarko ($3.79 in chips) 
retyq71: posts small blind $0.01
TapeTarko: posts big blind $0.02
*** HOLE CARDS ***
Dealt to lawlex_2 [3h 4s]
visiit: calls $0.02
lawlex_2: folds 
kunicina13: folds 
Jammywhisker: folds 
retyq71: calls $0.01
TapeTarko: checks 
*** FLOP *** [2s 9h 6h]
retyq71: checks 
TapeTarko: checks 
visiit: checks 
*** TURN *** [2s 9h 6h] [Jd]
retyq71: checks 
TapeTarko: bets $0.02
visiit: folds 
retyq71: folds 
Uncalled bet ($0.02) returned to TapeTarko
TapeTarko collected $0.06 from pot
TapeTarko: doesn't show hand 
*** SUMMARY ***
Total pot $0.06 | Rake $0 
Board [2s 9h 6h Jd]
Seat 1: visiit folded on the Turn
Seat 2: lawlex_2 folded before Flop (didn't bet)
Seat 3: kunicina13 folded before Flop (didn't bet)
Seat 4: Jammywhisker (button) folded before Flop (didn't bet)
Seat 5: retyq71 (small blind) folded on the Turn
Seat 6: TapeTarko (big blind) collected ($0.06)



PokerStars Hand #213580012143:  Hold'em No Limit ($0.01/$0.02 USD) - 2020/05/09 22:26:47 MSK [2020/05/09 15:26:47 ET]
Table 'Antiphos II' 6-max Seat #5 is the button
Seat 1: visiit ($1.24 in chips) 
Seat 2: lawlex_2 ($1.83 in chips) 
Seat 3: kunicina13 ($1.91 in chips) 
Seat 4: Jammywhisker ($3.38 in chips) 
Seat 5: retyq71 ($1.69 in chips) 
Seat 6: TapeTarko ($3.83 in chips) 
TapeTarko: posts small blind $0.01
visiit: posts big blind $0.02
*** HOLE CARDS ***
Dealt to lawlex_2 [8s 9d]
lawlex_2: folds 
kunicina13: folds 
Jammywhisker: folds 
retyq71: raises $0.02 to $0.04
TapeTarko: folds 
visiit: calls $0.02
*** FLOP *** [Qd Td 3c]
visiit: checks 
retyq71: bets $0.04
visiit: folds 
Uncalled bet ($0.04) returned to retyq71
retyq71 collected $0.09 from pot
retyq71: doesn't show hand 
*** SUMMARY ***
Total pot $0.09 | Rake $0 
Board [Qd Td 3c]
Seat 1: visiit (big blind) folded on the Flop
Seat 2: lawlex_2 folded before Flop (didn't bet)
Seat 3: kunicina13 folded before Flop (didn't bet)
Seat 4: Jammywhisker folded before Flop (didn't bet)
Seat 5: retyq71 (button) collected ($0.09)
Seat 6: TapeTarko (small blind) folded before Flop



PokerStars Hand #213580062425:  Hold'em No Limit ($0.01/$0.02 USD) - 2020/05/09 22:27:30 MSK [2020/05/09 15:27:30 ET]
Table 'Antiphos II' 6-max Seat #6 is the button
Seat 1: visiit ($1.20 in chips) 
Seat 2: lawlex_2 ($1.83 in chips) 
Seat 3: kunicina13 ($1.91 in chips) 
Seat 4: Jammywhisker ($3.38 in chips) 
Seat 5: retyq71 ($1.74 in chips) 
Seat 6: TapeTarko ($3.82 in chips) 
visiit: posts small blind $0.01
lawlex_2: posts big blind $0.02
*** HOLE CARDS ***
Dealt to lawlex_2 [8c 8h]
kunicina13: folds 
Jammywhisker has timed out
Jammywhisker: folds 
retyq71: raises $0.04 to $0.06
TapeTarko: folds 
visiit: raises $0.04 to $0.10
lawlex_2: folds 
retyq71: calls $0.04
*** FLOP *** [4c 3c 4d]
visiit: checks 
retyq71: checks 
*** TURN *** [4c 3c 4d] [9s]
visiit: bets $0.10
retyq71: folds 
Uncalled bet ($0.10) returned to visiit
visiit collected $0.21 from pot
visiit: doesn't show hand 
*** SUMMARY ***
Total pot $0.22 | Rake $0.01 
Board [4c 3c 4d 9s]
Seat 1: visiit (small blind) collected ($0.21)
Seat 2: lawlex_2 (big blind) folded before Flop
Seat 3: kunicina13 folded before Flop (didn't bet)
Seat 4: Jammywhisker folded before Flop (didn't bet)
Seat 5: retyq71 folded on the Turn
Seat 6: TapeTarko (button) folded before Flop (didn't bet)



PokerStars Hand #213580125694:  Hold'em No Limit ($0.01/$0.02 USD) - 2020/05/09 22:28:24 MSK [2020/05/09 15:28:24 ET]
Table 'Antiphos II' 6-max Seat #1 is the button
Seat 1: visiit ($1.31 in chips) 
Seat 2: lawlex_2 ($1.81 in chips) 
Seat 3: kunicina13 ($1.91 in chips) 
Seat 4: Jammywhisker ($3.38 in chips) 
Seat 5: retyq71 ($1.64 in chips) 
Seat 6: TapeTarko ($3.82 in chips) 
lawlex_2: posts small blind $0.01
kunicina13: posts big blind $0.02
*** HOLE CARDS ***
Dealt to lawlex_2 [Qc Jh]
Jammywhisker: folds 
retyq71: folds 
TapeTarko: folds 
visiit: calls $0.02
lawlex_2: raises $0.03 to $0.05
kunicina13: folds 
visiit: raises $0.05 to $0.10
lawlex_2: calls $0.05
*** FLOP *** [Kd 2h Ac]
lawlex_2: bets $0.14
visiit: calls $0.14
*** TURN *** [Kd 2h Ac] [6s]
lawlex_2: bets $0.32
visiit: calls $0.32
*** RIVER *** [Kd 2h Ac 6s] [3h]
lawlex_2: checks 
visiit: checks 
*** SHOW DOWN ***
lawlex_2: shows [Qc Jh] (high card Ace)
visiit: shows [Ks Th] (a pair of Kings)
visiit collected $1.10 from pot
*** SUMMARY ***
Total pot $1.14 | Rake $0.04 
Board [Kd 2h Ac 6s 3h]
Seat 1: visiit (button) showed [Ks Th] and won ($1.10) with a pair of Kings
Seat 2: lawlex_2 (small blind) showed [Qc Jh] and lost with high card Ace
Seat 3: kunicina13 (big blind) folded before Flop
Seat 4: Jammywhisker folded before Flop (didn't bet)
Seat 5: retyq71 folded before Flop (didn't bet)
Seat 6: TapeTarko folded before Flop (didn't bet)



PokerStars Hand #213580208845:  Hold'em No Limit ($0.01/$0.02 USD) - 2020/05/09 22:29:35 MSK [2020/05/09 15:29:35 ET]
Table 'Antiphos II' 6-max Seat #2 is the button
Seat 1: visiit ($1.85 in chips) 
Seat 2: lawlex_2 ($1.25 in chips) 
Seat 3: kunicina13 ($1.89 in chips) 
Seat 4: Jammywhisker ($3.38 in chips) 
Seat 5: retyq71 ($1.64 in chips) 
Seat 6: TapeTarko ($3.82 in chips) 
kunicina13: posts small blind $0.01
Jammywhisker: posts big blind $0.02
*** HOLE CARDS ***
Dealt to lawlex_2 [5d 3h]
retyq71: folds 
TapeTarko: folds 
visiit: calls $0.02
lawlex_2: folds 
kunicina13: raises $0.02 to $0.04
Jammywhisker: folds 
visiit: calls $0.02
*** FLOP *** [6h 3d 8d]
kunicina13: checks 
visiit: bets $0.02
kunicina13: calls $0.02
*** TURN *** [6h 3d 8d] [8s]
kunicina13: checks 
visiit: checks 
*** RIVER *** [6h 3d 8d 8s] [Ts]
kunicina13: checks 
visiit: checks 
*** SHOW DOWN ***
kunicina13: shows [7c 5c] (a pair of Eights)
visiit: mucks hand 
kunicina13 collected $0.14 from pot
*** SUMMARY ***
Total pot $0.14 | Rake $0 
Board [6h 3d 8d 8s Ts]
Seat 1: visiit mucked [5h 2d]
Seat 2: lawlex_2 (button) folded before Flop (didn't bet)
Seat 3: kunicina13 (small blind) showed [7c 5c] and won ($0.14) with a pair of Eights
Seat 4: Jammywhisker (big blind) folded before Flop
Seat 5: retyq71 folded before Flop (didn't bet)
Seat 6: TapeTarko folded before Flop (didn't bet)



PokerStars Hand #213580297694:  Hold'em No Limit ($0.01/$0.02 USD) - 2020/05/09 22:30:45 MSK [2020/05/09 15:30:45 ET]
Table 'Antiphos II' 6-max Seat #3 is the button
Seat 1: visiit ($1.79 in chips) 
Seat 2: lawlex_2 ($1.25 in chips) 
Seat 3: kunicina13 ($1.97 in chips) 
Seat 4: Jammywhisker ($3.36 in chips) 
Seat 5: retyq71 ($1.64 in chips) 
Seat 6: TapeTarko ($3.82 in chips) 
Jammywhisker: posts small blind $0.01
retyq71: posts big blind $0.02
*** HOLE CARDS ***
Dealt to lawlex_2 [5d 6s]
TapeTarko: folds 
visiit: calls $0.02
lawlex_2: folds 
kunicina13: folds 
Jammywhisker: raises $0.04 to $0.06
retyq71: folds 
visiit: folds 
Uncalled bet ($0.04) returned to Jammywhisker
Jammywhisker collected $0.06 from pot
Jammywhisker: doesn't show hand 
*** SUMMARY ***
Total pot $0.06 | Rake $0 
Seat 1: visiit folded before Flop
Seat 2: lawlex_2 folded before Flop (didn't bet)
Seat 3: kunicina13 (button) folded before Flop (didn't bet)
Seat 4: Jammywhisker (small blind) collected ($0.06)
Seat 5: retyq71 (big blind) folded before Flop
Seat 6: TapeTarko folded before Flop (didn't bet)



PokerStars Hand #213580327951:  Hold'em No Limit ($0.01/$0.02 USD) - 2020/05/09 22:31:11 MSK [2020/05/09 15:31:11 ET]
Table 'Antiphos II' 6-max Seat #4 is the button
Seat 1: visiit ($1.77 in chips) 
Seat 2: lawlex_2 ($1.25 in chips) 
Seat 3: kunicina13 ($1.97 in chips) 
Seat 4: Jammywhisker ($3.40 in chips) 
Seat 5: retyq71 ($1.62 in chips) 
Seat 6: TapeTarko ($3.82 in chips) 
retyq71: posts small blind $0.01
TapeTarko: posts big blind $0.02
*** HOLE CARDS ***
Dealt to lawlex_2 [Kd 4s]
visiit: calls $0.02
lawlex_2: folds 
kunicina13: folds 
Jammywhisker: raises $0.04 to $0.06
retyq71: calls $0.05
TapeTarko: folds 
visiit: calls $0.04
*** FLOP *** [8d Ah 2h]
retyq71: bets $0.04
visiit: folds 
Jammywhisker: folds 
Uncalled bet ($0.04) returned to retyq71
retyq71 collected $0.19 from pot
retyq71: doesn't show hand 
*** SUMMARY ***
Total pot $0.20 | Rake $0.01 
Board [8d Ah 2h]
Seat 1: visiit folded on the Flop
Seat 2: lawlex_2 folded before Flop (didn't bet)
Seat 3: kunicina13 folded before Flop (didn't bet)
Seat 4: Jammywhisker (button) folded on the Flop
Seat 5: retyq71 (small blind) collected ($0.19)
Seat 6: TapeTarko (big blind) folded before Flop



PokerStars Hand #213580375064:  Hold'em No Limit ($0.01/$0.02 USD) - 2020/05/09 22:31:50 MSK [2020/05/09 15:31:50 ET]
Table 'Antiphos II' 6-max Seat #5 is the button
Seat 1: visiit ($1.71 in chips) 
Seat 2: lawlex_2 ($1.25 in chips) 
Seat 3: kunicina13 ($1.97 in chips) 
Seat 4: Jammywhisker ($3.34 in chips) 
Seat 5: retyq71 ($1.75 in chips) 
Seat 6: TapeTarko ($3.80 in chips) 
TapeTarko: posts small blind $0.01
visiit: posts big blind $0.02
*** HOLE CARDS ***
Dealt to lawlex_2 [5h 2d]
lawlex_2: folds 
kunicina13: raises $0.04 to $0.06
Jammywhisker: folds 
retyq71: folds 
TapeTarko: folds 
visiit: raises $0.04 to $0.10
kunicina13: calls $0.04
*** FLOP *** [5c Kd 7d]
visiit: bets $0.22
kunicina13: folds 
Uncalled bet ($0.22) returned to visiit
visiit collected $0.20 from pot
visiit: doesn't show hand 
*** SUMMARY ***
Total pot $0.21 | Rake $0.01 
Board [5c Kd 7d]
Seat 1: visiit (big blind) collected ($0.20)
Seat 2: lawlex_2 folded before Flop (didn't bet)
Seat 3: kunicina13 folded on the Flop
Seat 4: Jammywhisker folded before Flop (didn't bet)
Seat 5: retyq71 (button) folded before Flop (didn't bet)
Seat 6: TapeTarko (small blind) folded before Flop



PokerStars Hand #213580428316:  Hold'em No Limit ($0.01/$0.02 USD) - 2020/05/09 22:32:35 MSK [2020/05/09 15:32:35 ET]
Table 'Antiphos II' 6-max Seat #6 is the button
Seat 1: visiit ($1.81 in chips) 
Seat 2: lawlex_2 ($1.25 in chips) 
Seat 3: kunicina13 ($1.87 in chips) 
Seat 4: Jammywhisker ($3.34 in chips) 
Seat 5: retyq71 ($1.75 in chips) 
Seat 6: TapeTarko ($3.79 in chips) 
visiit: posts small blind $0.01
lawlex_2: posts big blind $0.02
*** HOLE CARDS ***
Dealt to lawlex_2 [5h Kd]
kunicina13: folds 
Jammywhisker: folds 
retyq71: calls $0.02
TapeTarko: calls $0.02
visiit: raises $0.10 to $0.12
lawlex_2: folds 
retyq71: calls $0.10
TapeTarko: folds 
*** FLOP *** [4d Ah Td]
visiit: bets $0.20
retyq71: raises $0.20 to $0.40
visiit: calls $0.20
*** TURN *** [4d Ah Td] [9d]
visiit: checks 
retyq71: checks 
*** RIVER *** [4d Ah Td 9d] [Qh]
visiit: checks 
retyq71: bets $0.52
visiit: calls $0.52
*** SHOW DOWN ***
retyq71: shows [5d 6d] (a flush, Ten high)
visiit: mucks hand 
retyq71 collected $2.05 from pot
*** SUMMARY ***
Total pot $2.12 | Rake $0.07 
Board [4d Ah Td 9d Qh]
Seat 1: visiit (small blind) mucked [Ac 9c]
Seat 2: lawlex_2 (big blind) folded before Flop
Seat 3: kunicina13 folded before Flop (didn't bet)
Seat 4: Jammywhisker folded before Flop (didn't bet)
Seat 5: retyq71 showed [5d 6d] and won ($2.05) with a flush, Ten high
Seat 6: TapeTarko (button) folded before Flop



PokerStars Hand #213580488101:  Hold'em No Limit ($0.01/$0.02 USD) - 2020/05/09 22:33:26 MSK [2020/05/09 15:33:26 ET]
Table 'Antiphos II' 6-max Seat #1 is the button
Seat 1: visiit ($0.77 in chips) 
Seat 2: lawlex_2 ($1.23 in chips) 
Seat 3: kunicina13 ($1.87 in chips) 
Seat 4: Jammywhisker ($3.34 in chips) 
Seat 5: retyq71 ($2.76 in chips) 
Seat 6: TapeTarko ($3.77 in chips) 
lawlex_2: posts small blind $0.01
kunicina13: posts big blind $0.02
*** HOLE CARDS ***
Dealt to lawlex_2 [Ah As]
Jammywhisker: folds 
retyq71: folds 
TapeTarko: folds 
visiit: calls $0.02
lawlex_2: calls $0.01
kunicina13: raises $0.06 to $0.08
visiit: folds 
lawlex_2: calls $0.06
*** FLOP *** [9s Jc 7h]
lawlex_2: bets $0.11
kunicina13: calls $0.11
*** TURN *** [9s Jc 7h] [3d]
lawlex_2: bets $0.26
kunicina13: folds 
Uncalled bet ($0.26) returned to lawlex_2
lawlex_2 collected $0.39 from pot
lawlex_2: doesn't show hand 
*** SUMMARY ***
Total pot $0.40 | Rake $0.01 
Board [9s Jc 7h 3d]
Seat 1: visiit (button) folded before Flop
Seat 2: lawlex_2 (small blind) collected ($0.39)
Seat 3: kunicina13 (big blind) folded on the Turn
Seat 4: Jammywhisker folded before Flop (didn't bet)
Seat 5: retyq71 folded before Flop (didn't bet)
Seat 6: TapeTarko folded before Flop (didn't bet)



PokerStars Hand #213580554268:  Hold'em No Limit ($0.01/$0.02 USD) - 2020/05/09 22:34:22 MSK [2020/05/09 15:34:22 ET]
Table 'Antiphos II' 6-max Seat #2 is the button
Seat 1: visiit ($0.75 in chips) 
Seat 2: lawlex_2 ($1.43 in chips) 
Seat 3: kunicina13 ($1.68 in chips) 
Seat 4: Jammywhisker ($3.34 in chips) 
Seat 5: retyq71 ($2.76 in chips) 
Seat 6: TapeTarko ($3.77 in chips) 
kunicina13: posts small blind $0.01
Jammywhisker: posts big blind $0.02
*** HOLE CARDS ***
Dealt to lawlex_2 [2h 2d]
retyq71: folds 
TapeTarko: folds 
visiit: calls $0.02
lawlex_2: raises $0.03 to $0.05
kunicina13: folds 
Jammywhisker: folds 
visiit: calls $0.03
*** FLOP *** [4c Js Ts]
visiit: checks 
lawlex_2: checks 
*** TURN *** [4c Js Ts] [Jc]
visiit: checks 
lawlex_2: checks 
*** RIVER *** [4c Js Ts Jc] [Qd]
visiit: checks 
lawlex_2: checks 
*** SHOW DOWN ***
visiit: shows [8s Kc] (a pair of Jacks)
lawlex_2: shows [2h 2d] (two pair, Jacks and Deuces)
lawlex_2 collected $0.13 from pot
*** SUMMARY ***
Total pot $0.13 | Rake $0 
Board [4c Js Ts Jc Qd]
Seat 1: visiit showed [8s Kc] and lost with a pair of Jacks
Seat 2: lawlex_2 (button) showed [2h 2d] and won ($0.13) with two pair, Jacks and Deuces
Seat 3: kunicina13 (small blind) folded before Flop
Seat 4: Jammywhisker (big blind) folded before Flop
Seat 5: retyq71 folded before Flop (didn't bet)
Seat 6: TapeTarko folded before Flop (didn't bet)



PokerStars Hand #213580616998:  Hold'em No Limit ($0.01/$0.02 USD) - 2020/05/09 22:35:07 MSK [2020/05/09 15:35:07 ET]
Table 'Antiphos II' 6-max Seat #3 is the button
Seat 1: visiit ($0.70 in chips) 
Seat 2: lawlex_2 ($1.51 in chips) 
Seat 3: kunicina13 ($1.67 in chips) 
Seat 4: Jammywhisker ($3.32 in chips) 
Seat 5: retyq71 ($2.76 in chips) 
Seat 6: TapeTarko ($3.77 in chips) 
Jammywhisker: posts small blind $0.01
retyq71: posts big blind $0.02
*** HOLE CARDS ***
Dealt to lawlex_2 [Kd Ad]
TapeTarko: folds 
visiit: calls $0.02
lawlex_2: raises $0.03 to $0.05
kunicina13: calls $0.05
Jammywhisker: folds 
retyq71: folds 
visiit: calls $0.03
*** FLOP *** [Kh 5d Jh]
visiit: checks 
lawlex_2: bets $0.11
kunicina13: calls $0.11
visiit: folds 
*** TURN *** [Kh 5d Jh] [7h]
lawlex_2: bets $0.20
TapeTarko leaves the table
kunicina13: raises $0.20 to $0.40
lawlex_2: calls $0.20
*** RIVER *** [Kh 5d Jh 7h] [6s]
lawlex_2: checks 
kunicina13: bets $1.11 and is all-in
Hulk3047 joins the table at seat #6 
lawlex_2: calls $0.95 and is all-in
Uncalled bet ($0.16) returned to kunicina13
*** SHOW DOWN ***
kunicina13: shows [Th Ts] (a pair of Tens)
lawlex_2: shows [Kd Ad] (a pair of Kings)
lawlex_2 collected $2.99 from pot
*** SUMMARY ***
Total pot $3.10 | Rake $0.11 
Board [Kh 5d Jh 7h 6s]
Seat 1: visiit folded on the Flop
Seat 2: lawlex_2 showed [Kd Ad] and won ($2.99) with a pair of Kings
Seat 3: kunicina13 (button) showed [Th Ts] and lost with a pair of Tens
Seat 4: Jammywhisker (small blind) folded before Flop
Seat 5: retyq71 (big blind) folded before Flop
Seat 6: TapeTarko folded before Flop (didn't bet)



PokerStars Hand #213580720475:  Hold'em No Limit ($0.01/$0.02 USD) - 2020/05/09 22:36:33 MSK [2020/05/09 15:36:33 ET]
Table 'Antiphos II' 6-max Seat #4 is the button
Seat 1: visiit ($0.65 in chips) 
Seat 2: lawlex_2 ($2.99 in chips) 
Seat 3: kunicina13 ($0.16 in chips) 
Seat 4: Jammywhisker ($3.31 in chips) 
Seat 5: retyq71 ($2.74 in chips) 
Seat 6: Hulk3047 ($2 in chips) 
retyq71: posts small blind $0.01
Hulk3047: posts big blind $0.02
*** HOLE CARDS ***
Dealt to lawlex_2 [Jd 4s]
visiit: folds 
lawlex_2: folds 
kunicina13: raises $0.14 to $0.16 and is all-in
Jammywhisker: folds 
retyq71: folds 
Hulk3047: folds 
Uncalled bet ($0.14) returned to kunicina13
kunicina13 collected $0.05 from pot
kunicina13: doesn't show hand 
*** SUMMARY ***
Total pot $0.05 | Rake $0 
Seat 1: visiit folded before Flop (didn't bet)
Seat 2: lawlex_2 folded before Flop (didn't bet)
Seat 3: kunicina13 collected ($0.05)
Seat 4: Jammywhisker (button) folded before Flop (didn't bet)
Seat 5: retyq71 (small blind) folded before Flop
Seat 6: Hulk3047 (big blind) folded before Flop



PokerStars Hand #213580743684:  Hold'em No Limit ($0.01/$0.02 USD) - 2020/05/09 22:36:52 MSK [2020/05/09 15:36:52 ET]
Table 'Antiphos II' 6-max Seat #5 is the button
Seat 1: visiit ($0.65 in chips) 
Seat 2: lawlex_2 ($2.99 in chips) 
Seat 3: kunicina13 ($2 in chips) 
Seat 4: Jammywhisker ($3.31 in chips) 
Seat 5: retyq71 ($2.73 in chips) 
Seat 6: Hulk3047 ($2 in chips) 
Hulk3047: posts small blind $0.01
visiit: posts big blind $0.02
*** HOLE CARDS ***
Dealt to lawlex_2 [4c 3d]
lawlex_2: folds 
kunicina13: folds 
Jammywhisker: raises $0.04 to $0.06
retyq71: calls $0.06
Hulk3047: folds 
visiit: calls $0.04
*** FLOP *** [4h Qh Ac]
visiit: checks 
Jammywhisker: bets $0.09
retyq71: folds 
visiit: folds 
Uncalled bet ($0.09) returned to Jammywhisker
Jammywhisker collected $0.18 from pot
Jammywhisker: doesn't show hand 
*** SUMMARY ***
Total pot $0.19 | Rake $0.01 
Board [4h Qh Ac]
Seat 1: visiit (big blind) folded on the Flop
Seat 2: lawlex_2 folded before Flop (didn't bet)
Seat 3: kunicina13 folded before Flop (didn't bet)
Seat 4: Jammywhisker collected ($0.18)
Seat 5: retyq71 (button) folded on the Flop
Seat 6: Hulk3047 (small blind) folded before Flop



PokerStars Hand #213580784836:  Hold'em No Limit ($0.01/$0.02 USD) - 2020/05/09 22:37:27 MSK [2020/05/09 15:37:27 ET]
Table 'Antiphos II' 6-max Seat #6 is the button
Seat 1: visiit ($0.59 in chips) 
Seat 2: lawlex_2 ($2.99 in chips) 
Seat 3: kunicina13 ($2 in chips) 
Seat 4: Jammywhisker ($3.43 in chips) 
Seat 5: retyq71 ($2.67 in chips) 
Seat 6: Hulk3047 ($2 in chips) 
visiit: posts small blind $0.01
lawlex_2: posts big blind $0.02
*** HOLE CARDS ***
Dealt to lawlex_2 [7d 8c]
kunicina13: folds 
Jammywhisker: folds 
retyq71: folds 
Hulk3047: raises $0.04 to $0.06
visiit: calls $0.05
lawlex_2: folds 
*** FLOP *** [3s 4s Qh]
visiit: checks 
Hulk3047: bets $0.07
visiit: calls $0.07
*** TURN *** [3s 4s Qh] [Qs]
visiit: checks 
Hulk3047: checks 
*** RIVER *** [3s 4s Qh Qs] [8s]
visiit: bets $0.22
Hulk3047: calls $0.22
*** SHOW DOWN ***
visiit: shows [6d Qd] (three of a kind, Queens)
Hulk3047: shows [9h 9s] (a flush, Queen high)
Hulk3047 collected $0.69 from pot
*** SUMMARY ***
Total pot $0.72 | Rake $0.03 
Board [3s 4s Qh Qs 8s]
Seat 1: visiit (small blind) showed [6d Qd] and lost with three of a kind, Queens
Seat 2: lawlex_2 (big blind) folded before Flop
Seat 3: kunicina13 folded before Flop (didn't bet)
Seat 4: Jammywhisker folded before Flop (didn't bet)
Seat 5: retyq71 folded before Flop (didn't bet)
Seat 6: Hulk3047 (button) showed [9h 9s] and won ($0.69) with a flush, Queen high



PokerStars Hand #213580844166:  Hold'em No Limit ($0.01/$0.02 USD) - 2020/05/09 22:38:17 MSK [2020/05/09 15:38:17 ET]
Table 'Antiphos II' 6-max Seat #1 is the button
Seat 1: visiit ($0.24 in chips) 
Seat 2: lawlex_2 ($2.97 in chips) 
Seat 3: kunicina13 ($2 in chips) 
Seat 4: Jammywhisker ($3.43 in chips) 
Seat 5: retyq71 ($2.67 in chips) 
Seat 6: Hulk3047 ($2.34 in chips) 
lawlex_2: posts small blind $0.01
kunicina13: posts big blind $0.02
*** HOLE CARDS ***
Dealt to lawlex_2 [Jh 8h]
Jammywhisker: folds 
retyq71: calls $0.02
Hulk3047: folds 
visiit: calls $0.02
lawlex_2: raises $0.03 to $0.05
kunicina13: folds 
retyq71: calls $0.03
visiit: calls $0.03
*** FLOP *** [Qc 7s 2h]
lawlex_2: checks 
retyq71: checks 
visiit: bets $0.02
lawlex_2: folds 
retyq71: folds 
Uncalled bet ($0.02) returned to visiit
visiit collected $0.16 from pot
visiit: doesn't show hand 
*** SUMMARY ***
Total pot $0.17 | Rake $0.01 
Board [Qc 7s 2h]
Seat 1: visiit (button) collected ($0.16)
Seat 2: lawlex_2 (small blind) folded on the Flop
Seat 3: kunicina13 (big blind) folded before Flop
Seat 4: Jammywhisker folded before Flop (didn't bet)
Seat 5: retyq71 folded on the Flop
Seat 6: Hulk3047 folded before Flop (didn't bet)



PokerStars Hand #213580889065:  Hold'em No Limit ($0.01/$0.02 USD) - 2020/05/09 22:38:54 MSK [2020/05/09 15:38:54 ET]
Table 'Antiphos II' 6-max Seat #2 is the button
Seat 1: visiit ($0.35 in chips) 
Seat 2: lawlex_2 ($2.92 in chips) 
Seat 3: kunicina13 ($1.98 in chips) 
Seat 4: Jammywhisker ($3.43 in chips) 
Seat 5: retyq71 ($2.62 in chips) 
Seat 6: Hulk3047 ($2.34 in chips) 
kunicina13: posts small blind $0.01
Jammywhisker: posts big blind $0.02
*** HOLE CARDS ***
Dealt to lawlex_2 [As Qh]
retyq71: raises $0.04 to $0.06
Hulk3047: folds 
visiit: calls $0.06
lawlex_2: calls $0.06
kunicina13: folds 
Jammywhisker: folds 
*** FLOP *** [2d 3s 9c]
retyq71: bets $0.20
visiit: folds 
lawlex_2: folds 
Uncalled bet ($0.20) returned to retyq71
retyq71 collected $0.20 from pot
retyq71: doesn't show hand 
*** SUMMARY ***
Total pot $0.21 | Rake $0.01 
Board [2d 3s 9c]
Seat 1: visiit folded on the Flop
Seat 2: lawlex_2 (button) folded on the Flop
Seat 3: kunicina13 (small blind) folded before Flop
Seat 4: Jammywhisker (big blind) folded before Flop
Seat 5: retyq71 collected ($0.20)
Seat 6: Hulk3047 folded before Flop (didn't bet)



PokerStars Hand #213580920639:  Hold'em No Limit ($0.01/$0.02 USD) - 2020/05/09 22:39:21 MSK [2020/05/09 15:39:21 ET]
Table 'Antiphos II' 6-max Seat #3 is the button
Seat 1: visiit ($0.29 in chips) 
Seat 2: lawlex_2 ($2.86 in chips) 
Seat 3: kunicina13 ($1.97 in chips) 
Seat 4: Jammywhisker ($3.41 in chips) 
Seat 5: retyq71 ($2.76 in chips) 
Seat 6: Hulk3047 ($2.34 in chips) 
Jammywhisker: posts small blind $0.01
retyq71: posts big blind $0.02
*** HOLE CARDS ***
Dealt to lawlex_2 [Ts 7c]
Hulk3047: folds 
visiit: raises $0.08 to $0.10
lawlex_2: folds 
kunicina13: folds 
Jammywhisker: folds 
retyq71: folds 
Uncalled bet ($0.08) returned to visiit
retyq71 leaves the table
visiit collected $0.05 from pot
visiit: doesn't show hand 
*** SUMMARY ***
Total pot $0.05 | Rake $0 
Seat 1: visiit collected ($0.05)
Seat 2: lawlex_2 folded before Flop (didn't bet)
Seat 3: kunicina13 (button) folded before Flop (didn't bet)
Seat 4: Jammywhisker (small blind) folded before Flop
Seat 5: retyq71 (big blind) folded before Flop
Seat 6: Hulk3047 folded before Flop (didn't bet)



PokerStars Hand #213580951059:  Hold'em No Limit ($0.01/$0.02 USD) - 2020/05/09 22:39:46 MSK [2020/05/09 15:39:46 ET]
Table 'Antiphos II' 6-max Seat #4 is the button
Seat 1: visiit ($0.32 in chips) 
Seat 2: lawlex_2 ($2.86 in chips) 
Seat 3: kunicina13 ($1.97 in chips) 
Seat 4: Jammywhisker ($3.40 in chips) 
Seat 6: Hulk3047 ($2.34 in chips) 
Hulk3047: posts small blind $0.01
visiit: posts big blind $0.02
*** HOLE CARDS ***
Dealt to lawlex_2 [4h Ks]
lawlex_2: folds 
kunicina13: folds 
Jammywhisker: raises $0.04 to $0.06
Hulk3047: folds 
visiit: raises $0.04 to $0.10
Jammywhisker: calls $0.04
*** FLOP *** [3c Td 8d]
lolo01337 joins the table at seat #5 
lolo01337 leaves the table
visiit: bets $0.20
nashkoffee joins the table at seat #5 
Jammywhisker: folds 
Uncalled bet ($0.20) returned to visiit
visiit collected $0.20 from pot
visiit: doesn't show hand 
*** SUMMARY ***
Total pot $0.21 | Rake $0.01 
Board [3c Td 8d]
Seat 1: visiit (big blind) collected ($0.20)
Seat 2: lawlex_2 folded before Flop (didn't bet)
Seat 3: kunicina13 folded before Flop (didn't bet)
Seat 4: Jammywhisker (button) folded on the Flop
Seat 6: Hulk3047 (small blind) folded before Flop



PokerStars Hand #213580996064:  Hold'em No Limit ($0.01/$0.02 USD) - 2020/05/09 22:40:23 MSK [2020/05/09 15:40:23 ET]
Table 'Antiphos II' 6-max Seat #6 is the button
Seat 1: visiit ($0.42 in chips) 
Seat 2: lawlex_2 ($2.86 in chips) 
Seat 3: kunicina13 ($1.97 in chips) 
Seat 4: Jammywhisker ($3.30 in chips) 
Seat 6: Hulk3047 ($2.33 in chips) 
visiit: posts small blind $0.01
lawlex_2: posts big blind $0.02
nashkoffee: sits out 
*** HOLE CARDS ***
Dealt to lawlex_2 [9s Ac]
kunicina13: folds 
Jammywhisker: folds 
Hulk3047: folds 
visiit: calls $0.01
lawlex_2: raises $0.03 to $0.05
visiit: calls $0.03
*** FLOP *** [9d As Kd]
visiit: checks 
lawlex_2: checks 
*** TURN *** [9d As Kd] [8d]
visiit: checks 
lawlex_2: bets $0.07
visiit: folds 
Uncalled bet ($0.07) returned to lawlex_2
lawlex_2 collected $0.10 from pot
lawlex_2: doesn't show hand 
*** SUMMARY ***
Total pot $0.10 | Rake $0 
Board [9d As Kd 8d]
Seat 1: visiit (small blind) folded on the Turn
Seat 2: lawlex_2 (big blind) collected ($0.10)
Seat 3: kunicina13 folded before Flop (didn't bet)
Seat 4: Jammywhisker folded before Flop (didn't bet)
Seat 6: Hulk3047 (button) folded before Flop (didn't bet)



PokerStars Hand #213581064715:  Hold'em No Limit ($0.01/$0.02 USD) - 2020/05/09 22:41:21 MSK [2020/05/09 15:41:21 ET]
Table 'Antiphos II' 6-max Seat #1 is the button
Seat 1: visiit ($0.37 in chips) 
Seat 2: lawlex_2 ($2.91 in chips) 
Seat 3: kunicina13 ($1.97 in chips) 
Seat 6: Hulk3047 ($2.33 in chips) 
lawlex_2: posts small blind $0.01
kunicina13: posts big blind $0.02
nashkoffee: sits out 
*** HOLE CARDS ***
Dealt to lawlex_2 [Qh 2d]
Hulk3047: folds 
visiit: folds 
lawlex_2: folds 
Uncalled bet ($0.01) returned to kunicina13
kunicina13 collected $0.02 from pot
kunicina13: doesn't show hand 
*** SUMMARY ***
Total pot $0.02 | Rake $0 
Seat 1: visiit (button) folded before Flop (didn't bet)
Seat 2: lawlex_2 (small blind) folded before Flop
Seat 3: kunicina13 (big blind) collected ($0.02)
Seat 6: Hulk3047 folded before Flop (didn't bet)



PokerStars Hand #213581089879:  Hold'em No Limit ($0.01/$0.02 USD) - 2020/05/09 22:41:42 MSK [2020/05/09 15:41:42 ET]
Table 'Antiphos II' 6-max Seat #2 is the button
Seat 1: visiit ($0.37 in chips) 
Seat 2: lawlex_2 ($2.90 in chips) 
Seat 3: kunicina13 ($1.98 in chips) 
Seat 5: nashkoffee ($2 in chips) 
Seat 6: Hulk3047 ($2.33 in chips) 
kunicina13: posts small blind $0.01
nashkoffee: posts big blind $0.02
*** HOLE CARDS ***
Dealt to lawlex_2 [7c Kc]
Hulk3047: raises $0.04 to $0.06
visiit: raises $0.04 to $0.10
lawlex_2: folds 
kunicina13: folds 
nashkoffee: folds 
Hulk3047: raises $2.23 to $2.33 and is all-in
visiit: calls $0.27 and is all-in
Uncalled bet ($1.96) returned to Hulk3047
*** FLOP *** [Qd 2h Ad]
*** TURN *** [Qd 2h Ad] [Ts]
*** RIVER *** [Qd 2h Ad Ts] [Js]
*** SHOW DOWN ***
Hulk3047: shows [Tc Ac] (two pair, Aces and Tens)
visiit: shows [Qh 9h] (a pair of Queens)
Hulk3047 collected $0.74 from pot
visiit cashed out the hand for $0.28
*** SUMMARY ***
Total pot $0.77 | Rake $0.03 
Board [Qd 2h Ad Ts Js]
Seat 1: visiit showed [Qh 9h] and lost with a pair of Queens (cashed out).
Seat 2: lawlex_2 (button) folded before Flop (didn't bet)
Seat 3: kunicina13 (small blind) folded before Flop
Seat 5: nashkoffee (big blind) folded before Flop
Seat 6: Hulk3047 showed [Tc Ac] and won ($0.74) with two pair, Aces and Tens



PokerStars Hand #213581132613:  Hold'em No Limit ($0.01/$0.02 USD) - 2020/05/09 22:42:18 MSK [2020/05/09 15:42:18 ET]
Table 'Antiphos II' 6-max Seat #3 is the button
Seat 1: visiit ($0.28 in chips) 
Seat 2: lawlex_2 ($2.90 in chips) 
Seat 3: kunicina13 ($1.97 in chips) 
Seat 5: nashkoffee ($1.98 in chips) 
Seat 6: Hulk3047 ($2.70 in chips) 
nashkoffee: posts small blind $0.01
Hulk3047: posts big blind $0.02
*** HOLE CARDS ***
Dealt to lawlex_2 [Qh Ad]
visiit: calls $0.02
lawlex_2: raises $0.03 to $0.05
kunicina13: folds 
nashkoffee: folds 
Hulk3047: folds 
visiit: calls $0.03
*** FLOP *** [4s 7d 2s]
visiit: checks 
lawlex_2: bets $0.09
visiit: folds 
Uncalled bet ($0.09) returned to lawlex_2
lawlex_2 collected $0.13 from pot
lawlex_2: doesn't show hand 
*** SUMMARY ***
Total pot $0.13 | Rake $0 
Board [4s 7d 2s]
Seat 1: visiit folded on the Flop
Seat 2: lawlex_2 collected ($0.13)
Seat 3: kunicina13 (button) folded before Flop (didn't bet)
Seat 5: nashkoffee (small blind) folded before Flop
Seat 6: Hulk3047 (big blind) folded before Flop



PokerStars Hand #213581171834:  Hold'em No Limit ($0.01/$0.02 USD) - 2020/05/09 22:42:51 MSK [2020/05/09 15:42:51 ET]
Table 'Antiphos II' 6-max Seat #5 is the button
Seat 1: visiit ($0.23 in chips) 
Seat 2: lawlex_2 ($2.98 in chips) 
Seat 3: kunicina13 ($1.97 in chips) 
Seat 5: nashkoffee ($1.97 in chips) 
Seat 6: Hulk3047 ($2.68 in chips) 
Hulk3047: posts small blind $0.01
visiit: posts big blind $0.02
*** HOLE CARDS ***
Dealt to lawlex_2 [8s Ad]
lawlex_2: raises $0.03 to $0.05
kunicina13: folds 
nashkoffee: calls $0.05
Hulk3047: folds 
visiit: calls $0.03
*** FLOP *** [9d 9s Tc]
visiit: checks 
lawlex_2: checks 
nashkoffee: bets $0.08
visiit: folds 
lawlex_2: calls $0.08
*** TURN *** [9d 9s Tc] [6c]
lawlex_2: checks 
nashkoffee: bets $0.16
lawlex_2: calls $0.16
*** RIVER *** [9d 9s Tc 6c] [8d]
lawlex_2: checks 
nashkoffee: bets $0.62
lawlex_2: folds 
Uncalled bet ($0.62) returned to nashkoffee
nashkoffee collected $0.62 from pot
nashkoffee: doesn't show hand 
*** SUMMARY ***
Total pot $0.64 | Rake $0.02 
Board [9d 9s Tc 6c 8d]
Seat 1: visiit (big blind) folded on the Flop
Seat 2: lawlex_2 folded on the River
Seat 3: kunicina13 folded before Flop (didn't bet)
Seat 5: nashkoffee (button) collected ($0.62)
Seat 6: Hulk3047 (small blind) folded before Flop



PokerStars Hand #213581248499:  Hold'em No Limit ($0.01/$0.02 USD) - 2020/05/09 22:43:53 MSK [2020/05/09 15:43:53 ET]
Table 'Antiphos II' 6-max Seat #6 is the button
Seat 1: visiit ($0.18 in chips) 
Seat 2: lawlex_2 ($2.69 in chips) 
Seat 3: kunicina13 ($1.97 in chips) 
Seat 5: nashkoffee ($2.30 in chips) 
Seat 6: Hulk3047 ($2.67 in chips) 
visiit: posts small blind $0.01
lawlex_2: posts big blind $0.02
*** HOLE CARDS ***
Dealt to lawlex_2 [9c 9s]
kunicina13: folds 
nashkoffee: raises $0.04 to $0.06
Hulk3047: folds 
visiit: folds 
lawlex_2: calls $0.04
*** FLOP *** [7c Jc Kc]
lawlex_2: bets $0.09
nashkoffee: calls $0.09
*** TURN *** [7c Jc Kc] [Tc]
lawlex_2: bets $0.20
nashkoffee: folds 
Uncalled bet ($0.20) returned to lawlex_2
lawlex_2 collected $0.30 from pot
lawlex_2: doesn't show hand 
*** SUMMARY ***
Total pot $0.31 | Rake $0.01 
Board [7c Jc Kc Tc]
Seat 1: visiit (small blind) folded before Flop
Seat 2: lawlex_2 (big blind) collected ($0.30)
Seat 3: kunicina13 folded before Flop (didn't bet)
Seat 5: nashkoffee folded on the Turn
Seat 6: Hulk3047 (button) folded before Flop (didn't bet)



PokerStars Hand #213581281743:  Hold'em No Limit ($0.01/$0.02 USD) - 2020/05/09 22:44:22 MSK [2020/05/09 15:44:22 ET]
Table 'Antiphos II' 6-max Seat #1 is the button
Seat 1: visiit ($0.17 in chips) 
Seat 2: lawlex_2 ($2.84 in chips) 
Seat 3: kunicina13 ($1.97 in chips) 
Seat 5: nashkoffee ($2.15 in chips) 
Seat 6: Hulk3047 ($2.67 in chips) 
lawlex_2: posts small blind $0.01
kunicina13: posts big blind $0.02
*** HOLE CARDS ***
Dealt to lawlex_2 [Ah 8d]
nashkoffee: folds 
Hulk3047: folds 
visiit: raises $0.08 to $0.10
lawlex_2: folds 
kunicina13: folds 
Uncalled bet ($0.08) returned to visiit
visiit collected $0.05 from pot
*** SUMMARY ***
Total pot $0.05 | Rake $0 
Seat 1: visiit (button) collected ($0.05)
Seat 2: lawlex_2 (small blind) folded before Flop
Seat 3: kunicina13 (big blind) folded before Flop
Seat 5: nashkoffee folded before Flop (didn't bet)
Seat 6: Hulk3047 folded before Flop (didn't bet)



PokerStars Hand #213581298991:  Hold'em No Limit ($0.01/$0.02 USD) - 2020/05/09 22:44:36 MSK [2020/05/09 15:44:36 ET]
Table 'Antiphos II' 6-max Seat #2 is the button
Seat 1: visiit ($0.20 in chips) 
Seat 2: lawlex_2 ($2.83 in chips) 
Seat 3: kunicina13 ($1.95 in chips) 
Seat 5: nashkoffee ($2.15 in chips) 
Seat 6: Hulk3047 ($2.67 in chips) 
kunicina13: posts small blind $0.01
nashkoffee: posts big blind $0.02
*** HOLE CARDS ***
Dealt to lawlex_2 [3s 4d]
Hulk3047: folds 
visiit has timed out
visiit: folds 
lawlex_2: folds 
kunicina13: folds 
Uncalled bet ($0.01) returned to nashkoffee
nashkoffee collected $0.02 from pot
nashkoffee: doesn't show hand 
*** SUMMARY ***
Total pot $0.02 | Rake $0 
Seat 1: visiit folded before Flop (didn't bet)
Seat 2: lawlex_2 (button) folded before Flop (didn't bet)
Seat 3: kunicina13 (small blind) folded before Flop
Seat 5: nashkoffee (big blind) collected ($0.02)
Seat 6: Hulk3047 folded before Flop (didn't bet)



PokerStars Hand #213581332498:  Hold'em No Limit ($0.01/$0.02 USD) - 2020/05/09 22:45:05 MSK [2020/05/09 15:45:05 ET]
Table 'Antiphos II' 6-max Seat #3 is the button
Seat 1: visiit ($0.20 in chips) 
Seat 2: lawlex_2 ($2.83 in chips) 
Seat 3: kunicina13 ($1.94 in chips) 
Seat 5: nashkoffee ($2.16 in chips) 
Seat 6: Hulk3047 ($2.67 in chips) 
nashkoffee: posts small blind $0.01
Hulk3047: posts big blind $0.02
*** HOLE CARDS ***
Dealt to lawlex_2 [4d Th]
visiit: calls $0.02
lawlex_2: folds 
kunicina13: folds 
nashkoffee: folds 
Hulk3047: checks 
*** FLOP *** [8h 5c 9s]
Hulk3047: checks 
visiit: bets $0.02
Hulk3047: folds 
Uncalled bet ($0.02) returned to visiit
visiit collected $0.05 from pot
visiit: doesn't show hand 
*** SUMMARY ***
Total pot $0.05 | Rake $0 
Board [8h 5c 9s]
Seat 1: visiit collected ($0.05)
Seat 2: lawlex_2 folded before Flop (didn't bet)
Seat 3: kunicina13 (button) folded before Flop (didn't bet)
Seat 5: nashkoffee (small blind) folded before Flop
Seat 6: Hulk3047 (big blind) folded on the Flop



PokerStars Hand #213581355017:  Hold'em No Limit ($0.01/$0.02 USD) - 2020/05/09 22:45:24 MSK [2020/05/09 15:45:24 ET]
Table 'Antiphos II' 6-max Seat #5 is the button
Seat 1: visiit ($0.23 in chips) 
Seat 2: lawlex_2 ($2.83 in chips) 
Seat 3: kunicina13 ($1.94 in chips) 
Seat 5: nashkoffee ($2.15 in chips) 
Seat 6: Hulk3047 ($2.65 in chips) 
Hulk3047: posts small blind $0.01
visiit: posts big blind $0.02
Jammywhisker: sits out 
*** HOLE CARDS ***
Dealt to lawlex_2 [4d Ks]
lawlex_2: folds 
kunicina13 is disconnected 
kunicina13 has timed out while being disconnected
kunicina13: folds 
nashkoffee: folds 
Hulk3047: folds 
Uncalled bet ($0.01) returned to visiit
visiit collected $0.02 from pot
visiit: doesn't show hand 
*** SUMMARY ***
Total pot $0.02 | Rake $0 
Seat 1: visiit (big blind) collected ($0.02)
Seat 2: lawlex_2 folded before Flop (didn't bet)
Seat 3: kunicina13 folded before Flop (didn't bet)
Seat 5: nashkoffee (button) folded before Flop (didn't bet)
Seat 6: Hulk3047 (small blind) folded before Flop



PokerStars Hand #213581396112:  Hold'em No Limit ($0.01/$0.02 USD) - 2020/05/09 22:45:56 MSK [2020/05/09 15:45:56 ET]
Table 'Antiphos II' 6-max Seat #6 is the button
Seat 1: visiit ($0.24 in chips) 
Seat 2: lawlex_2 ($2.83 in chips) 
Seat 5: nashkoffee ($2.15 in chips) 
Seat 6: Hulk3047 ($2.64 in chips) 
visiit: posts small blind $0.01
lawlex_2: posts big blind $0.02
Jammywhisker: sits out 
*** HOLE CARDS ***
Dealt to lawlex_2 [3s Js]
nashkoffee: raises $0.04 to $0.06
Hulk3047: folds 
visiit: calls $0.05
lawlex_2: folds 
*** FLOP *** [Jd 4h 7d]
visiit: bets $0.04
nashkoffee: raises $0.22 to $0.26
visiit: calls $0.14 and is all-in
Uncalled bet ($0.08) returned to nashkoffee
*** TURN *** [Jd 4h 7d] [9h]
*** RIVER *** [Jd 4h 7d 9h] [5c]
*** SHOW DOWN ***
visiit: shows [Td Ah] (high card Ace)
nashkoffee: shows [Jh Ks] (a pair of Jacks)
nashkoffee collected $0.48 from pot
*** SUMMARY ***
Total pot $0.50 | Rake $0.02 
Board [Jd 4h 7d 9h 5c]
Seat 1: visiit (small blind) showed [Td Ah] and lost with high card Ace
Seat 2: lawlex_2 (big blind) folded before Flop
Seat 5: nashkoffee showed [Jh Ks] and won ($0.48) with a pair of Jacks
Seat 6: Hulk3047 (button) folded before Flop (didn't bet)



PokerStars Hand #213581447844:  Hold'em No Limit ($0.01/$0.02 USD) - 2020/05/09 22:46:39 MSK [2020/05/09 15:46:39 ET]
Table 'Antiphos II' 6-max Seat #2 is the button
Seat 2: lawlex_2 ($2.81 in chips) 
Seat 3: kunicina13 ($1.94 in chips) 
Seat 4: Jammywhisker ($3.30 in chips) 
Seat 5: nashkoffee ($2.39 in chips) 
Seat 6: Hulk3047 ($2.64 in chips) 
kunicina13: posts small blind $0.01
Jammywhisker: posts big blind $0.02
*** HOLE CARDS ***
Dealt to lawlex_2 [2d 3h]
nashkoffee: raises $0.04 to $0.06
Hulk3047: folds 
lawlex_2: folds 
kunicina13: folds 
Jammywhisker: calls $0.04
*** FLOP *** [4d Jh 2h]
Jammywhisker: bets $0.10
nashkoffee: folds 
Uncalled bet ($0.10) returned to Jammywhisker
Jammywhisker collected $0.13 from pot
Jammywhisker: doesn't show hand 
*** SUMMARY ***
Total pot $0.13 | Rake $0 
Board [4d Jh 2h]
Seat 2: lawlex_2 (button) folded before Flop (didn't bet)
Seat 3: kunicina13 (small blind) folded before Flop
Seat 4: Jammywhisker (big blind) collected ($0.13)
Seat 5: nashkoffee folded on the Flop
Seat 6: Hulk3047 folded before Flop (didn't bet)



PokerStars Hand #213581482901:  Hold'em No Limit ($0.01/$0.02 USD) - 2020/05/09 22:47:09 MSK [2020/05/09 15:47:09 ET]
Table 'Antiphos II' 6-max Seat #3 is the button
Seat 1: visiit ($0.80 in chips) 
Seat 2: lawlex_2 ($2.81 in chips) 
Seat 3: kunicina13 ($1.93 in chips) 
Seat 4: Jammywhisker ($3.37 in chips) 
Seat 5: nashkoffee ($2.33 in chips) 
Seat 6: Hulk3047 ($2.64 in chips) 
Jammywhisker: posts small blind $0.01
nashkoffee: posts big blind $0.02
*** HOLE CARDS ***
Dealt to lawlex_2 [9c 5d]
Hulk3047: raises $0.04 to $0.06
visiit: folds 
lawlex_2: folds 
kunicina13: folds 
Jammywhisker: calls $0.05
nashkoffee: folds 
*** FLOP *** [6h 7s 6c]
Jammywhisker: bets $0.07
Hulk3047: calls $0.07
*** TURN *** [6h 7s 6c] [2s]
Jammywhisker: checks 
Hulk3047: bets $0.08
Jammywhisker: folds 
Uncalled bet ($0.08) returned to Hulk3047
Hulk3047 collected $0.27 from pot
Hulk3047: doesn't show hand 
*** SUMMARY ***
Total pot $0.28 | Rake $0.01 
Board [6h 7s 6c 2s]
Seat 1: visiit folded before Flop (didn't bet)
Seat 2: lawlex_2 folded before Flop (didn't bet)
Seat 3: kunicina13 (button) folded before Flop (didn't bet)
Seat 4: Jammywhisker (small blind) folded on the Turn
Seat 5: nashkoffee (big blind) folded before Flop
Seat 6: Hulk3047 collected ($0.27)



PokerStars Hand #213581561352:  Hold'em No Limit ($0.01/$0.02 USD) - 2020/05/09 22:48:07 MSK [2020/05/09 15:48:07 ET]
Table 'Antiphos II' 6-max Seat #4 is the button
Seat 1: visiit ($0.80 in chips) 
Seat 2: lawlex_2 ($2.81 in chips) 
Seat 3: kunicina13 ($1.93 in chips) 
Seat 4: Jammywhisker ($3.24 in chips) 
Seat 5: nashkoffee ($2.31 in chips) 
Seat 6: Hulk3047 ($2.78 in chips) 
nashkoffee: posts small blind $0.01
Hulk3047: posts big blind $0.02
*** HOLE CARDS ***
Dealt to lawlex_2 [As Ac]
visiit: calls $0.02
lawlex_2: calls $0.02
kunicina13: raises $0.02 to $0.04
Jammywhisker: folds 
nashkoffee: folds 
Hulk3047: folds 
visiit: calls $0.02
lawlex_2: calls $0.02
*** FLOP *** [2s Ks 5d]
visiit: bets $0.12
lawlex_2: calls $0.12
kunicina13: calls $0.12
*** TURN *** [2s Ks 5d] [8c]
visiit: bets $0.20
lawlex_2: calls $0.20
kunicina13: folds 
*** RIVER *** [2s Ks 5d 8c] [8h]
visiit: checks 
lawlex_2: bets $0.44
visiit: calls $0.44 and is all-in
*** SHOW DOWN ***
lawlex_2: shows [As Ac] (two pair, Aces and Eights)
visiit: shows [Kh 8s] (a full house, Eights full of Kings)
visiit collected $1.73 from pot
*** SUMMARY ***
Total pot $1.79 | Rake $0.06 
Board [2s Ks 5d 8c 8h]
Seat 1: visiit showed [Kh 8s] and won ($1.73) with a full house, Eights full of Kings
Seat 2: lawlex_2 showed [As Ac] and lost with two pair, Aces and Eights
Seat 3: kunicina13 folded on the Turn
Seat 4: Jammywhisker (button) folded before Flop (didn't bet)
Seat 5: nashkoffee (small blind) folded before Flop
Seat 6: Hulk3047 (big blind) folded before Flop



PokerStars Hand #213581647303:  Hold'em No Limit ($0.01/$0.02 USD) - 2020/05/09 22:49:19 MSK [2020/05/09 15:49:19 ET]
Table 'Antiphos II' 6-max Seat #5 is the button
Seat 1: visiit ($1.73 in chips) 
Seat 2: lawlex_2 ($2.01 in chips) 
Seat 3: kunicina13 ($1.77 in chips) 
Seat 4: Jammywhisker ($3.24 in chips) 
Seat 5: nashkoffee ($2.30 in chips) 
Seat 6: Hulk3047 ($2.76 in chips) 
Hulk3047: posts small blind $0.01
visiit: posts big blind $0.02
*** HOLE CARDS ***
Dealt to lawlex_2 [2h 4s]
lawlex_2: folds 
Jammywhisker said, "XD"
kunicina13: folds 
Jammywhisker: raises $0.04 to $0.06
nashkoffee: folds 
Hulk3047: folds 
visiit: calls $0.04
*** FLOP *** [Kc 4d Ks]
visiit: bets $0.12
Jammywhisker: folds 
Uncalled bet ($0.12) returned to visiit
visiit collected $0.13 from pot
visiit: doesn't show hand 
*** SUMMARY ***
Total pot $0.13 | Rake $0 
Board [Kc 4d Ks]
Seat 1: visiit (big blind) collected ($0.13)
Seat 2: lawlex_2 folded before Flop (didn't bet)
Seat 3: kunicina13 folded before Flop (didn't bet)
Seat 4: Jammywhisker folded on the Flop
Seat 5: nashkoffee (button) folded before Flop (didn't bet)
Seat 6: Hulk3047 (small blind) folded before Flop



PokerStars Hand #213581683545:  Hold'em No Limit ($0.01/$0.02 USD) - 2020/05/09 22:49:50 MSK [2020/05/09 15:49:50 ET]
Table 'Antiphos II' 6-max Seat #6 is the button
Seat 1: visiit ($1.80 in chips) 
Seat 2: lawlex_2 ($2.01 in chips) 
Seat 3: kunicina13 ($1.77 in chips) 
Seat 4: Jammywhisker ($3.18 in chips) 
Seat 5: nashkoffee ($2.30 in chips) 
Seat 6: Hulk3047 ($2.75 in chips) 
visiit: posts small blind $0.01
lawlex_2: posts big blind $0.02
*** HOLE CARDS ***
Dealt to lawlex_2 [5d 4d]
kunicina13: folds 
Jammywhisker: folds 
nashkoffee: folds 
Hulk3047: folds 
visiit: calls $0.01
lawlex_2: checks 
*** FLOP *** [3c Jh Js]
visiit: checks 
lawlex_2: checks 
*** TURN *** [3c Jh Js] [8c]
visiit: checks 
lawlex_2: checks 
*** RIVER *** [3c Jh Js 8c] [Qh]
visiit: checks 
lawlex_2: checks 
*** SHOW DOWN ***
visiit: shows [5c 8d] (two pair, Jacks and Eights)
lawlex_2: mucks hand 
visiit collected $0.04 from pot
*** SUMMARY ***
Total pot $0.04 | Rake $0 
Board [3c Jh Js 8c Qh]
Seat 1: visiit (small blind) showed [5c 8d] and won ($0.04) with two pair, Jacks and Eights
Seat 2: lawlex_2 (big blind) mucked [5d 4d]
Seat 3: kunicina13 folded before Flop (didn't bet)
Seat 4: Jammywhisker folded before Flop (didn't bet)
Seat 5: nashkoffee folded before Flop (didn't bet)
Seat 6: Hulk3047 (button) folded before Flop (didn't bet)



PokerStars Hand #213581723561:  Hold'em No Limit ($0.01/$0.02 USD) - 2020/05/09 22:50:23 MSK [2020/05/09 15:50:23 ET]
Table 'Antiphos II' 6-max Seat #1 is the button
Seat 1: visiit ($1.82 in chips) 
Seat 2: lawlex_2 ($1.99 in chips) 
Seat 3: kunicina13 ($1.77 in chips) 
Seat 4: Jammywhisker ($3.18 in chips) 
Seat 5: nashkoffee ($2.30 in chips) 
Seat 6: Hulk3047 ($2.75 in chips) 
lawlex_2: posts small blind $0.01
kunicina13: posts big blind $0.02
*** HOLE CARDS ***
Dealt to lawlex_2 [2s Kd]
Jammywhisker: folds 
nashkoffee: folds 
Hulk3047: folds 
visiit: raises $0.08 to $0.10
lawlex_2: folds 
kunicina13: folds 
Uncalled bet ($0.08) returned to visiit
visiit collected $0.05 from pot
visiit: doesn't show hand 
*** SUMMARY ***
Total pot $0.05 | Rake $0 
Seat 1: visiit (button) collected ($0.05)
Seat 2: lawlex_2 (small blind) folded before Flop
Seat 3: kunicina13 (big blind) folded before Flop
Seat 4: Jammywhisker folded before Flop (didn't bet)
Seat 5: nashkoffee folded before Flop (didn't bet)
Seat 6: Hulk3047 folded before Flop (didn't bet)



PokerStars Hand #213581745549:  Hold'em No Limit ($0.01/$0.02 USD) - 2020/05/09 22:50:36 MSK [2020/05/09 15:50:36 ET]
Table 'Antiphos II' 6-max Seat #2 is the button
Seat 1: visiit ($1.85 in chips) 
Seat 2: lawlex_2 ($1.98 in chips) 
Seat 3: kunicina13 ($1.75 in chips) 
Seat 4: Jammywhisker ($3.18 in chips) 
Seat 5: nashkoffee ($2.30 in chips) 
Seat 6: Hulk3047 ($2.75 in chips) 
kunicina13: posts small blind $0.01
Jammywhisker: posts big blind $0.02
*** HOLE CARDS ***
Dealt to lawlex_2 [3d 4d]
nashkoffee: folds 
Hulk3047: raises $0.04 to $0.06
visiit: folds 
lawlex_2: folds 
kunicina13: folds 
Jammywhisker: calls $0.04
*** FLOP *** [8d Qs Jd]
Jammywhisker: checks 
Hulk3047: checks 
*** TURN *** [8d Qs Jd] [Th]
Jammywhisker: bets $0.10
Hulk3047: calls $0.10
*** RIVER *** [8d Qs Jd Th] [6c]
Jammywhisker: bets $0.38
Hulk3047: folds 
Uncalled bet ($0.38) returned to Jammywhisker
Jammywhisker collected $0.32 from pot
Jammywhisker: doesn't show hand 
*** SUMMARY ***
Total pot $0.33 | Rake $0.01 
Board [8d Qs Jd Th 6c]
Seat 1: visiit folded before Flop (didn't bet)
Seat 2: lawlex_2 (button) folded before Flop (didn't bet)
Seat 3: kunicina13 (small blind) folded before Flop
Seat 4: Jammywhisker (big blind) collected ($0.32)
Seat 5: nashkoffee folded before Flop (didn't bet)
Seat 6: Hulk3047 folded on the River



PokerStars Hand #213581828410:  Hold'em No Limit ($0.01/$0.02 USD) - 2020/05/09 22:51:46 MSK [2020/05/09 15:51:46 ET]
Table 'Antiphos II' 6-max Seat #3 is the button
Seat 1: visiit ($1.85 in chips) 
Seat 2: lawlex_2 ($1.98 in chips) 
Seat 3: kunicina13 ($1.74 in chips) 
Seat 4: Jammywhisker ($3.34 in chips) 
Seat 5: nashkoffee ($2.30 in chips) 
Seat 6: Hulk3047 ($2.59 in chips) 
Jammywhisker: posts small blind $0.01
nashkoffee: posts big blind $0.02
*** HOLE CARDS ***
Dealt to lawlex_2 [3s Qc]
Hulk3047: folds 
visiit: raises $0.08 to $0.10
lawlex_2: folds 
kunicina13: folds 
Jammywhisker: folds 
nashkoffee: folds 
Uncalled bet ($0.08) returned to visiit
visiit collected $0.05 from pot
visiit: doesn't show hand 
*** SUMMARY ***
Total pot $0.05 | Rake $0 
Seat 1: visiit collected ($0.05)
Seat 2: lawlex_2 folded before Flop (didn't bet)
Seat 3: kunicina13 (button) folded before Flop (didn't bet)
Seat 4: Jammywhisker (small blind) folded before Flop
Seat 5: nashkoffee (big blind) folded before Flop
Seat 6: Hulk3047 folded before Flop (didn't bet)



PokerStars Hand #213581847530:  Hold'em No Limit ($0.01/$0.02 USD) - 2020/05/09 22:52:03 MSK [2020/05/09 15:52:03 ET]
Table 'Antiphos II' 6-max Seat #4 is the button
Seat 1: visiit ($1.88 in chips) 
Seat 2: lawlex_2 ($1.98 in chips) 
Seat 3: kunicina13 ($1.74 in chips) 
Seat 4: Jammywhisker ($3.33 in chips) 
Seat 5: nashkoffee ($2.28 in chips) 
Seat 6: Hulk3047 ($2.59 in chips) 
nashkoffee: posts small blind $0.01
Hulk3047: posts big blind $0.02
*** HOLE CARDS ***
Dealt to lawlex_2 [Ac 9c]
visiit: folds 
lawlex_2: raises $0.03 to $0.05
kunicina13: calls $0.05
Jammywhisker: folds 
nashkoffee: folds 
Hulk3047: folds 
*** FLOP *** [Ks 3d 7c]
lawlex_2: bets $0.09
kunicina13: folds 
Uncalled bet ($0.09) returned to lawlex_2
lawlex_2 collected $0.13 from pot
lawlex_2: doesn't show hand 
*** SUMMARY ***
Total pot $0.13 | Rake $0 
Board [Ks 3d 7c]
Seat 1: visiit folded before Flop (didn't bet)
Seat 2: lawlex_2 collected ($0.13)
Seat 3: kunicina13 folded on the Flop
Seat 4: Jammywhisker (button) folded before Flop (didn't bet)
Seat 5: nashkoffee (small blind) folded before Flop
Seat 6: Hulk3047 (big blind) folded before Flop



PokerStars Hand #213581883348:  Hold'em No Limit ($0.01/$0.02 USD) - 2020/05/09 22:52:33 MSK [2020/05/09 15:52:33 ET]
Table 'Antiphos II' 6-max Seat #5 is the button
Seat 1: visiit ($1.88 in chips) 
Seat 2: lawlex_2 ($2.06 in chips) 
Seat 3: kunicina13 ($1.69 in chips) 
Seat 4: Jammywhisker ($3.33 in chips) 
Seat 5: nashkoffee ($2.27 in chips) 
Seat 6: Hulk3047 ($2.57 in chips) 
Hulk3047: posts small blind $0.01
visiit: posts big blind $0.02
*** HOLE CARDS ***
Dealt to lawlex_2 [4d 6c]
lawlex_2: folds 
kunicina13: folds 
Jammywhisker: raises $0.04 to $0.06
nashkoffee: folds 
Hulk3047: folds 
visiit: folds 
Uncalled bet ($0.04) returned to Jammywhisker
Jammywhisker collected $0.05 from pot
Jammywhisker: doesn't show hand 
*** SUMMARY ***
Total pot $0.05 | Rake $0 
Seat 1: visiit (big blind) folded before Flop
Seat 2: lawlex_2 folded before Flop (didn't bet)
Seat 3: kunicina13 folded before Flop (didn't bet)
Seat 4: Jammywhisker collected ($0.05)
Seat 5: nashkoffee (button) folded before Flop (didn't bet)
Seat 6: Hulk3047 (small blind) folded before Flop



PokerStars Hand #213581896121:  Hold'em No Limit ($0.01/$0.02 USD) - 2020/05/09 22:52:44 MSK [2020/05/09 15:52:44 ET]
Table 'Antiphos II' 6-max Seat #6 is the button
Seat 1: visiit ($1.86 in chips) 
Seat 2: lawlex_2 ($2.06 in chips) 
Seat 3: kunicina13 ($1.69 in chips) 
Seat 4: Jammywhisker ($3.36 in chips) 
Seat 5: nashkoffee ($2.27 in chips) 
Seat 6: Hulk3047 ($2.56 in chips) 
visiit: posts small blind $0.01
lawlex_2: posts big blind $0.02
*** HOLE CARDS ***
Dealt to lawlex_2 [Tc 9c]
kunicina13: folds 
Jammywhisker: raises $0.04 to $0.06
nashkoffee: folds 
Hulk3047: folds 
visiit: folds 
lawlex_2: folds 
Uncalled bet ($0.04) returned to Jammywhisker
Jammywhisker collected $0.05 from pot
Jammywhisker: doesn't show hand 
*** SUMMARY ***
Total pot $0.05 | Rake $0 
Seat 1: visiit (small blind) folded before Flop
Seat 2: lawlex_2 (big blind) folded before Flop
Seat 3: kunicina13 folded before Flop (didn't bet)
Seat 4: Jammywhisker collected ($0.05)
Seat 5: nashkoffee folded before Flop (didn't bet)
Seat 6: Hulk3047 (button) folded before Flop (didn't bet)



PokerStars Hand #213581923310:  Hold'em No Limit ($0.01/$0.02 USD) - 2020/05/09 22:53:06 MSK [2020/05/09 15:53:06 ET]
Table 'Antiphos II' 6-max Seat #1 is the button
Seat 1: visiit ($1.85 in chips) 
Seat 2: lawlex_2 ($2.04 in chips) 
Seat 3: kunicina13 ($1.69 in chips) 
Seat 4: Jammywhisker ($3.39 in chips) 
Seat 5: nashkoffee ($2.27 in chips) 
Seat 6: Hulk3047 ($2.56 in chips) 
lawlex_2: posts small blind $0.01
kunicina13: posts big blind $0.02
*** HOLE CARDS ***
Dealt to lawlex_2 [4c Kd]
Jammywhisker: folds 
nashkoffee: raises $0.04 to $0.06
Hulk3047: folds 
visiit: calls $0.06
lawlex_2: folds 
kunicina13: folds 
*** FLOP *** [Jd 6c Ks]
nashkoffee: bets $0.06
visiit: calls $0.06
*** TURN *** [Jd 6c Ks] [3c]
nashkoffee: bets $0.12
visiit: calls $0.12
*** RIVER *** [Jd 6c Ks 3c] [Qs]
nashkoffee: checks 
visiit: checks 
*** SHOW DOWN ***
nashkoffee: shows [4h 4d] (a pair of Fours)
visiit: shows [8h Jh] (a pair of Jacks)
visiit collected $0.49 from pot
*** SUMMARY ***
Total pot $0.51 | Rake $0.02 
Board [Jd 6c Ks 3c Qs]
Seat 1: visiit (button) showed [8h Jh] and won ($0.49) with a pair of Jacks
Seat 2: lawlex_2 (small blind) folded before Flop
Seat 3: kunicina13 (big blind) folded before Flop
Seat 4: Jammywhisker folded before Flop (didn't bet)
Seat 5: nashkoffee showed [4h 4d] and lost with a pair of Fours
Seat 6: Hulk3047 folded before Flop (didn't bet)



PokerStars Hand #213581974314:  Hold'em No Limit ($0.01/$0.02 USD) - 2020/05/09 22:53:49 MSK [2020/05/09 15:53:49 ET]
Table 'Antiphos II' 6-max Seat #2 is the button
Seat 1: visiit ($2.10 in chips) 
Seat 2: lawlex_2 ($2.03 in chips) 
Seat 3: kunicina13 ($1.67 in chips) 
Seat 4: Jammywhisker ($3.39 in chips) 
Seat 5: nashkoffee ($2.03 in chips) 
Seat 6: Hulk3047 ($2.56 in chips) 
kunicina13: posts small blind $0.01
Jammywhisker: posts big blind $0.02
*** HOLE CARDS ***
Dealt to lawlex_2 [6s Jh]
nashkoffee: raises $0.04 to $0.06
Hulk3047: folds 
visiit: raises $0.04 to $0.10
lawlex_2: folds 
kunicina13: folds 
Jammywhisker: folds 
nashkoffee: folds 
Uncalled bet ($0.04) returned to visiit
visiit collected $0.15 from pot
*** SUMMARY ***
Total pot $0.15 | Rake $0 
Seat 1: visiit collected ($0.15)
Seat 2: lawlex_2 (button) folded before Flop (didn't bet)
Seat 3: kunicina13 (small blind) folded before Flop
Seat 4: Jammywhisker (big blind) folded before Flop
Seat 5: nashkoffee folded before Flop
Seat 6: Hulk3047 folded before Flop (didn't bet)



PokerStars Hand #213582007503:  Hold'em No Limit ($0.01/$0.02 USD) - 2020/05/09 22:54:17 MSK [2020/05/09 15:54:17 ET]
Table 'Antiphos II' 6-max Seat #3 is the button
Seat 1: visiit ($2.19 in chips) 
Seat 2: lawlex_2 ($2.03 in chips) 
Seat 3: kunicina13 ($1.66 in chips) 
Seat 4: Jammywhisker ($3.37 in chips) 
Seat 5: nashkoffee ($1.97 in chips) 
Seat 6: Hulk3047 ($2.56 in chips) 
Jammywhisker: posts small blind $0.01
nashkoffee: posts big blind $0.02
*** HOLE CARDS ***
Dealt to lawlex_2 [7c 2d]
Hulk3047: folds 
visiit: folds 
lawlex_2: folds 
kunicina13: raises $0.04 to $0.06
Jammywhisker: folds 
nashkoffee: folds 
Uncalled bet ($0.04) returned to kunicina13
kunicina13 collected $0.05 from pot
kunicina13: doesn't show hand 
*** SUMMARY ***
Total pot $0.05 | Rake $0 
Seat 1: visiit folded before Flop (didn't bet)
Seat 2: lawlex_2 folded before Flop (didn't bet)
Seat 3: kunicina13 (button) collected ($0.05)
Seat 4: Jammywhisker (small blind) folded before Flop
Seat 5: nashkoffee (big blind) folded before Flop
Seat 6: Hulk3047 folded before Flop (didn't bet)



PokerStars Hand #213582028271:  Hold'em No Limit ($0.01/$0.02 USD) - 2020/05/09 22:54:35 MSK [2020/05/09 15:54:35 ET]
Table 'Antiphos II' 6-max Seat #4 is the button
Seat 1: visiit ($2.19 in chips) 
Seat 2: lawlex_2 ($2.03 in chips) 
Seat 3: kunicina13 ($1.69 in chips) 
Seat 4: Jammywhisker ($3.36 in chips) 
Seat 5: nashkoffee ($1.95 in chips) 
Seat 6: Hulk3047 ($2.56 in chips) 
nashkoffee: posts small blind $0.01
Hulk3047: posts big blind $0.02
*** HOLE CARDS ***
Dealt to lawlex_2 [As 5c]
visiit: raises $0.08 to $0.10
lawlex_2: folds 
kunicina13: folds 
Jammywhisker: folds 
nashkoffee: folds 
Hulk3047: folds 
Uncalled bet ($0.08) returned to visiit
visiit collected $0.05 from pot
visiit: doesn't show hand 
*** SUMMARY ***
Total pot $0.05 | Rake $0 
Seat 1: visiit collected ($0.05)
Seat 2: lawlex_2 folded before Flop (didn't bet)
Seat 3: kunicina13 folded before Flop (didn't bet)
Seat 4: Jammywhisker (button) folded before Flop (didn't bet)
Seat 5: nashkoffee (small blind) folded before Flop
Seat 6: Hulk3047 (big blind) folded before Flop



PokerStars Hand #213582045035:  Hold'em No Limit ($0.01/$0.02 USD) - 2020/05/09 22:54:49 MSK [2020/05/09 15:54:49 ET]
Table 'Antiphos II' 6-max Seat #5 is the button
Seat 1: visiit ($2.22 in chips) 
Seat 2: lawlex_2 ($2.03 in chips) 
Seat 3: kunicina13 ($1.69 in chips) 
Seat 4: Jammywhisker ($3.36 in chips) 
Seat 5: nashkoffee ($1.94 in chips) 
Seat 6: Hulk3047 ($2.54 in chips) 
Hulk3047: posts small blind $0.01
visiit: posts big blind $0.02
*** HOLE CARDS ***
Dealt to lawlex_2 [5h Jd]
lawlex_2: folds 
kunicina13: raises $0.04 to $0.06
Jammywhisker: folds 
nashkoffee: folds 
Hulk3047: folds 
visiit: raises $0.04 to $0.10
kunicina13: calls $0.04
*** FLOP *** [9s 5d Js]
visiit: checks 
kunicina13: bets $0.10
visiit: calls $0.10
*** TURN *** [9s 5d Js] [7s]
visiit: bets $0.20
kunicina13: raises $0.20 to $0.40
visiit: calls $0.20
*** RIVER *** [9s 5d Js 7s] [Ac]
visiit: checks 
kunicina13: bets $1.09 and is all-in
visiit: folds 
Uncalled bet ($1.09) returned to kunicina13
kunicina13 collected $1.17 from pot
kunicina13: doesn't show hand 
*** SUMMARY ***
Total pot $1.21 | Rake $0.04 
Board [9s 5d Js 7s Ac]
Seat 1: visiit (big blind) folded on the River
Seat 2: lawlex_2 folded before Flop (didn't bet)
Seat 3: kunicina13 collected ($1.17)
Seat 4: Jammywhisker folded before Flop (didn't bet)
Seat 5: nashkoffee (button) folded before Flop (didn't bet)
Seat 6: Hulk3047 (small blind) folded before Flop



PokerStars Hand #213582103011:  Hold'em No Limit ($0.01/$0.02 USD) - 2020/05/09 22:55:51 MSK [2020/05/09 15:55:51 ET]
Table 'Antiphos II' 6-max Seat #6 is the button
Seat 1: visiit ($1.62 in chips) 
Seat 2: lawlex_2 ($2.03 in chips) 
Seat 3: kunicina13 ($2.26 in chips) 
Seat 4: Jammywhisker ($3.36 in chips) 
Seat 5: nashkoffee ($1.94 in chips) 
Seat 6: Hulk3047 ($2.53 in chips) 
visiit: posts small blind $0.01
lawlex_2: posts big blind $0.02
*** HOLE CARDS ***
Dealt to lawlex_2 [Jh 5h]
kunicina13: folds 
Jammywhisker: folds 
nashkoffee: raises $0.04 to $0.06
Hulk3047: folds 
visiit: folds 
lawlex_2: folds 
Uncalled bet ($0.04) returned to nashkoffee
nashkoffee collected $0.05 from pot
nashkoffee: doesn't show hand 
*** SUMMARY ***
Total pot $0.05 | Rake $0 
Seat 1: visiit (small blind) folded before Flop
Seat 2: lawlex_2 (big blind) folded before Flop
Seat 3: kunicina13 folded before Flop (didn't bet)
Seat 4: Jammywhisker folded before Flop (didn't bet)
Seat 5: nashkoffee collected ($0.05)
Seat 6: Hulk3047 (button) folded before Flop (didn't bet)



PokerStars Hand #213582121232:  Hold'em No Limit ($0.01/$0.02 USD) - 2020/05/09 22:56:14 MSK [2020/05/09 15:56:14 ET]
Table 'Antiphos II' 6-max Seat #1 is the button
Seat 1: visiit ($1.61 in chips) 
Seat 2: lawlex_2 ($2.01 in chips) 
Seat 3: kunicina13 ($2.26 in chips) 
Seat 4: Jammywhisker ($3.36 in chips) 
Seat 5: nashkoffee ($1.97 in chips) 
Seat 6: Hulk3047 ($2.53 in chips) 
lawlex_2: posts small blind $0.01
kunicina13: posts big blind $0.02
*** HOLE CARDS ***
Dealt to lawlex_2 [4d 6c]
Jammywhisker: raises $0.04 to $0.06
nashkoffee: folds 
Hulk3047: folds 
visiit: folds 
lawlex_2: folds 
kunicina13: folds 
Uncalled bet ($0.04) returned to Jammywhisker
Jammywhisker collected $0.05 from pot
Jammywhisker: doesn't show hand 
*** SUMMARY ***
Total pot $0.05 | Rake $0 
Seat 1: visiit (button) folded before Flop (didn't bet)
Seat 2: lawlex_2 (small blind) folded before Flop
Seat 3: kunicina13 (big blind) folded before Flop
Seat 4: Jammywhisker collected ($0.05)
Seat 5: nashkoffee folded before Flop (didn't bet)
Seat 6: Hulk3047 folded before Flop (didn't bet)



PokerStars Hand #213582128726:  Hold'em No Limit ($0.01/$0.02 USD) - 2020/05/09 22:56:24 MSK [2020/05/09 15:56:24 ET]
Table 'Antiphos II' 6-max Seat #2 is the button
Seat 1: visiit ($1.61 in chips) 
Seat 2: lawlex_2 ($2 in chips) 
Seat 3: kunicina13 ($2.24 in chips) 
Seat 4: Jammywhisker ($3.39 in chips) 
Seat 5: nashkoffee ($1.97 in chips) 
Seat 6: Hulk3047 ($2.53 in chips) 
kunicina13: posts small blind $0.01
Jammywhisker: posts big blind $0.02
*** HOLE CARDS ***
Dealt to lawlex_2 [4s 4c]
nashkoffee: folds 
Hulk3047: folds 
visiit: folds 
lawlex_2: raises $0.03 to $0.05
kunicina13: folds 
Jammywhisker: calls $0.03
*** FLOP *** [Kh As 7h]
Jammywhisker: bets $0.06
lawlex_2: folds 
Uncalled bet ($0.06) returned to Jammywhisker
Jammywhisker collected $0.11 from pot
Jammywhisker: doesn't show hand 
*** SUMMARY ***
Total pot $0.11 | Rake $0 
Board [Kh As 7h]
Seat 1: visiit folded before Flop (didn't bet)
Seat 2: lawlex_2 (button) folded on the Flop
Seat 3: kunicina13 (small blind) folded before Flop
Seat 4: Jammywhisker (big blind) collected ($0.11)
Seat 5: nashkoffee folded before Flop (didn't bet)
Seat 6: Hulk3047 folded before Flop (didn't bet)



PokerStars Hand #213582151155:  Hold'em No Limit ($0.01/$0.02 USD) - 2020/05/09 22:56:52 MSK [2020/05/09 15:56:52 ET]
Table 'Antiphos II' 6-max Seat #3 is the button
Seat 1: visiit ($1.61 in chips) 
Seat 2: lawlex_2 ($1.95 in chips) 
Seat 3: kunicina13 ($2.23 in chips) 
Seat 4: Jammywhisker ($3.45 in chips) 
Seat 5: nashkoffee ($1.97 in chips) 
Seat 6: Hulk3047 ($2.53 in chips) 
Jammywhisker: posts small blind $0.01
nashkoffee: posts big blind $0.02
*** HOLE CARDS ***
Dealt to lawlex_2 [7c 5c]
Hulk3047: folds 
visiit: calls $0.02
lawlex_2: folds 
kunicina13: calls $0.02
Jammywhisker: calls $0.01
nashkoffee: checks 
*** FLOP *** [Jh Ah 2s]
Jammywhisker: checks 
nashkoffee: bets $0.04
visiit: raises $0.06 to $0.10
kunicina13: calls $0.10
Jammywhisker: folds 
nashkoffee: folds 
*** TURN *** [Jh Ah 2s] [Ac]
visiit: bets $0.20
kunicina13: folds 
Uncalled bet ($0.20) returned to visiit
visiit collected $0.31 from pot
visiit: doesn't show hand 
*** SUMMARY ***
Total pot $0.32 | Rake $0.01 
Board [Jh Ah 2s Ac]
Seat 1: visiit collected ($0.31)
Seat 2: lawlex_2 folded before Flop (didn't bet)
Seat 3: kunicina13 (button) folded on the Turn
Seat 4: Jammywhisker (small blind) folded on the Flop
Seat 5: nashkoffee (big blind) folded on the Flop
Seat 6: Hulk3047 folded before Flop (didn't bet)



PokerStars Hand #213582204732:  Hold'em No Limit ($0.01/$0.02 USD) - 2020/05/09 22:58:00 MSK [2020/05/09 15:58:00 ET]
Table 'Antiphos II' 6-max Seat #4 is the button
Seat 1: visiit ($1.80 in chips) 
Seat 2: lawlex_2 ($1.95 in chips) 
Seat 3: kunicina13 ($2.11 in chips) 
Seat 4: Jammywhisker ($3.43 in chips) 
Seat 5: nashkoffee ($1.91 in chips) 
Seat 6: Hulk3047 ($2.53 in chips) 
nashkoffee: posts small blind $0.01
Hulk3047: posts big blind $0.02
*** HOLE CARDS ***
Dealt to lawlex_2 [9d 2s]
visiit: calls $0.02
lawlex_2: folds 
kunicina13: folds 
Jammywhisker: folds 
nashkoffee: raises $0.04 to $0.06
Hulk3047: folds 
visiit: calls $0.04
*** FLOP *** [Td 4d 5d]
nashkoffee: bets $0.06
visiit: folds 
Uncalled bet ($0.06) returned to nashkoffee
nashkoffee collected $0.14 from pot
nashkoffee: doesn't show hand 
*** SUMMARY ***
Total pot $0.14 | Rake $0 
Board [Td 4d 5d]
Seat 1: visiit folded on the Flop
Seat 2: lawlex_2 folded before Flop (didn't bet)
Seat 3: kunicina13 folded before Flop (didn't bet)
Seat 4: Jammywhisker (button) folded before Flop (didn't bet)
Seat 5: nashkoffee (small blind) collected ($0.14)
Seat 6: Hulk3047 (big blind) folded before Flop



PokerStars Hand #213582231156:  Hold'em No Limit ($0.01/$0.02 USD) - 2020/05/09 22:58:34 MSK [2020/05/09 15:58:34 ET]
Table 'Antiphos II' 6-max Seat #5 is the button
Seat 1: visiit ($1.74 in chips) 
Seat 2: lawlex_2 ($1.95 in chips) 
Seat 3: kunicina13 ($2.11 in chips) 
Seat 4: Jammywhisker ($3.43 in chips) 
Seat 5: nashkoffee ($1.99 in chips) 
Seat 6: Hulk3047 ($2.51 in chips) 
Hulk3047: posts small blind $0.01
visiit: posts big blind $0.02
*** HOLE CARDS ***
Dealt to lawlex_2 [Jc Qd]
lawlex_2: raises $0.03 to $0.05
kunicina13: folds 
Jammywhisker: folds 
nashkoffee: folds 
Hulk3047: folds 
visiit: calls $0.03
*** FLOP *** [Kd 5s 4s]
visiit: bets $0.10
lawlex_2: folds 
Uncalled bet ($0.10) returned to visiit
visiit collected $0.11 from pot
visiit: doesn't show hand 
*** SUMMARY ***
Total pot $0.11 | Rake $0 
Board [Kd 5s 4s]
Seat 1: visiit (big blind) collected ($0.11)
Seat 2: lawlex_2 folded on the Flop
Seat 3: kunicina13 folded before Flop (didn't bet)
Seat 4: Jammywhisker folded before Flop (didn't bet)
Seat 5: nashkoffee (button) folded before Flop (didn't bet)
Seat 6: Hulk3047 (small blind) folded before Flop



PokerStars Hand #213582255406:  Hold'em No Limit ($0.01/$0.02 USD) - 2020/05/09 22:59:04 MSK [2020/05/09 15:59:04 ET]
Table 'Antiphos II' 6-max Seat #6 is the button
Seat 1: visiit ($1.80 in chips) 
Seat 2: lawlex_2 ($1.90 in chips) 
Seat 3: kunicina13 ($2.11 in chips) 
Seat 4: Jammywhisker ($3.43 in chips) 
Seat 5: nashkoffee ($1.99 in chips) 
Seat 6: Hulk3047 ($2.50 in chips) 
visiit: posts small blind $0.01
lawlex_2: posts big blind $0.02
*** HOLE CARDS ***
Dealt to lawlex_2 [3c 9d]
kunicina13: raises $0.02 to $0.04
Jammywhisker: folds 
nashkoffee: folds 
Hulk3047: raises $0.08 to $0.12
visiit: folds 
lawlex_2: folds 
kunicina13: folds 
Uncalled bet ($0.08) returned to Hulk3047
Hulk3047 collected $0.11 from pot
Hulk3047: doesn't show hand 
*** SUMMARY ***
Total pot $0.11 | Rake $0 
Seat 1: visiit (small blind) folded before Flop
Seat 2: lawlex_2 (big blind) folded before Flop
Seat 3: kunicina13 folded before Flop
Seat 4: Jammywhisker folded before Flop (didn't bet)
Seat 5: nashkoffee folded before Flop (didn't bet)
Seat 6: Hulk3047 (button) collected ($0.11)



PokerStars Hand #213582277800:  Hold'em No Limit ($0.01/$0.02 USD) - 2020/05/09 22:59:33 MSK [2020/05/09 15:59:33 ET]
Table 'Antiphos II' 6-max Seat #1 is the button
Seat 1: visiit ($1.79 in chips) 
Seat 2: lawlex_2 ($1.88 in chips) 
Seat 3: kunicina13 ($2.07 in chips) 
Seat 4: Jammywhisker ($3.43 in chips) 
Seat 5: nashkoffee ($1.99 in chips) 
Seat 6: Hulk3047 ($2.57 in chips) 
lawlex_2: posts small blind $0.01
kunicina13: posts big blind $0.02
*** HOLE CARDS ***
Dealt to lawlex_2 [9c Ah]
Jammywhisker: folds 
nashkoffee: folds 
Hulk3047: raises $0.04 to $0.06
visiit: calls $0.06
lawlex_2: calls $0.05
kunicina13: folds 
*** FLOP *** [2d 5s Th]
lawlex_2: checks 
Hulk3047: bets $0.10
visiit: folds 
lawlex_2: folds 
Uncalled bet ($0.10) returned to Hulk3047
Hulk3047 collected $0.19 from pot
Hulk3047: doesn't show hand 
*** SUMMARY ***
Total pot $0.20 | Rake $0.01 
Board [2d 5s Th]
Seat 1: visiit (button) folded on the Flop
Seat 2: lawlex_2 (small blind) folded on the Flop
Seat 3: kunicina13 (big blind) folded before Flop
Seat 4: Jammywhisker folded before Flop (didn't bet)
Seat 5: nashkoffee folded before Flop (didn't bet)
Seat 6: Hulk3047 collected ($0.19)



PokerStars Hand #213582307077:  Hold'em No Limit ($0.01/$0.02 USD) - 2020/05/09 23:00:08 MSK [2020/05/09 16:00:08 ET]
Table 'Antiphos II' 6-max Seat #2 is the button
Seat 1: visiit ($1.73 in chips) 
Seat 2: lawlex_2 ($1.82 in chips) 
Seat 3: kunicina13 ($2.05 in chips) 
Seat 4: Jammywhisker ($3.43 in chips) 
Seat 5: nashkoffee ($1.99 in chips) 
Seat 6: Hulk3047 ($2.70 in chips) 
kunicina13: posts small blind $0.01
Jammywhisker: posts big blind $0.02
*** HOLE CARDS ***
Dealt to lawlex_2 [Tc Kh]
nashkoffee: folds 
Hulk3047: folds 
visiit: calls $0.02
lawlex_2: raises $0.03 to $0.05
kunicina13: folds 
Jammywhisker: folds 
visiit: calls $0.03
*** FLOP *** [Js 9h 9c]
visiit: checks 
lawlex_2: bets $0.09
visiit: calls $0.09
*** TURN *** [Js 9h 9c] [2h]
visiit: checks 
lawlex_2: checks 
*** RIVER *** [Js 9h 9c 2h] [5h]
visiit: bets $0.20
lawlex_2: folds 
Uncalled bet ($0.20) returned to visiit
visiit collected $0.30 from pot
visiit: doesn't show hand 
*** SUMMARY ***
Total pot $0.31 | Rake $0.01 
Board [Js 9h 9c 2h 5h]
Seat 1: visiit collected ($0.30)
Seat 2: lawlex_2 (button) folded on the River
Seat 3: kunicina13 (small blind) folded before Flop
Seat 4: Jammywhisker (big blind) folded before Flop
Seat 5: nashkoffee folded before Flop (didn't bet)
Seat 6: Hulk3047 folded before Flop (didn't bet)



PokerStars Hand #213582368444:  Hold'em No Limit ($0.01/$0.02 USD) - 2020/05/09 23:01:11 MSK [2020/05/09 16:01:11 ET]
Table 'Antiphos II' 6-max Seat #3 is the button
Seat 1: visiit ($1.89 in chips) 
Seat 2: lawlex_2 ($1.68 in chips) 
Seat 3: kunicina13 ($2.04 in chips) 
Seat 4: Jammywhisker ($3.41 in chips) 
Seat 5: nashkoffee ($1.99 in chips) 
Seat 6: Hulk3047 ($2.70 in chips) 
Jammywhisker: posts small blind $0.01
nashkoffee: posts big blind $0.02
*** HOLE CARDS ***
Dealt to lawlex_2 [Kh Ts]
Hulk3047: folds 
visiit: calls $0.02
lawlex_2: raises $0.03 to $0.05
kunicina13: folds 
Jammywhisker: folds 
nashkoffee: folds 
visiit: calls $0.03
*** FLOP *** [9c Js Jd]
visiit: checks 
lawlex_2: bets $0.09
visiit: folds 
Uncalled bet ($0.09) returned to lawlex_2
lawlex_2 collected $0.13 from pot
lawlex_2: doesn't show hand 
*** SUMMARY ***
Total pot $0.13 | Rake $0 
Board [9c Js Jd]
Seat 1: visiit folded on the Flop
Seat 2: lawlex_2 collected ($0.13)
Seat 3: kunicina13 (button) folded before Flop (didn't bet)
Seat 4: Jammywhisker (small blind) folded before Flop
Seat 5: nashkoffee (big blind) folded before Flop
Seat 6: Hulk3047 folded before Flop (didn't bet)



PokerStars Hand #213582395386:  Hold'em No Limit ($0.01/$0.02 USD) - 2020/05/09 23:01:38 MSK [2020/05/09 16:01:38 ET]
Table 'Antiphos II' 6-max Seat #4 is the button
Seat 1: visiit ($1.84 in chips) 
Seat 2: lawlex_2 ($1.76 in chips) 
Seat 3: kunicina13 ($2.04 in chips) 
Seat 4: Jammywhisker ($3.40 in chips) 
Seat 5: nashkoffee ($1.97 in chips) 
Seat 6: Hulk3047 ($2.70 in chips) 
nashkoffee: posts small blind $0.01
Hulk3047: posts big blind $0.02
*** HOLE CARDS ***
Dealt to lawlex_2 [Th Ks]
visiit: calls $0.02
lawlex_2: raises $0.03 to $0.05
kunicina13: calls $0.05
Jammywhisker: folds 
nashkoffee: folds 
Hulk3047: folds 
visiit: calls $0.03
*** FLOP *** [6s Ts 9c]
visiit: checks 
lawlex_2: bets $0.11
kunicina13: calls $0.11
visiit: folds 
*** TURN *** [6s Ts 9c] [Kd]
lawlex_2: checks 
kunicina13: checks 
*** RIVER *** [6s Ts 9c Kd] [Qc]
lawlex_2: bets $0.26
kunicina13: folds 
Uncalled bet ($0.26) returned to lawlex_2
lawlex_2 collected $0.39 from pot
lawlex_2: doesn't show hand 
*** SUMMARY ***
Total pot $0.40 | Rake $0.01 
Board [6s Ts 9c Kd Qc]
Seat 1: visiit folded on the Flop
Seat 2: lawlex_2 collected ($0.39)
Seat 3: kunicina13 folded on the River
Seat 4: Jammywhisker (button) folded before Flop (didn't bet)
Seat 5: nashkoffee (small blind) folded before Flop
Seat 6: Hulk3047 (big blind) folded before Flop



PokerStars Hand #213582490612:  Hold'em No Limit ($0.01/$0.02 USD) - 2020/05/09 23:03:05 MSK [2020/05/09 16:03:05 ET]
Table 'Antiphos II' 6-max Seat #5 is the button
Seat 1: visiit ($1.79 in chips) 
Seat 2: lawlex_2 ($1.99 in chips) 
Seat 3: kunicina13 ($1.88 in chips) 
Seat 4: Jammywhisker ($3.40 in chips) 
Seat 5: nashkoffee ($1.96 in chips) 
Seat 6: Hulk3047 ($2.68 in chips) 
Hulk3047: posts small blind $0.01
visiit: posts big blind $0.02
*** HOLE CARDS ***
Dealt to lawlex_2 [8s 6c]
lawlex_2: folds 
kunicina13: folds 
Jammywhisker: folds 
nashkoffee: folds 
Hulk3047: folds 
Uncalled bet ($0.01) returned to visiit
visiit collected $0.02 from pot
visiit: doesn't show hand 
*** SUMMARY ***
Total pot $0.02 | Rake $0 
Seat 1: visiit (big blind) collected ($0.02)
Seat 2: lawlex_2 folded before Flop (didn't bet)
Seat 3: kunicina13 folded before Flop (didn't bet)
Seat 4: Jammywhisker folded before Flop (didn't bet)
Seat 5: nashkoffee (button) folded before Flop (didn't bet)
Seat 6: Hulk3047 (small blind) folded before Flop



PokerStars Hand #213582522878:  Hold'em No Limit ($0.01/$0.02 USD) - 2020/05/09 23:03:31 MSK [2020/05/09 16:03:31 ET]
Table 'Antiphos II' 6-max Seat #6 is the button
Seat 1: visiit ($1.80 in chips) 
Seat 2: lawlex_2 ($1.99 in chips) 
Seat 3: kunicina13 ($1.88 in chips) 
Seat 4: Jammywhisker ($3.40 in chips) 
Seat 5: nashkoffee ($1.96 in chips) 
Seat 6: Hulk3047 ($2.67 in chips) 
visiit: posts small blind $0.01
lawlex_2: posts big blind $0.02
*** HOLE CARDS ***
Dealt to lawlex_2 [Qs Th]
kunicina13: folds 
Jammywhisker: raises $0.04 to $0.06
nashkoffee: folds 
Hulk3047: folds 
visiit: folds 
lawlex_2: folds 
Uncalled bet ($0.04) returned to Jammywhisker
Jammywhisker collected $0.05 from pot
Jammywhisker: doesn't show hand 
*** SUMMARY ***
Total pot $0.05 | Rake $0 
Seat 1: visiit (small blind) folded before Flop
Seat 2: lawlex_2 (big blind) folded before Flop
Seat 3: kunicina13 folded before Flop (didn't bet)
Seat 4: Jammywhisker collected ($0.05)
Seat 5: nashkoffee folded before Flop (didn't bet)
Seat 6: Hulk3047 (button) folded before Flop (didn't bet)



PokerStars Hand #213582553921:  Hold'em No Limit ($0.01/$0.02 USD) - 2020/05/09 23:03:57 MSK [2020/05/09 16:03:57 ET]
Table 'Antiphos II' 6-max Seat #1 is the button
Seat 1: visiit ($1.79 in chips) 
Seat 2: lawlex_2 ($1.97 in chips) 
Seat 3: kunicina13 ($1.88 in chips) 
Seat 4: Jammywhisker ($3.43 in chips) 
Seat 5: nashkoffee ($1.96 in chips) 
Seat 6: Hulk3047 ($2.67 in chips) 
lawlex_2: posts small blind $0.01
kunicina13: posts big blind $0.02
*** HOLE CARDS ***
Dealt to lawlex_2 [Ac Jh]
Jammywhisker: folds 
nashkoffee: raises $0.04 to $0.06
Hulk3047: folds 
visiit: calls $0.06
lawlex_2: calls $0.05
kunicina13: calls $0.04
*** FLOP *** [Qh Th 4d]
lawlex_2: bets $0.15
kunicina13: folds 
nashkoffee: folds 
visiit: folds 
Uncalled bet ($0.15) returned to lawlex_2
lawlex_2 collected $0.23 from pot
lawlex_2: doesn't show hand 
*** SUMMARY ***
Total pot $0.24 | Rake $0.01 
Board [Qh Th 4d]
Seat 1: visiit (button) folded on the Flop
Seat 2: lawlex_2 (small blind) collected ($0.23)
Seat 3: kunicina13 (big blind) folded on the Flop
Seat 4: Jammywhisker folded before Flop (didn't bet)
Seat 5: nashkoffee folded on the Flop
Seat 6: Hulk3047 folded before Flop (didn't bet)



PokerStars Hand #213582589828:  Hold'em No Limit ($0.01/$0.02 USD) - 2020/05/09 23:04:28 MSK [2020/05/09 16:04:28 ET]
Table 'Antiphos II' 6-max Seat #2 is the button
Seat 1: visiit ($1.73 in chips) 
Seat 2: lawlex_2 ($2.14 in chips) 
Seat 3: kunicina13 ($1.82 in chips) 
Seat 4: Jammywhisker ($3.43 in chips) 
Seat 5: nashkoffee ($1.90 in chips) 
Seat 6: Hulk3047 ($2.67 in chips) 
kunicina13: posts small blind $0.01
Jammywhisker: posts big blind $0.02
*** HOLE CARDS ***
Dealt to lawlex_2 [6d 4s]
nashkoffee: folds 
Hulk3047: folds 
visiit: calls $0.02
lawlex_2: folds 
kunicina13: folds 
Jammywhisker: raises $0.04 to $0.06
visiit: calls $0.04
*** FLOP *** [8d 9d As]
Jammywhisker: bets $0.10
visiit: folds 
Uncalled bet ($0.10) returned to Jammywhisker
Jammywhisker collected $0.13 from pot
Jammywhisker: doesn't show hand 
*** SUMMARY ***
Total pot $0.13 | Rake $0 
Board [8d 9d As]
Seat 1: visiit folded on the Flop
Seat 2: lawlex_2 (button) folded before Flop (didn't bet)
Seat 3: kunicina13 (small blind) folded before Flop
Seat 4: Jammywhisker (big blind) collected ($0.13)
Seat 5: nashkoffee folded before Flop (didn't bet)
Seat 6: Hulk3047 folded before Flop (didn't bet)



PokerStars Hand #213582626616:  Hold'em No Limit ($0.01/$0.02 USD) - 2020/05/09 23:04:59 MSK [2020/05/09 16:04:59 ET]
Table 'Antiphos II' 6-max Seat #3 is the button
Seat 1: visiit ($1.67 in chips) 
Seat 2: lawlex_2 ($2.14 in chips) 
Seat 3: kunicina13 ($1.81 in chips) 
Seat 4: Jammywhisker ($3.50 in chips) 
Seat 5: nashkoffee ($1.90 in chips) 
Seat 6: Hulk3047 ($2.67 in chips) 
Jammywhisker: posts small blind $0.01
nashkoffee: posts big blind $0.02
*** HOLE CARDS ***
Dealt to lawlex_2 [Qc Kd]
Hulk3047: folds 
visiit: raises $0.08 to $0.10
lawlex_2: folds 
kunicina13: folds 
Jammywhisker: folds 
nashkoffee: folds 
Uncalled bet ($0.08) returned to visiit
visiit collected $0.05 from pot
visiit: doesn't show hand 
*** SUMMARY ***
Total pot $0.05 | Rake $0 
Seat 1: visiit collected ($0.05)
Seat 2: lawlex_2 folded before Flop (didn't bet)
Seat 3: kunicina13 (button) folded before Flop (didn't bet)
Seat 4: Jammywhisker (small blind) folded before Flop
Seat 5: nashkoffee (big blind) folded before Flop
Seat 6: Hulk3047 folded before Flop (didn't bet)



PokerStars Hand #213582659025:  Hold'em No Limit ($0.01/$0.02 USD) - 2020/05/09 23:05:25 MSK [2020/05/09 16:05:25 ET]
Table 'Antiphos II' 6-max Seat #4 is the button
Seat 1: visiit ($1.70 in chips) 
Seat 2: lawlex_2 ($2.14 in chips) 
Seat 3: kunicina13 ($1.81 in chips) 
Seat 4: Jammywhisker ($3.49 in chips) 
Seat 5: nashkoffee ($1.88 in chips) 
Seat 6: Hulk3047 ($2.67 in chips) 
nashkoffee: posts small blind $0.01
Hulk3047: posts big blind $0.02
*** HOLE CARDS ***
Dealt to lawlex_2 [Jc Qh]
visiit: raises $0.08 to $0.10
lawlex_2: folds 
kunicina13: calls $0.10
Jammywhisker: folds 
nashkoffee: folds 
Hulk3047: folds 
*** FLOP *** [9h 6h 7d]
visiit: checks 
kunicina13: checks 
*** TURN *** [9h 6h 7d] [4s]
visiit: checks 
kunicina13: bets $0.10
visiit: calls $0.10
*** RIVER *** [9h 6h 7d 4s] [2h]
visiit: checks 
kunicina13: checks 
*** SHOW DOWN ***
visiit: shows [As Qs] (high card Ace)
kunicina13: shows [8c 8h] (a pair of Eights)
kunicina13 collected $0.41 from pot
*** SUMMARY ***
Total pot $0.43 | Rake $0.02 
Board [9h 6h 7d 4s 2h]
Seat 1: visiit showed [As Qs] and lost with high card Ace
Seat 2: lawlex_2 folded before Flop (didn't bet)
Seat 3: kunicina13 showed [8c 8h] and won ($0.41) with a pair of Eights
Seat 4: Jammywhisker (button) folded before Flop (didn't bet)
Seat 5: nashkoffee (small blind) folded before Flop
Seat 6: Hulk3047 (big blind) folded before Flop



PokerStars Hand #213582714544:  Hold'em No Limit ($0.01/$0.02 USD) - 2020/05/09 23:06:06 MSK [2020/05/09 16:06:06 ET]
Table 'Antiphos II' 6-max Seat #5 is the button
Seat 1: visiit ($1.50 in chips) 
Seat 2: lawlex_2 ($2.14 in chips) 
Seat 3: kunicina13 ($2.02 in chips) 
Seat 4: Jammywhisker ($3.49 in chips) 
Seat 5: nashkoffee ($1.87 in chips) 
Seat 6: Hulk3047 ($2.65 in chips) 
Hulk3047: posts small blind $0.01
visiit: posts big blind $0.02
*** HOLE CARDS ***
Dealt to lawlex_2 [Qh 3h]
lawlex_2: folds 
kunicina13: folds 
Jammywhisker: folds 
nashkoffee has timed out
nashkoffee: folds 
Hulk3047: folds 
Uncalled bet ($0.01) returned to visiit
visiit collected $0.02 from pot
visiit: doesn't show hand 
*** SUMMARY ***
Total pot $0.02 | Rake $0 
Seat 1: visiit (big blind) collected ($0.02)
Seat 2: lawlex_2 folded before Flop (didn't bet)
Seat 3: kunicina13 folded before Flop (didn't bet)
Seat 4: Jammywhisker folded before Flop (didn't bet)
Seat 5: nashkoffee (button) folded before Flop (didn't bet)
Seat 6: Hulk3047 (small blind) folded before Flop



PokerStars Hand #213582750547:  Hold'em No Limit ($0.01/$0.02 USD) - 2020/05/09 23:06:30 MSK [2020/05/09 16:06:30 ET]
Table 'Antiphos II' 6-max Seat #6 is the button
Seat 1: visiit ($1.51 in chips) 
Seat 2: lawlex_2 ($2.14 in chips) 
Seat 3: kunicina13 ($2.02 in chips) 
Seat 4: Jammywhisker ($3.49 in chips) 
Seat 6: Hulk3047 ($2.64 in chips) 
visiit: posts small blind $0.01
lawlex_2: posts big blind $0.02
*** HOLE CARDS ***
Dealt to lawlex_2 [5d 8d]
kunicina13: folds 
Jammywhisker: raises $0.04 to $0.06
Hulk3047: folds 
visiit: folds 
lawlex_2: folds 
Uncalled bet ($0.04) returned to Jammywhisker
Jammywhisker collected $0.05 from pot
Jammywhisker: doesn't show hand 
*** SUMMARY ***
Total pot $0.05 | Rake $0 
Seat 1: visiit (small blind) folded before Flop
Seat 2: lawlex_2 (big blind) folded before Flop
Seat 3: kunicina13 folded before Flop (didn't bet)
Seat 4: Jammywhisker collected ($0.05)
Seat 6: Hulk3047 (button) folded before Flop (didn't bet)



PokerStars Hand #213582777802:  Hold'em No Limit ($0.01/$0.02 USD) - 2020/05/09 23:06:53 MSK [2020/05/09 16:06:53 ET]
Table 'Antiphos II' 6-max Seat #1 is the button
Seat 1: visiit ($1.50 in chips) 
Seat 2: lawlex_2 ($2.12 in chips) 
Seat 3: kunicina13 ($2.02 in chips) 
Seat 4: Jammywhisker ($3.52 in chips) 
Seat 6: Hulk3047 ($2.64 in chips) 
lawlex_2: posts small blind $0.01
kunicina13: posts big blind $0.02
*** HOLE CARDS ***
Dealt to lawlex_2 [7d 4h]
Jammywhisker: folds 
Hulk3047: folds 
visiit: calls $0.02
lawlex_2: folds 
kunicina13: checks 
*** FLOP *** [3c 5c Ah]
kunicina13: checks 
visiit: checks 
*** TURN *** [3c 5c Ah] [Qs]
kunicina13: checks 
visiit: checks 
*** RIVER *** [3c 5c Ah Qs] [6h]
kunicina13: checks 
visiit: checks 
*** SHOW DOWN ***
kunicina13: shows [2c Qh] (a pair of Queens)
visiit: mucks hand 
kunicina13 collected $0.05 from pot
*** SUMMARY ***
Total pot $0.05 | Rake $0 
Board [3c 5c Ah Qs 6h]
Seat 1: visiit (button) mucked [8s 9d]
Seat 2: lawlex_2 (small blind) folded before Flop
Seat 3: kunicina13 (big blind) showed [2c Qh] and won ($0.05) with a pair of Queens
Seat 4: Jammywhisker folded before Flop (didn't bet)
Seat 6: Hulk3047 folded before Flop (didn't bet)



PokerStars Hand #213582833744:  Hold'em No Limit ($0.01/$0.02 USD) - 2020/05/09 23:07:39 MSK [2020/05/09 16:07:39 ET]
Table 'Antiphos II' 6-max Seat #2 is the button
Seat 1: visiit ($1.48 in chips) 
Seat 2: lawlex_2 ($2.11 in chips) 
Seat 3: kunicina13 ($2.05 in chips) 
Seat 4: Jammywhisker ($3.52 in chips) 
Seat 5: nashkoffee ($1.87 in chips) 
Seat 6: Hulk3047 ($2.64 in chips) 
kunicina13: posts small blind $0.01
Jammywhisker: posts big blind $0.02
*** HOLE CARDS ***
Dealt to lawlex_2 [Kc 7s]
nashkoffee: raises $0.04 to $0.06
Hulk3047: folds 
visiit: folds 
lawlex_2: folds 
kunicina13: folds 
Jammywhisker: folds 
Uncalled bet ($0.04) returned to nashkoffee
nashkoffee collected $0.05 from pot
nashkoffee: doesn't show hand 
*** SUMMARY ***
Total pot $0.05 | Rake $0 
Seat 1: visiit folded before Flop (didn't bet)
Seat 2: lawlex_2 (button) folded before Flop (didn't bet)
Seat 3: kunicina13 (small blind) folded before Flop
Seat 4: Jammywhisker (big blind) folded before Flop
Seat 5: nashkoffee collected ($0.05)
Seat 6: Hulk3047 folded before Flop (didn't bet)



PokerStars Hand #213582853919:  Hold'em No Limit ($0.01/$0.02 USD) - 2020/05/09 23:07:56 MSK [2020/05/09 16:07:56 ET]
Table 'Antiphos II' 6-max Seat #3 is the button
Seat 1: visiit ($1.48 in chips) 
Seat 2: lawlex_2 ($2.11 in chips) 
Seat 3: kunicina13 ($2.04 in chips) 
Seat 4: Jammywhisker ($3.50 in chips) 
Seat 5: nashkoffee ($1.90 in chips) 
Seat 6: Hulk3047 ($2.64 in chips) 
Jammywhisker: posts small blind $0.01
nashkoffee: posts big blind $0.02
*** HOLE CARDS ***
Dealt to lawlex_2 [Kc Jd]
Hulk3047: folds 
visiit: calls $0.02
lawlex_2: raises $0.03 to $0.05
kunicina13: folds 
Jammywhisker: folds 
nashkoffee: folds 
visiit: calls $0.03
*** FLOP *** [Td 8h Ks]
visiit: checks 
lawlex_2: bets $0.09
visiit: folds 
Uncalled bet ($0.09) returned to lawlex_2
lawlex_2 collected $0.13 from pot
lawlex_2: doesn't show hand 
*** SUMMARY ***
Total pot $0.13 | Rake $0 
Board [Td 8h Ks]
Seat 1: visiit folded on the Flop
Seat 2: lawlex_2 collected ($0.13)
Seat 3: kunicina13 (button) folded before Flop (didn't bet)
Seat 4: Jammywhisker (small blind) folded before Flop
Seat 5: nashkoffee (big blind) folded before Flop
Seat 6: Hulk3047 folded before Flop (didn't bet)



