PokerStars Hand #213800324255:  Hold'em No Limit ($0.01/$0.02 USD) - 2020/05/13 18:45:46 MSK [2020/05/13 11:45:46 ET]
Table 'Seginus III' 6-max Seat #3 is the button
Seat 2: crunchcorner511 ($1.59 in chips) 
Seat 3: NKGOK ($1.85 in chips) 
Seat 4: noKep yMep ($3.34 in chips) 
Seat 5: lawlex_2 ($2 in chips) 
noKep yMep: posts small blind $0.01
lawlex_2: posts big blind $0.02
Igryk007: sits out 
MarioStar78: sits out 
*** HOLE CARDS ***
Dealt to lawlex_2 [5s 3c]
crunchcorner511: folds 
NKGOK: calls $0.02
noKep yMep: raises $0.06 to $0.08
lawlex_2: folds 
NKGOK: calls $0.06
*** FLOP *** [9s Tc As]
noKep yMep: bets $0.09
NKGOK: folds 
Uncalled bet ($0.09) returned to noKep yMep
noKep yMep collected $0.17 from pot
noKep yMep: doesn't show hand 
*** SUMMARY ***
Total pot $0.18 | Rake $0.01 
Board [9s Tc As]
Seat 2: crunchcorner511 folded before Flop (didn't bet)
Seat 3: NKGOK (button) folded on the Flop
Seat 4: noKep yMep (small blind) collected ($0.17)
Seat 5: lawlex_2 (big blind) folded before Flop



PokerStars Hand #213800341659:  Hold'em No Limit ($0.01/$0.02 USD) - 2020/05/13 18:46:10 MSK [2020/05/13 11:46:10 ET]
Table 'Seginus III' 6-max Seat #4 is the button
Seat 2: crunchcorner511 ($1.59 in chips) 
Seat 3: NKGOK ($1.77 in chips) 
Seat 4: noKep yMep ($3.43 in chips) 
Seat 5: lawlex_2 ($1.98 in chips) 
Seat 6: Igryk007 ($0.80 in chips) 
lawlex_2: posts small blind $0.01
Igryk007: posts big blind $0.02
MarioStar78: sits out 
*** HOLE CARDS ***
Dealt to lawlex_2 [8h 8s]
crunchcorner511: calls $0.02
NKGOK: folds 
noKep yMep: folds 
lawlex_2: calls $0.01
Igryk007: checks 
*** FLOP *** [5d 2d 3d]
lawlex_2: bets $0.04
Igryk007: calls $0.04
crunchcorner511: folds 
*** TURN *** [5d 2d 3d] [Th]
lawlex_2: bets $0.09
Igryk007: folds 
Uncalled bet ($0.09) returned to lawlex_2
lawlex_2 collected $0.14 from pot
lawlex_2: doesn't show hand 
*** SUMMARY ***
Total pot $0.14 | Rake $0 
Board [5d 2d 3d Th]
Seat 2: crunchcorner511 folded on the Flop
Seat 3: NKGOK folded before Flop (didn't bet)
Seat 4: noKep yMep (button) folded before Flop (didn't bet)
Seat 5: lawlex_2 (small blind) collected ($0.14)
Seat 6: Igryk007 (big blind) folded on the Turn



PokerStars Hand #213800372495:  Hold'em No Limit ($0.01/$0.02 USD) - 2020/05/13 18:46:51 MSK [2020/05/13 11:46:51 ET]
Table 'Seginus III' 6-max Seat #5 is the button
Seat 1: MarioStar78 ($1.60 in chips) 
Seat 2: crunchcorner511 ($1.57 in chips) 
Seat 3: NKGOK ($1.77 in chips) 
Seat 4: noKep yMep ($3.43 in chips) 
Seat 5: lawlex_2 ($2.06 in chips) 
Seat 6: Igryk007 ($0.74 in chips) 
Igryk007: posts small blind $0.01
MarioStar78: posts big blind $0.02
*** HOLE CARDS ***
Dealt to lawlex_2 [6c Qs]
crunchcorner511: calls $0.02
NKGOK: folds 
noKep yMep: folds 
lawlex_2: folds 
Igryk007: calls $0.01
MarioStar78: checks 
*** FLOP *** [3d 7h Qc]
Igryk007: checks 
MarioStar78: bets $0.02
crunchcorner511: calls $0.02
Igryk007: folds 
*** TURN *** [3d 7h Qc] [7d]
MarioStar78: bets $0.02
crunchcorner511: calls $0.02
*** RIVER *** [3d 7h Qc 7d] [9h]
MarioStar78: bets $0.08
crunchcorner511: calls $0.08
*** SHOW DOWN ***
MarioStar78: shows [5h 7c] (three of a kind, Sevens)
crunchcorner511: mucks hand 
MarioStar78 collected $0.29 from pot
*** SUMMARY ***
Total pot $0.30 | Rake $0.01 
Board [3d 7h Qc 7d 9h]
Seat 1: MarioStar78 (big blind) showed [5h 7c] and won ($0.29) with three of a kind, Sevens
Seat 2: crunchcorner511 mucked [8c Ah]
Seat 3: NKGOK folded before Flop (didn't bet)
Seat 4: noKep yMep folded before Flop (didn't bet)
Seat 5: lawlex_2 (button) folded before Flop (didn't bet)
Seat 6: Igryk007 (small blind) folded on the Flop



PokerStars Hand #213800400267:  Hold'em No Limit ($0.01/$0.02 USD) - 2020/05/13 18:47:28 MSK [2020/05/13 11:47:28 ET]
Table 'Seginus III' 6-max Seat #6 is the button
Seat 1: MarioStar78 ($1.75 in chips) 
Seat 2: crunchcorner511 ($1.43 in chips) 
Seat 3: NKGOK ($1.77 in chips) 
Seat 4: noKep yMep ($3.43 in chips) 
Seat 5: lawlex_2 ($2.06 in chips) 
Seat 6: Igryk007 ($0.72 in chips) 
MarioStar78: posts small blind $0.01
crunchcorner511: posts big blind $0.02
*** HOLE CARDS ***
Dealt to lawlex_2 [7c Ah]
NKGOK: folds 
noKep yMep: folds 
lawlex_2: raises $0.03 to $0.05
Igryk007: calls $0.05
MarioStar78: calls $0.04
crunchcorner511: calls $0.03
*** FLOP *** [4h 7h 4d]
MarioStar78: checks 
crunchcorner511: checks 
lawlex_2: bets $0.13
Igryk007: folds 
MarioStar78: calls $0.13
crunchcorner511: folds 
*** TURN *** [4h 7h 4d] [2s]
MarioStar78: checks 
lawlex_2: bets $0.29
MarioStar78: calls $0.29
*** RIVER *** [4h 7h 4d 2s] [9s]
MarioStar78: checks 
lawlex_2: checks 
*** SHOW DOWN ***
MarioStar78: shows [Kd Kh] (two pair, Kings and Fours)
lawlex_2: mucks hand 
MarioStar78 collected $1 from pot
*** SUMMARY ***
Total pot $1.04 | Rake $0.04 
Board [4h 7h 4d 2s 9s]
Seat 1: MarioStar78 (small blind) showed [Kd Kh] and won ($1) with two pair, Kings and Fours
Seat 2: crunchcorner511 (big blind) folded on the Flop
Seat 3: NKGOK folded before Flop (didn't bet)
Seat 4: noKep yMep folded before Flop (didn't bet)
Seat 5: lawlex_2 mucked [7c Ah]
Seat 6: Igryk007 (button) folded on the Flop



PokerStars Hand #213800428276:  Hold'em No Limit ($0.01/$0.02 USD) - 2020/05/13 18:48:06 MSK [2020/05/13 11:48:06 ET]
Table 'Seginus III' 6-max Seat #1 is the button
Seat 1: MarioStar78 ($2.28 in chips) 
Seat 2: crunchcorner511 ($1.38 in chips) 
Seat 3: NKGOK ($1.77 in chips) 
Seat 4: noKep yMep ($3.43 in chips) 
Seat 5: lawlex_2 ($1.59 in chips) 
Seat 6: Igryk007 ($0.67 in chips) 
crunchcorner511: posts small blind $0.01
NKGOK: posts big blind $0.02
*** HOLE CARDS ***
Dealt to lawlex_2 [6c 7c]
noKep yMep: raises $0.03 to $0.05
lawlex_2: folds 
Igryk007: folds 
MarioStar78: folds 
crunchcorner511: calls $0.04
NKGOK: folds 
*** FLOP *** [Ad Qh 5c]
crunchcorner511: checks 
noKep yMep: bets $0.08
crunchcorner511: folds 
Uncalled bet ($0.08) returned to noKep yMep
noKep yMep collected $0.12 from pot
noKep yMep: doesn't show hand 
*** SUMMARY ***
Total pot $0.12 | Rake $0 
Board [Ad Qh 5c]
Seat 1: MarioStar78 (button) folded before Flop (didn't bet)
Seat 2: crunchcorner511 (small blind) folded on the Flop
Seat 3: NKGOK (big blind) folded before Flop
Seat 4: noKep yMep collected ($0.12)
Seat 5: lawlex_2 folded before Flop (didn't bet)
Seat 6: Igryk007 folded before Flop (didn't bet)



PokerStars Hand #213800468124:  Hold'em No Limit ($0.01/$0.02 USD) - 2020/05/13 18:48:46 MSK [2020/05/13 11:48:46 ET]
Table 'Seginus III' 6-max Seat #2 is the button
Seat 1: MarioStar78 ($2.28 in chips) 
Seat 2: crunchcorner511 ($1.33 in chips) 
Seat 3: NKGOK ($1.75 in chips) 
Seat 4: noKep yMep ($3.50 in chips) 
Seat 5: lawlex_2 ($1.59 in chips) 
Seat 6: Igryk007 ($0.67 in chips) 
NKGOK: posts small blind $0.01
noKep yMep: posts big blind $0.02
*** HOLE CARDS ***
Dealt to lawlex_2 [Qd 3d]
lawlex_2: folds 
Igryk007: calls $0.02
MarioStar78 has timed out
MarioStar78: folds 
crunchcorner511: calls $0.02
NKGOK has timed out
NKGOK: folds 
noKep yMep: raises $0.08 to $0.10
Igryk007: calls $0.08
crunchcorner511: calls $0.08
*** FLOP *** [7h 5s 8d]
noKep yMep: bets $0.15
Igryk007: calls $0.15
crunchcorner511: calls $0.15
*** TURN *** [7h 5s 8d] [Ks]
noKep yMep: bets $1.30
Igryk007: calls $0.42 and is all-in
crunchcorner511: folds 
Uncalled bet ($0.88) returned to noKep yMep
*** RIVER *** [7h 5s 8d Ks] [3s]
*** SHOW DOWN ***
noKep yMep: shows [Ad Ac] (a pair of Aces)
Igryk007: shows [Ah 7c] (a pair of Sevens)
noKep yMep collected $1.54 from pot
Igryk007 cashed out the hand for $0.07
*** SUMMARY ***
Total pot $1.60 | Rake $0.06 
Board [7h 5s 8d Ks 3s]
Seat 1: MarioStar78 folded before Flop (didn't bet)
Seat 2: crunchcorner511 (button) folded on the Turn
Seat 3: NKGOK (small blind) folded before Flop
Seat 4: noKep yMep (big blind) showed [Ad Ac] and won ($1.54) with a pair of Aces
Seat 5: lawlex_2 folded before Flop (didn't bet)
Seat 6: Igryk007 showed [Ah 7c] and lost with a pair of Sevens (cashed out).



PokerStars Hand #213800563018:  Hold'em No Limit ($0.01/$0.02 USD) - 2020/05/13 18:50:53 MSK [2020/05/13 11:50:53 ET]
Table 'Seginus III' 6-max Seat #3 is the button
Seat 1: MarioStar78 ($2.28 in chips) 
Seat 2: crunchcorner511 ($1.08 in chips) 
Seat 3: NKGOK ($1.74 in chips) 
Seat 4: noKep yMep ($4.37 in chips) 
Seat 5: lawlex_2 ($1.59 in chips) 
Seat 6: Igryk007 ($0.07 in chips) 
noKep yMep: posts small blind $0.01
lawlex_2: posts big blind $0.02
*** HOLE CARDS ***
Dealt to lawlex_2 [Qs 7c]
Igryk007: folds 
MarioStar78: folds 
crunchcorner511: calls $0.02
NKGOK: folds 
noKep yMep: calls $0.01
lawlex_2: checks 
*** FLOP *** [4s 6h 4h]
noKep yMep: checks 
lawlex_2: checks 
crunchcorner511: checks 
*** TURN *** [4s 6h 4h] [4c]
noKep yMep: checks 
lawlex_2: checks 
crunchcorner511: checks 
*** RIVER *** [4s 6h 4h 4c] [Jh]
noKep yMep: checks 
lawlex_2: checks 
crunchcorner511: bets $0.18
noKep yMep: folds 
lawlex_2 has timed out
lawlex_2: folds 
Uncalled bet ($0.18) returned to crunchcorner511
crunchcorner511 collected $0.06 from pot
crunchcorner511: doesn't show hand 
*** SUMMARY ***
Total pot $0.06 | Rake $0 
Board [4s 6h 4h 4c Jh]
Seat 1: MarioStar78 folded before Flop (didn't bet)
Seat 2: crunchcorner511 collected ($0.06)
Seat 3: NKGOK (button) folded before Flop (didn't bet)
Seat 4: noKep yMep (small blind) folded on the River
Seat 5: lawlex_2 (big blind) folded on the River
Seat 6: Igryk007 folded before Flop (didn't bet)



PokerStars Hand #213800709509:  Hold'em No Limit ($0.01/$0.02 USD) - 2020/05/13 18:54:10 MSK [2020/05/13 11:54:10 ET]
Table 'Seginus III' 6-max Seat #1 is the button
Seat 1: MarioStar78 ($2.28 in chips) 
Seat 2: crunchcorner511 ($1.10 in chips) 
Seat 3: NKGOK ($1.74 in chips) 
Seat 4: noKep yMep ($4.28 in chips) 
Seat 5: lawlex_2 ($1.57 in chips) 
Seat 6: Igryk007 ($0.15 in chips) 
crunchcorner511: posts small blind $0.01
NKGOK: posts big blind $0.02
lawlex_2: posts small blind $0.01
*** HOLE CARDS ***
Dealt to lawlex_2 [5d Qs]
noKep yMep: folds 
lawlex_2: folds 
Igryk007: calls $0.02
MarioStar78: calls $0.02
crunchcorner511: calls $0.01
NKGOK: checks 
*** FLOP *** [2c Ah 2s]
crunchcorner511: checks 
NKGOK: checks 
Igryk007: bets $0.13 and is all-in
MarioStar78: folds 
crunchcorner511: calls $0.13
NKGOK: folds 
*** TURN *** [2c Ah 2s] [5s]
*** RIVER *** [2c Ah 2s 5s] [4d]
*** SHOW DOWN ***
crunchcorner511: shows [4h Ad] (two pair, Aces and Fours)
Igryk007: shows [Jc 4c] (two pair, Fours and Deuces)
crunchcorner511 collected $0.34 from pot
*** SUMMARY ***
Total pot $0.35 | Rake $0.01 
Board [2c Ah 2s 5s 4d]
Seat 1: MarioStar78 (button) folded on the Flop
Seat 2: crunchcorner511 (small blind) showed [4h Ad] and won ($0.34) with two pair, Aces and Fours
Seat 3: NKGOK (big blind) folded on the Flop
Seat 4: noKep yMep folded before Flop (didn't bet)
Seat 5: lawlex_2 folded before Flop (didn't bet)
Seat 6: Igryk007 showed [Jc 4c] and lost with two pair, Fours and Deuces



PokerStars Hand #213800740236:  Hold'em No Limit ($0.01/$0.02 USD) - 2020/05/13 18:54:52 MSK [2020/05/13 11:54:52 ET]
Table 'Seginus III' 6-max Seat #2 is the button
Seat 1: MarioStar78 ($2.26 in chips) 
Seat 2: crunchcorner511 ($1.29 in chips) 
Seat 3: NKGOK ($1.72 in chips) 
Seat 4: noKep yMep ($4.28 in chips) 
Seat 5: lawlex_2 ($1.56 in chips) 
NKGOK: posts small blind $0.01
noKep yMep: posts big blind $0.02
*** HOLE CARDS ***
Dealt to lawlex_2 [7h 6s]
lawlex_2: folds 
MarioStar78: calls $0.02
Igryk007 leaves the table
crunchcorner511: calls $0.02
NKGOK: calls $0.01
noKep yMep: checks 
*** FLOP *** [Th Qd 3s]
NKGOK: checks 
NandoEstrela joins the table at seat #6 
noKep yMep: checks 
MarioStar78: bets $0.04
crunchcorner511: calls $0.04
NKGOK: folds 
noKep yMep: folds 
*** TURN *** [Th Qd 3s] [8d]
MarioStar78: bets $0.04
crunchcorner511: calls $0.04
*** RIVER *** [Th Qd 3s 8d] [Jd]
MarioStar78: checks 
crunchcorner511: bets $0.40
MarioStar78: folds 
Uncalled bet ($0.40) returned to crunchcorner511
crunchcorner511 collected $0.23 from pot
crunchcorner511: doesn't show hand 
*** SUMMARY ***
Total pot $0.24 | Rake $0.01 
Board [Th Qd 3s 8d Jd]
Seat 1: MarioStar78 folded on the River
Seat 2: crunchcorner511 (button) collected ($0.23)
Seat 3: NKGOK (small blind) folded on the Flop
Seat 4: noKep yMep (big blind) folded on the Flop
Seat 5: lawlex_2 folded before Flop (didn't bet)



PokerStars Hand #213800797402:  Hold'em No Limit ($0.01/$0.02 USD) - 2020/05/13 18:56:10 MSK [2020/05/13 11:56:10 ET]
Table 'Seginus III' 6-max Seat #3 is the button
Seat 1: MarioStar78 ($2.16 in chips) 
Seat 2: crunchcorner511 ($1.42 in chips) 
Seat 3: NKGOK ($1.70 in chips) 
Seat 4: noKep yMep ($4.26 in chips) 
Seat 5: lawlex_2 ($1.56 in chips) 
noKep yMep: posts small blind $0.01
lawlex_2: posts big blind $0.02
NandoEstrela: sits out 
*** HOLE CARDS ***
Dealt to lawlex_2 [Jh Ts]
MarioStar78: calls $0.02
crunchcorner511: folds 
NKGOK: folds 
noKep yMep: raises $0.06 to $0.08
lawlex_2: folds 
MarioStar78: folds 
Uncalled bet ($0.06) returned to noKep yMep
noKep yMep collected $0.06 from pot
noKep yMep: doesn't show hand 
*** SUMMARY ***
Total pot $0.06 | Rake $0 
Seat 1: MarioStar78 folded before Flop
Seat 2: crunchcorner511 folded before Flop (didn't bet)
Seat 3: NKGOK (button) folded before Flop (didn't bet)
Seat 4: noKep yMep (small blind) collected ($0.06)
Seat 5: lawlex_2 (big blind) folded before Flop



PokerStars Hand #213800806966:  Hold'em No Limit ($0.01/$0.02 USD) - 2020/05/13 18:56:27 MSK [2020/05/13 11:56:27 ET]
Table 'Seginus III' 6-max Seat #4 is the button
Seat 1: MarioStar78 ($2.14 in chips) 
Seat 2: crunchcorner511 ($1.42 in chips) 
Seat 3: NKGOK ($1.70 in chips) 
Seat 4: noKep yMep ($4.30 in chips) 
Seat 5: lawlex_2 ($1.54 in chips) 
Seat 6: NandoEstrela ($2 in chips) 
lawlex_2: posts small blind $0.01
NandoEstrela: posts big blind $0.02
*** HOLE CARDS ***
Dealt to lawlex_2 [2h Ad]
MarioStar78: raises $0.04 to $0.06
crunchcorner511: folds 
NKGOK: folds 
noKep yMep: folds 
lawlex_2: folds 
NandoEstrela: folds 
Uncalled bet ($0.04) returned to MarioStar78
MarioStar78 collected $0.05 from pot
MarioStar78: doesn't show hand 
*** SUMMARY ***
Total pot $0.05 | Rake $0 
Seat 1: MarioStar78 collected ($0.05)
Seat 2: crunchcorner511 folded before Flop (didn't bet)
Seat 3: NKGOK folded before Flop (didn't bet)
Seat 4: noKep yMep (button) folded before Flop (didn't bet)
Seat 5: lawlex_2 (small blind) folded before Flop
Seat 6: NandoEstrela (big blind) folded before Flop



PokerStars Hand #213800816970:  Hold'em No Limit ($0.01/$0.02 USD) - 2020/05/13 18:56:44 MSK [2020/05/13 11:56:44 ET]
Table 'Seginus III' 6-max Seat #5 is the button
Seat 1: MarioStar78 ($2.17 in chips) 
Seat 2: crunchcorner511 ($1.42 in chips) 
Seat 3: NKGOK ($1.70 in chips) 
Seat 4: noKep yMep ($4.30 in chips) 
Seat 5: lawlex_2 ($1.53 in chips) 
Seat 6: NandoEstrela ($1.98 in chips) 
NandoEstrela: posts small blind $0.01
MarioStar78: posts big blind $0.02
*** HOLE CARDS ***
Dealt to lawlex_2 [Ts 2s]
crunchcorner511: calls $0.02
NKGOK: folds 
noKep yMep: folds 
lawlex_2: folds 
NandoEstrela: folds 
MarioStar78: checks 
*** FLOP *** [Ad 4s 2c]
MarioStar78: checks 
crunchcorner511: checks 
*** TURN *** [Ad 4s 2c] [8h]
MarioStar78: checks 
crunchcorner511: checks 
*** RIVER *** [Ad 4s 2c 8h] [4d]
MarioStar78: checks 
crunchcorner511: bets $0.05
MarioStar78: folds 
Uncalled bet ($0.05) returned to crunchcorner511
crunchcorner511 collected $0.05 from pot
crunchcorner511: doesn't show hand 
*** SUMMARY ***
Total pot $0.05 | Rake $0 
Board [Ad 4s 2c 8h 4d]
Seat 1: MarioStar78 (big blind) folded on the River
Seat 2: crunchcorner511 collected ($0.05)
Seat 3: NKGOK folded before Flop (didn't bet)
Seat 4: noKep yMep folded before Flop (didn't bet)
Seat 5: lawlex_2 (button) folded before Flop (didn't bet)
Seat 6: NandoEstrela (small blind) folded before Flop



PokerStars Hand #213800840266:  Hold'em No Limit ($0.01/$0.02 USD) - 2020/05/13 18:57:24 MSK [2020/05/13 11:57:24 ET]
Table 'Seginus III' 6-max Seat #6 is the button
Seat 1: MarioStar78 ($2.15 in chips) 
Seat 2: crunchcorner511 ($1.45 in chips) 
Seat 3: NKGOK ($1.70 in chips) 
Seat 4: noKep yMep ($4.30 in chips) 
Seat 5: lawlex_2 ($1.53 in chips) 
Seat 6: NandoEstrela ($2 in chips) 
MarioStar78: posts small blind $0.01
crunchcorner511: posts big blind $0.02
*** HOLE CARDS ***
Dealt to lawlex_2 [Qh Td]
NKGOK: folds 
noKep yMep: folds 
lawlex_2: raises $0.03 to $0.05
NandoEstrela: folds 
MarioStar78: folds 
crunchcorner511: calls $0.03
*** FLOP *** [8d 9s 3h]
crunchcorner511: checks 
lawlex_2: bets $0.07
crunchcorner511: calls $0.07
*** TURN *** [8d 9s 3h] [6s]
crunchcorner511: checks 
lawlex_2: bets $0.12
crunchcorner511: calls $0.12
*** RIVER *** [8d 9s 3h 6s] [As]
crunchcorner511: bets $0.24
lawlex_2: folds 
Uncalled bet ($0.24) returned to crunchcorner511
crunchcorner511 collected $0.47 from pot
crunchcorner511: doesn't show hand 
*** SUMMARY ***
Total pot $0.49 | Rake $0.02 
Board [8d 9s 3h 6s As]
Seat 1: MarioStar78 (small blind) folded before Flop
Seat 2: crunchcorner511 (big blind) collected ($0.47)
Seat 3: NKGOK folded before Flop (didn't bet)
Seat 4: noKep yMep folded before Flop (didn't bet)
Seat 5: lawlex_2 folded on the River
Seat 6: NandoEstrela (button) folded before Flop (didn't bet)



PokerStars Hand #213800871941:  Hold'em No Limit ($0.01/$0.02 USD) - 2020/05/13 18:58:18 MSK [2020/05/13 11:58:18 ET]
Table 'Seginus III' 6-max Seat #1 is the button
Seat 1: MarioStar78 ($2.14 in chips) 
Seat 2: crunchcorner511 ($1.68 in chips) 
Seat 3: NKGOK ($1.70 in chips) 
Seat 4: noKep yMep ($4.30 in chips) 
Seat 5: lawlex_2 ($1.29 in chips) 
Seat 6: NandoEstrela ($2 in chips) 
crunchcorner511: posts small blind $0.01
NKGOK: posts big blind $0.02
*** HOLE CARDS ***
Dealt to lawlex_2 [Qs 4s]
noKep yMep: folds 
lawlex_2: folds 
NandoEstrela: folds 
MarioStar78: folds 
crunchcorner511: calls $0.01
NKGOK: checks 
*** FLOP *** [2c 3s 8c]
crunchcorner511: checks 
NKGOK: checks 
*** TURN *** [2c 3s 8c] [Jh]
crunchcorner511: checks 
NKGOK: checks 
*** RIVER *** [2c 3s 8c Jh] [Td]
crunchcorner511: checks 
NKGOK: checks 
*** SHOW DOWN ***
crunchcorner511: shows [9h 5h] (high card Jack)
NKGOK: shows [3d Ah] (a pair of Threes)
NKGOK collected $0.04 from pot
*** SUMMARY ***
Total pot $0.04 | Rake $0 
Board [2c 3s 8c Jh Td]
Seat 1: MarioStar78 (button) folded before Flop (didn't bet)
Seat 2: crunchcorner511 (small blind) showed [9h 5h] and lost with high card Jack
Seat 3: NKGOK (big blind) showed [3d Ah] and won ($0.04) with a pair of Threes
Seat 4: noKep yMep folded before Flop (didn't bet)
Seat 5: lawlex_2 folded before Flop (didn't bet)
Seat 6: NandoEstrela folded before Flop (didn't bet)



PokerStars Hand #213800887847:  Hold'em No Limit ($0.01/$0.02 USD) - 2020/05/13 18:58:45 MSK [2020/05/13 11:58:45 ET]
Table 'Seginus III' 6-max Seat #2 is the button
Seat 1: MarioStar78 ($2.14 in chips) 
Seat 2: crunchcorner511 ($1.66 in chips) 
Seat 3: NKGOK ($1.72 in chips) 
Seat 4: noKep yMep ($4.30 in chips) 
Seat 5: lawlex_2 ($1.29 in chips) 
Seat 6: NandoEstrela ($2 in chips) 
NKGOK: posts small blind $0.01
noKep yMep: posts big blind $0.02
*** HOLE CARDS ***
Dealt to lawlex_2 [2c Th]
lawlex_2: folds 
NandoEstrela: raises $0.04 to $0.06
MarioStar78 has timed out
MarioStar78: folds 
crunchcorner511: folds 
NKGOK: folds 
noKep yMep: folds 
Uncalled bet ($0.04) returned to NandoEstrela
NandoEstrela collected $0.05 from pot
NandoEstrela: doesn't show hand 
*** SUMMARY ***
Total pot $0.05 | Rake $0 
Seat 1: MarioStar78 folded before Flop (didn't bet)
Seat 2: crunchcorner511 (button) folded before Flop (didn't bet)
Seat 3: NKGOK (small blind) folded before Flop
Seat 4: noKep yMep (big blind) folded before Flop
Seat 5: lawlex_2 folded before Flop (didn't bet)
Seat 6: NandoEstrela collected ($0.05)



PokerStars Hand #213800912323:  Hold'em No Limit ($0.01/$0.02 USD) - 2020/05/13 18:59:27 MSK [2020/05/13 11:59:27 ET]
Table 'Seginus III' 6-max Seat #3 is the button
Seat 1: MarioStar78 ($2.14 in chips) 
Seat 2: crunchcorner511 ($1.66 in chips) 
Seat 3: NKGOK ($1.71 in chips) 
Seat 4: noKep yMep ($4.28 in chips) 
Seat 5: lawlex_2 ($1.29 in chips) 
Seat 6: NandoEstrela ($2.03 in chips) 
noKep yMep: posts small blind $0.01
lawlex_2: posts big blind $0.02
*** HOLE CARDS ***
Dealt to lawlex_2 [As Ks]
NandoEstrela: folds 
MarioStar78: calls $0.02
crunchcorner511: calls $0.02
NKGOK: folds 
noKep yMep: calls $0.01
lawlex_2: raises $0.03 to $0.05
MarioStar78: calls $0.03
crunchcorner511: calls $0.03
noKep yMep: folds 
*** FLOP *** [8h 5c Kh]
lawlex_2: bets $0.11
MarioStar78: calls $0.11
crunchcorner511: folds 
*** TURN *** [8h 5c Kh] [Ac]
lawlex_2: bets $0.25
MarioStar78: calls $0.25
*** RIVER *** [8h 5c Kh Ac] [7c]
lawlex_2: bets $0.57
MarioStar78: calls $0.57
*** SHOW DOWN ***
lawlex_2: shows [As Ks] (two pair, Aces and Kings)
MarioStar78: mucks hand 
lawlex_2 collected $1.96 from pot
*** SUMMARY ***
Total pot $2.03 | Rake $0.07 
Board [8h 5c Kh Ac 7c]
Seat 1: MarioStar78 mucked [Js Kc]
Seat 2: crunchcorner511 folded on the Flop
Seat 3: NKGOK (button) folded before Flop (didn't bet)
Seat 4: noKep yMep (small blind) folded before Flop
Seat 5: lawlex_2 (big blind) showed [As Ks] and won ($1.96) with two pair, Aces and Kings
Seat 6: NandoEstrela folded before Flop (didn't bet)



PokerStars Hand #213800938773:  Hold'em No Limit ($0.01/$0.02 USD) - 2020/05/13 19:00:12 MSK [2020/05/13 12:00:12 ET]
Table 'Seginus III' 6-max Seat #4 is the button
Seat 1: MarioStar78 ($1.16 in chips) 
Seat 2: crunchcorner511 ($1.61 in chips) 
Seat 3: NKGOK ($1.71 in chips) 
Seat 4: noKep yMep ($4.26 in chips) 
Seat 5: lawlex_2 ($2.27 in chips) 
Seat 6: NandoEstrela ($2.03 in chips) 
lawlex_2: posts small blind $0.01
NandoEstrela: posts big blind $0.02
*** HOLE CARDS ***
Dealt to lawlex_2 [7d 2h]
MarioStar78: folds 
crunchcorner511: calls $0.02
NKGOK: folds 
noKep yMep: raises $0.06 to $0.08
lawlex_2: folds 
NandoEstrela: folds 
crunchcorner511: calls $0.06
*** FLOP *** [8d Th Qc]
crunchcorner511: checks 
noKep yMep: bets $0.10
crunchcorner511: calls $0.10
*** TURN *** [8d Th Qc] [Kc]
crunchcorner511: bets $0.12
noKep yMep: raises $3.96 to $4.08 and is all-in
crunchcorner511: folds 
Uncalled bet ($3.96) returned to noKep yMep
noKep yMep collected $0.61 from pot
noKep yMep: doesn't show hand 
*** SUMMARY ***
Total pot $0.63 | Rake $0.02 
Board [8d Th Qc Kc]
Seat 1: MarioStar78 folded before Flop (didn't bet)
Seat 2: crunchcorner511 folded on the Turn
Seat 3: NKGOK folded before Flop (didn't bet)
Seat 4: noKep yMep (button) collected ($0.61)
Seat 5: lawlex_2 (small blind) folded before Flop
Seat 6: NandoEstrela (big blind) folded before Flop



PokerStars Hand #213800975839:  Hold'em No Limit ($0.01/$0.02 USD) - 2020/05/13 19:01:11 MSK [2020/05/13 12:01:11 ET]
Table 'Seginus III' 6-max Seat #5 is the button
Seat 1: MarioStar78 ($1.96 in chips) 
Seat 2: crunchcorner511 ($1.31 in chips) 
Seat 3: NKGOK ($1.71 in chips) 
Seat 4: noKep yMep ($4.57 in chips) 
Seat 5: lawlex_2 ($2.26 in chips) 
Seat 6: NandoEstrela ($2.01 in chips) 
NandoEstrela: posts small blind $0.01
MarioStar78: posts big blind $0.02
*** HOLE CARDS ***
Dealt to lawlex_2 [6d Jh]
crunchcorner511: calls $0.02
NKGOK: folds 
noKep yMep: folds 
lawlex_2: folds 
NandoEstrela: folds 
MarioStar78: checks 
*** FLOP *** [4c 9c Ks]
MarioStar78: checks 
crunchcorner511: bets $0.02
MarioStar78: folds 
Uncalled bet ($0.02) returned to crunchcorner511
crunchcorner511 collected $0.05 from pot
crunchcorner511: doesn't show hand 
*** SUMMARY ***
Total pot $0.05 | Rake $0 
Board [4c 9c Ks]
Seat 1: MarioStar78 (big blind) folded on the Flop
Seat 2: crunchcorner511 collected ($0.05)
Seat 3: NKGOK folded before Flop (didn't bet)
Seat 4: noKep yMep folded before Flop (didn't bet)
Seat 5: lawlex_2 (button) folded before Flop (didn't bet)
Seat 6: NandoEstrela (small blind) folded before Flop



PokerStars Hand #213800995546:  Hold'em No Limit ($0.01/$0.02 USD) - 2020/05/13 19:01:39 MSK [2020/05/13 12:01:39 ET]
Table 'Seginus III' 6-max Seat #6 is the button
Seat 1: MarioStar78 ($1.94 in chips) 
Seat 2: crunchcorner511 ($1.34 in chips) 
Seat 3: NKGOK ($1.71 in chips) 
Seat 4: noKep yMep ($4.57 in chips) 
Seat 5: lawlex_2 ($2.26 in chips) 
Seat 6: NandoEstrela ($2 in chips) 
MarioStar78: posts small blind $0.01
crunchcorner511: posts big blind $0.02
*** HOLE CARDS ***
Dealt to lawlex_2 [3s 9d]
NKGOK: folds 
noKep yMep: folds 
lawlex_2: folds 
NandoEstrela: folds 
MarioStar78: raises $0.02 to $0.04
crunchcorner511: folds 
Uncalled bet ($0.02) returned to MarioStar78
MarioStar78 collected $0.04 from pot
MarioStar78: doesn't show hand 
*** SUMMARY ***
Total pot $0.04 | Rake $0 
Seat 1: MarioStar78 (small blind) collected ($0.04)
Seat 2: crunchcorner511 (big blind) folded before Flop
Seat 3: NKGOK folded before Flop (didn't bet)
Seat 4: noKep yMep folded before Flop (didn't bet)
Seat 5: lawlex_2 folded before Flop (didn't bet)
Seat 6: NandoEstrela (button) folded before Flop (didn't bet)



PokerStars Hand #213801007983:  Hold'em No Limit ($0.01/$0.02 USD) - 2020/05/13 19:01:57 MSK [2020/05/13 12:01:57 ET]
Table 'Seginus III' 6-max Seat #1 is the button
Seat 1: MarioStar78 ($1.96 in chips) 
Seat 2: crunchcorner511 ($1.32 in chips) 
Seat 3: NKGOK ($1.71 in chips) 
Seat 4: noKep yMep ($4.57 in chips) 
Seat 5: lawlex_2 ($2.26 in chips) 
Seat 6: NandoEstrela ($2 in chips) 
crunchcorner511: posts small blind $0.01
NKGOK: posts big blind $0.02
*** HOLE CARDS ***
Dealt to lawlex_2 [7h 9h]
noKep yMep: raises $0.03 to $0.05
lawlex_2: folds 
NandoEstrela: folds 
MarioStar78: folds 
crunchcorner511: folds 
NKGOK: folds 
Uncalled bet ($0.03) returned to noKep yMep
noKep yMep collected $0.05 from pot
noKep yMep: doesn't show hand 
*** SUMMARY ***
Total pot $0.05 | Rake $0 
Seat 1: MarioStar78 (button) folded before Flop (didn't bet)
Seat 2: crunchcorner511 (small blind) folded before Flop
Seat 3: NKGOK (big blind) folded before Flop
Seat 4: noKep yMep collected ($0.05)
Seat 5: lawlex_2 folded before Flop (didn't bet)
Seat 6: NandoEstrela folded before Flop (didn't bet)



PokerStars Hand #213801024448:  Hold'em No Limit ($0.01/$0.02 USD) - 2020/05/13 19:02:19 MSK [2020/05/13 12:02:19 ET]
Table 'Seginus III' 6-max Seat #2 is the button
Seat 1: MarioStar78 ($1.96 in chips) 
Seat 2: crunchcorner511 ($1.31 in chips) 
Seat 3: NKGOK ($1.69 in chips) 
Seat 5: lawlex_2 ($2.26 in chips) 
Seat 6: NandoEstrela ($2 in chips) 
NKGOK: posts small blind $0.01
noKep yMep: is sitting out 
lawlex_2: posts big blind $0.02
*** HOLE CARDS ***
Dealt to lawlex_2 [As Kh]
NandoEstrela: folds 
MarioStar78: folds 
crunchcorner511: folds 
NKGOK: folds 
Uncalled bet ($0.01) returned to lawlex_2
lawlex_2 collected $0.02 from pot
lawlex_2: doesn't show hand 
*** SUMMARY ***
Total pot $0.02 | Rake $0 
Seat 1: MarioStar78 folded before Flop (didn't bet)
Seat 2: crunchcorner511 (button) folded before Flop (didn't bet)
Seat 3: NKGOK (small blind) folded before Flop
Seat 5: lawlex_2 (big blind) collected ($0.02)
Seat 6: NandoEstrela folded before Flop (didn't bet)



PokerStars Hand #213801034005:  Hold'em No Limit ($0.01/$0.02 USD) - 2020/05/13 19:02:32 MSK [2020/05/13 12:02:32 ET]
Table 'Seginus III' 6-max Seat #3 is the button
Seat 1: MarioStar78 ($1.96 in chips) 
Seat 2: crunchcorner511 ($1.31 in chips) 
Seat 3: NKGOK ($1.68 in chips) 
Seat 5: lawlex_2 ($2.27 in chips) 
Seat 6: NandoEstrela ($2 in chips) 
lawlex_2: posts small blind $0.01
NandoEstrela: posts big blind $0.02
*** HOLE CARDS ***
Dealt to lawlex_2 [9h 9c]
MarioStar78: folds 
crunchcorner511: folds 
NKGOK: folds 
lawlex_2: raises $0.03 to $0.05
NandoEstrela: folds 
Uncalled bet ($0.03) returned to lawlex_2
lawlex_2 collected $0.04 from pot
lawlex_2: doesn't show hand 
*** SUMMARY ***
Total pot $0.04 | Rake $0 
Seat 1: MarioStar78 folded before Flop (didn't bet)
Seat 2: crunchcorner511 folded before Flop (didn't bet)
Seat 3: NKGOK (button) folded before Flop (didn't bet)
Seat 5: lawlex_2 (small blind) collected ($0.04)
Seat 6: NandoEstrela (big blind) folded before Flop



PokerStars Hand #213801044242:  Hold'em No Limit ($0.01/$0.02 USD) - 2020/05/13 19:02:46 MSK [2020/05/13 12:02:46 ET]
Table 'Seginus III' 6-max Seat #5 is the button
Seat 1: MarioStar78 ($1.96 in chips) 
Seat 2: crunchcorner511 ($1.31 in chips) 
Seat 3: NKGOK ($1.68 in chips) 
Seat 5: lawlex_2 ($2.29 in chips) 
Seat 6: NandoEstrela ($1.98 in chips) 
NandoEstrela: posts small blind $0.01
MarioStar78: posts big blind $0.02
*** HOLE CARDS ***
Dealt to lawlex_2 [Ad 2c]
crunchcorner511: calls $0.02
NKGOK: calls $0.02
lawlex_2: raises $0.03 to $0.05
NandoEstrela: calls $0.04
MarioStar78: folds 
crunchcorner511: calls $0.03
NKGOK: calls $0.03
*** FLOP *** [9h 7d Qc]
NandoEstrela: checks 
crunchcorner511: checks 
NKGOK: checks 
lawlex_2: bets $0.14
NandoEstrela: folds 
crunchcorner511: folds 
NKGOK: folds 
Uncalled bet ($0.14) returned to lawlex_2
lawlex_2 collected $0.21 from pot
lawlex_2: doesn't show hand 
*** SUMMARY ***
Total pot $0.22 | Rake $0.01 
Board [9h 7d Qc]
Seat 1: MarioStar78 (big blind) folded before Flop
Seat 2: crunchcorner511 folded on the Flop
Seat 3: NKGOK folded on the Flop
Seat 5: lawlex_2 (button) collected ($0.21)
Seat 6: NandoEstrela (small blind) folded on the Flop



PokerStars Hand #213801073748:  Hold'em No Limit ($0.01/$0.02 USD) - 2020/05/13 19:03:26 MSK [2020/05/13 12:03:26 ET]
Table 'Seginus III' 6-max Seat #6 is the button
Seat 1: MarioStar78 ($1.94 in chips) 
Seat 2: crunchcorner511 ($1.26 in chips) 
Seat 3: NKGOK ($1.63 in chips) 
Seat 5: lawlex_2 ($2.45 in chips) 
Seat 6: NandoEstrela ($2 in chips) 
MarioStar78: posts small blind $0.01
crunchcorner511: posts big blind $0.02
*** HOLE CARDS ***
Dealt to lawlex_2 [4s 2h]
NKGOK: folds 
lawlex_2: folds 
NandoEstrela: folds 
MarioStar78: folds 
Uncalled bet ($0.01) returned to crunchcorner511
crunchcorner511 collected $0.02 from pot
*** SUMMARY ***
Total pot $0.02 | Rake $0 
Seat 1: MarioStar78 (small blind) folded before Flop
Seat 2: crunchcorner511 (big blind) collected ($0.02)
Seat 3: NKGOK folded before Flop (didn't bet)
Seat 5: lawlex_2 folded before Flop (didn't bet)
Seat 6: NandoEstrela (button) folded before Flop (didn't bet)



PokerStars Hand #213801080214:  Hold'em No Limit ($0.01/$0.02 USD) - 2020/05/13 19:03:35 MSK [2020/05/13 12:03:35 ET]
Table 'Seginus III' 6-max Seat #1 is the button
Seat 1: MarioStar78 ($1.93 in chips) 
Seat 2: crunchcorner511 ($1.27 in chips) 
Seat 3: NKGOK ($1.63 in chips) 
Seat 5: lawlex_2 ($2.45 in chips) 
Seat 6: NandoEstrela ($2 in chips) 
crunchcorner511: posts small blind $0.01
NKGOK: posts big blind $0.02
*** HOLE CARDS ***
Dealt to lawlex_2 [4s Qd]
lawlex_2: folds 
NandoEstrela: raises $0.04 to $0.06
MarioStar78: calls $0.06
crunchcorner511: calls $0.05
NKGOK: calls $0.04
*** FLOP *** [2d 5s 3c]
crunchcorner511: checks 
NKGOK: checks 
NandoEstrela: checks 
MarioStar78: bets $0.06
crunchcorner511 is disconnected 
crunchcorner511 is connected 
crunchcorner511 has timed out
crunchcorner511: folds 
NKGOK: calls $0.06
NandoEstrela: calls $0.06
*** TURN *** [2d 5s 3c] [7c]
NKGOK: bets $0.20
NandoEstrela: folds 
crunchcorner511 is disconnected 
MarioStar78: calls $0.20
*** RIVER *** [2d 5s 3c 7c] [5c]
NKGOK: bets $0.40
noKep yMep leaves the table
MarioStar78: folds 
Uncalled bet ($0.40) returned to NKGOK
NKGOK collected $0.79 from pot
*** SUMMARY ***
Total pot $0.82 | Rake $0.03 
Board [2d 5s 3c 7c 5c]
Seat 1: MarioStar78 (button) folded on the River
Seat 2: crunchcorner511 (small blind) folded on the Flop
Seat 3: NKGOK (big blind) collected ($0.79)
Seat 5: lawlex_2 folded before Flop (didn't bet)
Seat 6: NandoEstrela folded on the Turn



PokerStars Hand #213801188852:  Hold'em No Limit ($0.01/$0.02 USD) - 2020/05/13 19:05:57 MSK [2020/05/13 12:05:57 ET]
Table 'Seginus III' 6-max Seat #3 is the button
Seat 1: MarioStar78 ($1.61 in chips) 
Seat 3: NKGOK ($2.10 in chips) 
Seat 5: lawlex_2 ($2.45 in chips) 
Seat 6: NandoEstrela ($2 in chips) 
lawlex_2: posts small blind $0.01
NandoEstrela: posts big blind $0.02
*** HOLE CARDS ***
Dealt to lawlex_2 [4d 6h]
MarioStar78: raises $0.02 to $0.04
NKGOK: folds 
lawlex_2: folds 
NandoEstrela: folds 
Uncalled bet ($0.02) returned to MarioStar78
MarioStar78 collected $0.05 from pot
MarioStar78: doesn't show hand 
*** SUMMARY ***
Total pot $0.05 | Rake $0 
Seat 1: MarioStar78 collected ($0.05)
Seat 3: NKGOK (button) folded before Flop (didn't bet)
Seat 5: lawlex_2 (small blind) folded before Flop
Seat 6: NandoEstrela (big blind) folded before Flop



PokerStars Hand #213801197746:  Hold'em No Limit ($0.01/$0.02 USD) - 2020/05/13 19:06:09 MSK [2020/05/13 12:06:09 ET]
Table 'Seginus III' 6-max Seat #5 is the button
Seat 1: MarioStar78 ($1.64 in chips) 
Seat 3: NKGOK ($2.10 in chips) 
Seat 5: lawlex_2 ($2.44 in chips) 
Seat 6: NandoEstrela ($1.98 in chips) 
NandoEstrela: posts small blind $0.01
MarioStar78: posts big blind $0.02
*** HOLE CARDS ***
Dealt to lawlex_2 [Kd 3d]
NKGOK: folds 
lawlex_2: folds 
NandoEstrela: raises $0.04 to $0.06
MarioStar78: calls $0.04
*** FLOP *** [6d 8s 4h]
NandoEstrela: checks 
MarioStar78: bets $0.04
NandoEstrela: calls $0.04
*** TURN *** [6d 8s 4h] [Ts]
NandoEstrela: checks 
MarioStar78: bets $0.04
NandoEstrela: folds 
Uncalled bet ($0.04) returned to MarioStar78
MarioStar78 collected $0.19 from pot
MarioStar78: doesn't show hand 
*** SUMMARY ***
Total pot $0.20 | Rake $0.01 
Board [6d 8s 4h Ts]
Seat 1: MarioStar78 (big blind) collected ($0.19)
Seat 3: NKGOK folded before Flop (didn't bet)
Seat 5: lawlex_2 (button) folded before Flop (didn't bet)
Seat 6: NandoEstrela (small blind) folded on the Turn



PokerStars Hand #213801225107:  Hold'em No Limit ($0.01/$0.02 USD) - 2020/05/13 19:06:44 MSK [2020/05/13 12:06:44 ET]
Table 'Seginus III' 6-max Seat #6 is the button
Seat 1: MarioStar78 ($1.73 in chips) 
Seat 3: NKGOK ($2.10 in chips) 
Seat 5: lawlex_2 ($2.44 in chips) 
Seat 6: NandoEstrela ($2 in chips) 
MarioStar78: posts small blind $0.01
NKGOK: posts big blind $0.02
*** HOLE CARDS ***
Dealt to lawlex_2 [7s 9d]
lawlex_2: folds 
NandoEstrela: raises $0.04 to $0.06
MarioStar78: calls $0.05
NKGOK: folds 
*** FLOP *** [8s 4h Js]
MarioStar78: checks 
NandoEstrela: checks 
*** TURN *** [8s 4h Js] [9h]
MarioStar78: bets $0.04
NandoEstrela: calls $0.04
*** RIVER *** [8s 4h Js 9h] [7c]
MarioStar78: bets $0.04
NandoEstrela: calls $0.04
*** SHOW DOWN ***
MarioStar78: shows [8c As] (a pair of Eights)
NandoEstrela: shows [Ah 8h] (a pair of Eights)
MarioStar78 collected $0.15 from pot
NandoEstrela collected $0.14 from pot
*** SUMMARY ***
Total pot $0.30 | Rake $0.01 
Board [8s 4h Js 9h 7c]
Seat 1: MarioStar78 (small blind) showed [8c As] and won ($0.15) with a pair of Eights
Seat 3: NKGOK (big blind) folded before Flop
Seat 5: lawlex_2 folded before Flop (didn't bet)
Seat 6: NandoEstrela (button) showed [Ah 8h] and won ($0.14) with a pair of Eights



PokerStars Hand #213801256791:  Hold'em No Limit ($0.01/$0.02 USD) - 2020/05/13 19:07:26 MSK [2020/05/13 12:07:26 ET]
Table 'Seginus III' 6-max Seat #1 is the button
Seat 1: MarioStar78 ($1.74 in chips) 
Seat 3: NKGOK ($2.08 in chips) 
Seat 5: lawlex_2 ($2.44 in chips) 
Seat 6: NandoEstrela ($2 in chips) 
NKGOK: posts small blind $0.01
lawlex_2: posts big blind $0.02
*** HOLE CARDS ***
Dealt to lawlex_2 [Jh Th]
NandoEstrela: raises $0.04 to $0.06
MarioStar78: calls $0.06
NKGOK: folds 
lawlex_2: calls $0.04
*** FLOP *** [Td 3s Ks]
lawlex_2: checks 
NandoEstrela: bets $0.09
MarioStar78: calls $0.09
lawlex_2: folds 
*** TURN *** [Td 3s Ks] [6d]
NandoEstrela: checks 
MarioStar78: bets $0.12
w.m.58 joins the table at seat #4 
NandoEstrela: folds 
Uncalled bet ($0.12) returned to MarioStar78
MarioStar78 collected $0.36 from pot
MarioStar78: doesn't show hand 
*** SUMMARY ***
Total pot $0.37 | Rake $0.01 
Board [Td 3s Ks 6d]
Seat 1: MarioStar78 (button) collected ($0.36)
Seat 3: NKGOK (small blind) folded before Flop
Seat 5: lawlex_2 (big blind) folded on the Flop
Seat 6: NandoEstrela folded on the Turn



PokerStars Hand #213801294751:  Hold'em No Limit ($0.01/$0.02 USD) - 2020/05/13 19:08:16 MSK [2020/05/13 12:08:16 ET]
Table 'Seginus III' 6-max Seat #3 is the button
Seat 1: MarioStar78 ($1.95 in chips) 
Seat 3: NKGOK ($2.07 in chips) 
Seat 5: lawlex_2 ($2.38 in chips) 
Seat 6: NandoEstrela ($2 in chips) 
lawlex_2: posts small blind $0.01
NandoEstrela: posts big blind $0.02
*** HOLE CARDS ***
Dealt to lawlex_2 [Jd 2h]
MarioStar78: folds 
NKGOK: raises $0.05 to $0.07
lawlex_2: folds 
NandoEstrela: raises $0.13 to $0.20
NKGOK: calls $0.13
*** FLOP *** [9c 3s 7s]
NandoEstrela: bets $0.26
NKGOK: folds 
Uncalled bet ($0.26) returned to NandoEstrela
NandoEstrela collected $0.40 from pot
NandoEstrela: doesn't show hand 
*** SUMMARY ***
Total pot $0.41 | Rake $0.01 
Board [9c 3s 7s]
Seat 1: MarioStar78 folded before Flop (didn't bet)
Seat 3: NKGOK (button) folded on the Flop
Seat 5: lawlex_2 (small blind) folded before Flop
Seat 6: NandoEstrela (big blind) collected ($0.40)



PokerStars Hand #213801323608:  Hold'em No Limit ($0.01/$0.02 USD) - 2020/05/13 19:08:54 MSK [2020/05/13 12:08:54 ET]
Table 'Seginus III' 6-max Seat #5 is the button
Seat 1: MarioStar78 ($1.95 in chips) 
Seat 3: NKGOK ($1.87 in chips) 
Seat 4: w.m.58 ($0.80 in chips) 
Seat 5: lawlex_2 ($2.37 in chips) 
Seat 6: NandoEstrela ($2.20 in chips) 
NandoEstrela: posts small blind $0.01
MarioStar78: posts big blind $0.02
w.m.58: posts big blind $0.02
*** HOLE CARDS ***
Dealt to lawlex_2 [2c 9d]
NKGOK: folds 
w.m.58: checks 
lawlex_2: folds 
NandoEstrela: raises $0.04 to $0.06
MarioStar78: folds 
w.m.58: calls $0.04
*** FLOP *** [4h Qc Js]
NandoEstrela: checks 
w.m.58: checks 
*** TURN *** [4h Qc Js] [9h]
NandoEstrela: bets $0.06
w.m.58: folds 
Uncalled bet ($0.06) returned to NandoEstrela
NandoEstrela collected $0.14 from pot
NandoEstrela: doesn't show hand 
*** SUMMARY ***
Total pot $0.14 | Rake $0 
Board [4h Qc Js 9h]
Seat 1: MarioStar78 (big blind) folded before Flop
Seat 3: NKGOK folded before Flop (didn't bet)
Seat 4: w.m.58 folded on the Turn
Seat 5: lawlex_2 (button) folded before Flop (didn't bet)
Seat 6: NandoEstrela (small blind) collected ($0.14)



PokerStars Hand #213801348820:  Hold'em No Limit ($0.01/$0.02 USD) - 2020/05/13 19:09:26 MSK [2020/05/13 12:09:26 ET]
Table 'Seginus III' 6-max Seat #6 is the button
Seat 1: MarioStar78 ($1.93 in chips) 
Seat 3: NKGOK ($1.87 in chips) 
Seat 4: w.m.58 ($0.74 in chips) 
Seat 5: lawlex_2 ($2.37 in chips) 
Seat 6: NandoEstrela ($2.28 in chips) 
MarioStar78: posts small blind $0.01
NKGOK: posts big blind $0.02
*** HOLE CARDS ***
Dealt to lawlex_2 [6s 5d]
w.m.58: folds 
lawlex_2: folds 
NandoEstrela: folds 
MarioStar78: folds 
Uncalled bet ($0.01) returned to NKGOK
NKGOK collected $0.02 from pot
NKGOK: doesn't show hand 
*** SUMMARY ***
Total pot $0.02 | Rake $0 
Seat 1: MarioStar78 (small blind) folded before Flop
Seat 3: NKGOK (big blind) collected ($0.02)
Seat 4: w.m.58 folded before Flop (didn't bet)
Seat 5: lawlex_2 folded before Flop (didn't bet)
Seat 6: NandoEstrela (button) folded before Flop (didn't bet)



PokerStars Hand #213801356929:  Hold'em No Limit ($0.01/$0.02 USD) - 2020/05/13 19:09:37 MSK [2020/05/13 12:09:37 ET]
Table 'Seginus III' 6-max Seat #1 is the button
Seat 1: MarioStar78 ($1.92 in chips) 
Seat 3: NKGOK ($1.88 in chips) 
Seat 4: w.m.58 ($0.74 in chips) 
Seat 5: lawlex_2 ($2.37 in chips) 
Seat 6: NandoEstrela ($2.28 in chips) 
NKGOK: posts small blind $0.01
w.m.58: posts big blind $0.02
*** HOLE CARDS ***
Dealt to lawlex_2 [As 3d]
lawlex_2: raises $0.03 to $0.05
NandoEstrela: folds 
MarioStar78: folds 
NKGOK: folds 
w.m.58: calls $0.03
*** FLOP *** [9s Qs 5s]
w.m.58: checks 
lawlex_2: bets $0.07
w.m.58: calls $0.07
*** TURN *** [9s Qs 5s] [2d]
w.m.58: checks 
lawlex_2: bets $0.16
w.m.58: raises $0.36 to $0.52
lawlex_2: folds 
Uncalled bet ($0.36) returned to w.m.58
w.m.58 collected $0.55 from pot
*** SUMMARY ***
Total pot $0.57 | Rake $0.02 
Board [9s Qs 5s 2d]
Seat 1: MarioStar78 (button) folded before Flop (didn't bet)
Seat 3: NKGOK (small blind) folded before Flop
Seat 4: w.m.58 (big blind) collected ($0.55)
Seat 5: lawlex_2 folded on the Turn
Seat 6: NandoEstrela folded before Flop (didn't bet)



PokerStars Hand #213801384591:  Hold'em No Limit ($0.01/$0.02 USD) - 2020/05/13 19:10:13 MSK [2020/05/13 12:10:13 ET]
Table 'Seginus III' 6-max Seat #3 is the button
Seat 1: MarioStar78 ($1.92 in chips) 
Seat 3: NKGOK ($1.87 in chips) 
Seat 4: w.m.58 ($1.01 in chips) 
Seat 5: lawlex_2 ($2.09 in chips) 
Seat 6: NandoEstrela ($2.28 in chips) 
w.m.58: posts small blind $0.01
lawlex_2: posts big blind $0.02
*** HOLE CARDS ***
Dealt to lawlex_2 [Tc 9d]
NandoEstrela: folds 
MarioStar78: folds 
NKGOK: folds 
w.m.58: calls $0.01
lawlex_2: checks 
*** FLOP *** [Qh Td 8s]
w.m.58: checks 
lawlex_2: bets $0.03
w.m.58: calls $0.03
*** TURN *** [Qh Td 8s] [Js]
w.m.58: checks 
lawlex_2: bets $0.07
w.m.58: calls $0.07
*** RIVER *** [Qh Td 8s Js] [8d]
w.m.58: checks 
lawlex_2: bets $0.15
w.m.58: calls $0.15
*** SHOW DOWN ***
lawlex_2: shows [Tc 9d] (a straight, Eight to Queen)
w.m.58: mucks hand 
lawlex_2 collected $0.52 from pot
*** SUMMARY ***
Total pot $0.54 | Rake $0.02 
Board [Qh Td 8s Js 8d]
Seat 1: MarioStar78 folded before Flop (didn't bet)
Seat 3: NKGOK (button) folded before Flop (didn't bet)
Seat 4: w.m.58 (small blind) mucked [Qs Ts]
Seat 5: lawlex_2 (big blind) showed [Tc 9d] and won ($0.52) with a straight, Eight to Queen
Seat 6: NandoEstrela folded before Flop (didn't bet)



PokerStars Hand #213801406858:  Hold'em No Limit ($0.01/$0.02 USD) - 2020/05/13 19:10:42 MSK [2020/05/13 12:10:42 ET]
Table 'Seginus III' 6-max Seat #4 is the button
Seat 1: MarioStar78 ($1.92 in chips) 
Seat 3: NKGOK ($1.87 in chips) 
Seat 4: w.m.58 ($0.74 in chips) 
Seat 5: lawlex_2 ($2.34 in chips) 
Seat 6: NandoEstrela ($2.28 in chips) 
lawlex_2: posts small blind $0.01
NandoEstrela: posts big blind $0.02
*** HOLE CARDS ***
Dealt to lawlex_2 [Qd 3d]
MarioStar78: folds 
NKGOK: raises $0.05 to $0.07
w.m.58: calls $0.07
lawlex_2: folds 
NandoEstrela: folds 
*** FLOP *** [Ad 6s 9d]
NKGOK: bets $0.16
w.m.58: folds 
Uncalled bet ($0.16) returned to NKGOK
NKGOK collected $0.16 from pot
*** SUMMARY ***
Total pot $0.17 | Rake $0.01 
Board [Ad 6s 9d]
Seat 1: MarioStar78 folded before Flop (didn't bet)
Seat 3: NKGOK collected ($0.16)
Seat 4: w.m.58 (button) folded on the Flop
Seat 5: lawlex_2 (small blind) folded before Flop
Seat 6: NandoEstrela (big blind) folded before Flop



PokerStars Hand #213801422442:  Hold'em No Limit ($0.01/$0.02 USD) - 2020/05/13 19:11:02 MSK [2020/05/13 12:11:02 ET]
Table 'Seginus III' 6-max Seat #5 is the button
Seat 1: MarioStar78 ($1.92 in chips) 
Seat 3: NKGOK ($1.96 in chips) 
Seat 4: w.m.58 ($0.67 in chips) 
Seat 5: lawlex_2 ($2.33 in chips) 
Seat 6: NandoEstrela ($2.26 in chips) 
NandoEstrela: posts small blind $0.01
MarioStar78: posts big blind $0.02
*** HOLE CARDS ***
Dealt to lawlex_2 [Kc 5h]
NKGOK: calls $0.02
w.m.58: calls $0.02
lawlex_2: folds 
NandoEstrela: calls $0.01
MarioStar78: checks 
*** FLOP *** [Td 4c 8d]
NandoEstrela: bets $0.04
MarioStar78: folds 
NKGOK: raises $0.04 to $0.08
w.m.58: folds 
NandoEstrela: calls $0.04
*** TURN *** [Td 4c 8d] [Ks]
NandoEstrela: checks 
NKGOK: bets $0.12
NandoEstrela: folds 
Uncalled bet ($0.12) returned to NKGOK
NKGOK collected $0.23 from pot
*** SUMMARY ***
Total pot $0.24 | Rake $0.01 
Board [Td 4c 8d Ks]
Seat 1: MarioStar78 (big blind) folded on the Flop
Seat 3: NKGOK collected ($0.23)
Seat 4: w.m.58 folded on the Flop
Seat 5: lawlex_2 (button) folded before Flop (didn't bet)
Seat 6: NandoEstrela (small blind) folded on the Turn



PokerStars Hand #213801454488:  Hold'em No Limit ($0.01/$0.02 USD) - 2020/05/13 19:11:44 MSK [2020/05/13 12:11:44 ET]
Table 'Seginus III' 6-max Seat #6 is the button
Seat 1: MarioStar78 ($1.90 in chips) 
Seat 3: NKGOK ($2.09 in chips) 
Seat 4: w.m.58 ($0.65 in chips) 
Seat 5: lawlex_2 ($2.33 in chips) 
Seat 6: NandoEstrela ($2.16 in chips) 
MarioStar78: posts small blind $0.01
NKGOK: posts big blind $0.02
*** HOLE CARDS ***
Dealt to lawlex_2 [2c 5s]
w.m.58: folds 
lawlex_2: folds 
NandoEstrela: raises $0.04 to $0.06
MarioStar78: folds 
NKGOK: folds 
Uncalled bet ($0.04) returned to NandoEstrela
NandoEstrela collected $0.05 from pot
NandoEstrela: doesn't show hand 
*** SUMMARY ***
Total pot $0.05 | Rake $0 
Seat 1: MarioStar78 (small blind) folded before Flop
Seat 3: NKGOK (big blind) folded before Flop
Seat 4: w.m.58 folded before Flop (didn't bet)
Seat 5: lawlex_2 folded before Flop (didn't bet)
Seat 6: NandoEstrela (button) collected ($0.05)



PokerStars Hand #213801463334:  Hold'em No Limit ($0.01/$0.02 USD) - 2020/05/13 19:11:56 MSK [2020/05/13 12:11:56 ET]
Table 'Seginus III' 6-max Seat #1 is the button
Seat 1: MarioStar78 ($1.89 in chips) 
Seat 3: NKGOK ($2.07 in chips) 
Seat 4: w.m.58 ($0.65 in chips) 
Seat 5: lawlex_2 ($2.33 in chips) 
Seat 6: NandoEstrela ($2.19 in chips) 
NKGOK: posts small blind $0.01
w.m.58: posts big blind $0.02
*** HOLE CARDS ***
Dealt to lawlex_2 [Qd 3s]
lawlex_2: folds 
NandoEstrela: folds 
MarioStar78: folds 
NKGOK: folds 
Uncalled bet ($0.01) returned to w.m.58
w.m.58 collected $0.02 from pot
*** SUMMARY ***
Total pot $0.02 | Rake $0 
Seat 1: MarioStar78 (button) folded before Flop (didn't bet)
Seat 3: NKGOK (small blind) folded before Flop
Seat 4: w.m.58 (big blind) collected ($0.02)
Seat 5: lawlex_2 folded before Flop (didn't bet)
Seat 6: NandoEstrela folded before Flop (didn't bet)



PokerStars Hand #213801471501:  Hold'em No Limit ($0.01/$0.02 USD) - 2020/05/13 19:12:06 MSK [2020/05/13 12:12:06 ET]
Table 'Seginus III' 6-max Seat #3 is the button
Seat 1: MarioStar78 ($1.89 in chips) 
Seat 3: NKGOK ($2.06 in chips) 
Seat 4: w.m.58 ($0.66 in chips) 
Seat 5: lawlex_2 ($2.33 in chips) 
Seat 6: NandoEstrela ($2.19 in chips) 
w.m.58: posts small blind $0.01
lawlex_2: posts big blind $0.02
*** HOLE CARDS ***
Dealt to lawlex_2 [4c Th]
NandoEstrela: folds 
MarioStar78: folds 
NKGOK: folds 
w.m.58: calls $0.01
lawlex_2: checks 
*** FLOP *** [Jh 8h 6h]
w.m.58: bets $0.02
lawlex_2: calls $0.02
*** TURN *** [Jh 8h 6h] [2c]
w.m.58: bets $0.02
lawlex_2: calls $0.02
*** RIVER *** [Jh 8h 6h 2c] [6c]
w.m.58: bets $0.02
lawlex_2: folds 
Uncalled bet ($0.02) returned to w.m.58
w.m.58 collected $0.12 from pot
*** SUMMARY ***
Total pot $0.12 | Rake $0 
Board [Jh 8h 6h 2c 6c]
Seat 1: MarioStar78 folded before Flop (didn't bet)
Seat 3: NKGOK (button) folded before Flop (didn't bet)
Seat 4: w.m.58 (small blind) collected ($0.12)
Seat 5: lawlex_2 (big blind) folded on the River
Seat 6: NandoEstrela folded before Flop (didn't bet)



PokerStars Hand #213801488454:  Hold'em No Limit ($0.01/$0.02 USD) - 2020/05/13 19:12:29 MSK [2020/05/13 12:12:29 ET]
Table 'Seginus III' 6-max Seat #4 is the button
Seat 1: MarioStar78 ($1.89 in chips) 
Seat 3: NKGOK ($2.06 in chips) 
Seat 4: w.m.58 ($0.72 in chips) 
Seat 5: lawlex_2 ($2.27 in chips) 
Seat 6: NandoEstrela ($2.19 in chips) 
lawlex_2: posts small blind $0.01
NandoEstrela: posts big blind $0.02
*** HOLE CARDS ***
Dealt to lawlex_2 [Tc 8h]
MarioStar78: folds 
NKGOK: folds 
w.m.58: folds 
lawlex_2: folds 
Uncalled bet ($0.01) returned to NandoEstrela
NandoEstrela collected $0.02 from pot
NandoEstrela: doesn't show hand 
*** SUMMARY ***
Total pot $0.02 | Rake $0 
Seat 1: MarioStar78 folded before Flop (didn't bet)
Seat 3: NKGOK folded before Flop (didn't bet)
Seat 4: w.m.58 (button) folded before Flop (didn't bet)
Seat 5: lawlex_2 (small blind) folded before Flop
Seat 6: NandoEstrela (big blind) collected ($0.02)



PokerStars Hand #213801496277:  Hold'em No Limit ($0.01/$0.02 USD) - 2020/05/13 19:12:39 MSK [2020/05/13 12:12:39 ET]
Table 'Seginus III' 6-max Seat #5 is the button
Seat 1: MarioStar78 ($1.89 in chips) 
Seat 3: NKGOK ($2.06 in chips) 
Seat 4: w.m.58 ($0.72 in chips) 
Seat 5: lawlex_2 ($2.26 in chips) 
Seat 6: NandoEstrela ($2.20 in chips) 
NandoEstrela: posts small blind $0.01
MarioStar78: posts big blind $0.02
*** HOLE CARDS ***
Dealt to lawlex_2 [8h Qh]
NKGOK: folds 
w.m.58: folds 
lawlex_2: raises $0.03 to $0.05
NandoEstrela: folds 
MarioStar78: folds 
Uncalled bet ($0.03) returned to lawlex_2
lawlex_2 collected $0.05 from pot
lawlex_2: doesn't show hand 
*** SUMMARY ***
Total pot $0.05 | Rake $0 
Seat 1: MarioStar78 (big blind) folded before Flop
Seat 3: NKGOK folded before Flop (didn't bet)
Seat 4: w.m.58 folded before Flop (didn't bet)
Seat 5: lawlex_2 (button) collected ($0.05)
Seat 6: NandoEstrela (small blind) folded before Flop



PokerStars Hand #213801505596:  Hold'em No Limit ($0.01/$0.02 USD) - 2020/05/13 19:12:51 MSK [2020/05/13 12:12:51 ET]
Table 'Seginus III' 6-max Seat #6 is the button
Seat 1: MarioStar78 ($1.87 in chips) 
Seat 3: NKGOK ($2.06 in chips) 
Seat 4: w.m.58 ($0.72 in chips) 
Seat 5: lawlex_2 ($2.29 in chips) 
Seat 6: NandoEstrela ($2.19 in chips) 
MarioStar78: posts small blind $0.01
NKGOK: posts big blind $0.02
*** HOLE CARDS ***
Dealt to lawlex_2 [4h Qd]
w.m.58: folds 
lawlex_2: folds 
NandoEstrela has timed out
NandoEstrela: folds 
MarioStar78: calls $0.01
NKGOK: checks 
*** FLOP *** [Jh 7h 9c]
MarioStar78: checks 
NKGOK: checks 
*** TURN *** [Jh 7h 9c] [8s]
MarioStar78: checks 
NKGOK: checks 
*** RIVER *** [Jh 7h 9c 8s] [4s]
MarioStar78: checks 
NKGOK: checks 
*** SHOW DOWN ***
MarioStar78: shows [Ac 6h] (high card Ace)
NKGOK: mucks hand 
MarioStar78 collected $0.04 from pot
crunchcorner511 was removed from the table for failing to post
crunchcorner511 leaves the table
*** SUMMARY ***
Total pot $0.04 | Rake $0 
Board [Jh 7h 9c 8s 4s]
Seat 1: MarioStar78 (small blind) showed [Ac 6h] and won ($0.04) with high card Ace
Seat 3: NKGOK (big blind) mucked [Kd Qc]
Seat 4: w.m.58 folded before Flop (didn't bet)
Seat 5: lawlex_2 folded before Flop (didn't bet)
Seat 6: NandoEstrela (button) folded before Flop (didn't bet)



PokerStars Hand #213801539746:  Hold'em No Limit ($0.01/$0.02 USD) - 2020/05/13 19:13:35 MSK [2020/05/13 12:13:35 ET]
Table 'Seginus III' 6-max Seat #1 is the button
Seat 1: MarioStar78 ($1.89 in chips) 
Seat 3: NKGOK ($2.04 in chips) 
Seat 4: w.m.58 ($0.72 in chips) 
Seat 5: lawlex_2 ($2.29 in chips) 
Seat 6: NandoEstrela ($2.19 in chips) 
NKGOK: posts small blind $0.01
w.m.58: posts big blind $0.02
*** HOLE CARDS ***
Dealt to lawlex_2 [Qd 9c]
lawlex_2: folds 
NandoEstrela: folds 
MarioStar78: folds 
NKGOK: folds 
Uncalled bet ($0.01) returned to w.m.58
w.m.58 collected $0.02 from pot
*** SUMMARY ***
Total pot $0.02 | Rake $0 
Seat 1: MarioStar78 (button) folded before Flop (didn't bet)
Seat 3: NKGOK (small blind) folded before Flop
Seat 4: w.m.58 (big blind) collected ($0.02)
Seat 5: lawlex_2 folded before Flop (didn't bet)
Seat 6: NandoEstrela folded before Flop (didn't bet)



PokerStars Hand #213801545719:  Hold'em No Limit ($0.01/$0.02 USD) - 2020/05/13 19:13:43 MSK [2020/05/13 12:13:43 ET]
Table 'Seginus III' 6-max Seat #3 is the button
Seat 1: MarioStar78 ($1.89 in chips) 
Seat 3: NKGOK ($2.03 in chips) 
Seat 4: w.m.58 ($0.73 in chips) 
Seat 5: lawlex_2 ($2.29 in chips) 
Seat 6: NandoEstrela ($2.19 in chips) 
w.m.58: posts small blind $0.01
lawlex_2: posts big blind $0.02
*** HOLE CARDS ***
Dealt to lawlex_2 [8d 7c]
NandoEstrela: raises $0.04 to $0.06
MarioStar78: calls $0.06
NKGOK: calls $0.06
w.m.58: folds 
lawlex_2: folds 
*** FLOP *** [Kc 2s 2d]
NandoEstrela: bets $0.12
vladbratuha joins the table at seat #2 
MarioStar78: calls $0.12
NKGOK: folds 
*** TURN *** [Kc 2s 2d] [Kd]
NandoEstrela: bets $0.16
MarioStar78: folds [Qs Qd]
Uncalled bet ($0.16) returned to NandoEstrela
NandoEstrela collected $0.43 from pot
NandoEstrela: doesn't show hand 
*** SUMMARY ***
Total pot $0.45 | Rake $0.02 
Board [Kc 2s 2d Kd]
Seat 1: MarioStar78 folded on the Turn
Seat 3: NKGOK (button) folded on the Flop
Seat 4: w.m.58 (small blind) folded before Flop
Seat 5: lawlex_2 (big blind) folded before Flop
Seat 6: NandoEstrela collected ($0.43)



PokerStars Hand #213801586261:  Hold'em No Limit ($0.01/$0.02 USD) - 2020/05/13 19:14:36 MSK [2020/05/13 12:14:36 ET]
Table 'Seginus III' 6-max Seat #4 is the button
Seat 1: MarioStar78 ($1.71 in chips) 
Seat 3: NKGOK ($1.97 in chips) 
Seat 4: w.m.58 ($0.72 in chips) 
Seat 5: lawlex_2 ($2.27 in chips) 
Seat 6: NandoEstrela ($2.44 in chips) 
lawlex_2: posts small blind $0.01
NandoEstrela: posts big blind $0.02
vladbratuha: sits out 
*** HOLE CARDS ***
Dealt to lawlex_2 [Ad 7c]
MarioStar78: folds 
NKGOK: raises $0.02 to $0.04
w.m.58: calls $0.04
lawlex_2: folds 
NandoEstrela: folds 
*** FLOP *** [5s 8d 4d]
NKGOK: checks 
w.m.58: bets $0.02
NKGOK: calls $0.02
*** TURN *** [5s 8d 4d] [Qh]
NKGOK: checks 
w.m.58: bets $0.02
NKGOK: raises $0.18 to $0.20
w.m.58: folds 
Uncalled bet ($0.18) returned to NKGOK
NKGOK collected $0.18 from pot
*** SUMMARY ***
Total pot $0.19 | Rake $0.01 
Board [5s 8d 4d Qh]
Seat 1: MarioStar78 folded before Flop (didn't bet)
Seat 3: NKGOK collected ($0.18)
Seat 4: w.m.58 (button) folded on the Turn
Seat 5: lawlex_2 (small blind) folded before Flop
Seat 6: NandoEstrela (big blind) folded before Flop



PokerStars Hand #213801608405:  Hold'em No Limit ($0.01/$0.02 USD) - 2020/05/13 19:15:05 MSK [2020/05/13 12:15:05 ET]
Table 'Seginus III' 6-max Seat #5 is the button
Seat 1: MarioStar78 ($1.71 in chips) 
Seat 3: NKGOK ($2.07 in chips) 
Seat 4: w.m.58 ($0.64 in chips) 
Seat 5: lawlex_2 ($2.26 in chips) 
Seat 6: NandoEstrela ($2.42 in chips) 
NandoEstrela: posts small blind $0.01
MarioStar78: posts big blind $0.02
vladbratuha: sits out 
*** HOLE CARDS ***
Dealt to lawlex_2 [Kd 7d]
NKGOK: raises $0.02 to $0.04
w.m.58: folds 
lawlex_2: folds 
NandoEstrela: folds 
MarioStar78: calls $0.02
*** FLOP *** [As Th 6d]
MarioStar78: checks 
NKGOK: bets $0.08
MarioStar78: folds 
Uncalled bet ($0.08) returned to NKGOK
NKGOK collected $0.09 from pot
*** SUMMARY ***
Total pot $0.09 | Rake $0 
Board [As Th 6d]
Seat 1: MarioStar78 (big blind) folded on the Flop
Seat 3: NKGOK collected ($0.09)
Seat 4: w.m.58 folded before Flop (didn't bet)
Seat 5: lawlex_2 (button) folded before Flop (didn't bet)
Seat 6: NandoEstrela (small blind) folded before Flop



PokerStars Hand #213801627274:  Hold'em No Limit ($0.01/$0.02 USD) - 2020/05/13 19:15:29 MSK [2020/05/13 12:15:29 ET]
Table 'Seginus III' 6-max Seat #6 is the button
Seat 1: MarioStar78 ($1.67 in chips) 
Seat 2: vladbratuha ($2 in chips) 
Seat 3: NKGOK ($2.12 in chips) 
Seat 4: w.m.58 ($0.64 in chips) 
Seat 5: lawlex_2 ($2.26 in chips) 
Seat 6: NandoEstrela ($2.41 in chips) 
MarioStar78: posts small blind $0.01
vladbratuha: posts big blind $0.02
*** HOLE CARDS ***
Dealt to lawlex_2 [5d 9c]
NKGOK: folds 
w.m.58: calls $0.02
lawlex_2: folds 
NandoEstrela: folds 
MarioStar78: folds 
vladbratuha: checks 
*** FLOP *** [Qh Qd 8s]
vladbratuha: checks 
w.m.58: bets $0.02
vladbratuha: folds 
Uncalled bet ($0.02) returned to w.m.58
w.m.58 collected $0.05 from pot
*** SUMMARY ***
Total pot $0.05 | Rake $0 
Board [Qh Qd 8s]
Seat 1: MarioStar78 (small blind) folded before Flop
Seat 2: vladbratuha (big blind) folded on the Flop
Seat 3: NKGOK folded before Flop (didn't bet)
Seat 4: w.m.58 collected ($0.05)
Seat 5: lawlex_2 folded before Flop (didn't bet)
Seat 6: NandoEstrela (button) folded before Flop (didn't bet)



PokerStars Hand #213801644338:  Hold'em No Limit ($0.01/$0.02 USD) - 2020/05/13 19:15:51 MSK [2020/05/13 12:15:51 ET]
Table 'Seginus III' 6-max Seat #1 is the button
Seat 1: MarioStar78 ($1.66 in chips) 
Seat 2: vladbratuha ($2 in chips) 
Seat 3: NKGOK ($2.12 in chips) 
Seat 4: w.m.58 ($0.67 in chips) 
Seat 5: lawlex_2 ($2.26 in chips) 
Seat 6: NandoEstrela ($2.41 in chips) 
vladbratuha: posts small blind $0.01
NKGOK: posts big blind $0.02
*** HOLE CARDS ***
Dealt to lawlex_2 [Kd Td]
w.m.58: calls $0.02
lawlex_2: raises $0.03 to $0.05
NandoEstrela: folds 
MarioStar78: folds 
vladbratuha: folds 
NKGOK has timed out
NKGOK: folds 
w.m.58: calls $0.03
*** FLOP *** [9c 6d Tc]
w.m.58: bets $0.02
lawlex_2: raises $0.11 to $0.13
w.m.58: calls $0.11
*** TURN *** [9c 6d Tc] [Jh]
w.m.58: bets $0.02
lawlex_2: raises $0.21 to $0.23
w.m.58: folds 
Uncalled bet ($0.21) returned to lawlex_2
lawlex_2 collected $0.41 from pot
lawlex_2: doesn't show hand 
*** SUMMARY ***
Total pot $0.43 | Rake $0.02 
Board [9c 6d Tc Jh]
Seat 1: MarioStar78 (button) folded before Flop (didn't bet)
Seat 2: vladbratuha (small blind) folded before Flop
Seat 3: NKGOK (big blind) folded before Flop
Seat 4: w.m.58 folded on the Turn
Seat 5: lawlex_2 collected ($0.41)
Seat 6: NandoEstrela folded before Flop (didn't bet)



PokerStars Hand #213801700380:  Hold'em No Limit ($0.01/$0.02 USD) - 2020/05/13 19:17:04 MSK [2020/05/13 12:17:04 ET]
Table 'Seginus III' 6-max Seat #2 is the button
Seat 1: MarioStar78 ($1.66 in chips) 
Seat 2: vladbratuha ($2 in chips) 
Seat 4: w.m.58 ($0.47 in chips) 
Seat 5: lawlex_2 ($2.47 in chips) 
Seat 6: NandoEstrela ($2.41 in chips) 
w.m.58: posts small blind $0.01
lawlex_2: posts big blind $0.02
*** HOLE CARDS ***
Dealt to lawlex_2 [9h Tc]
NandoEstrela: folds 
MarioStar78: folds 
vladbratuha: folds 
w.m.58: raises $0.04 to $0.06
lawlex_2: folds 
Uncalled bet ($0.04) returned to w.m.58
w.m.58 collected $0.04 from pot
*** SUMMARY ***
Total pot $0.04 | Rake $0 
Seat 1: MarioStar78 folded before Flop (didn't bet)
Seat 2: vladbratuha (button) folded before Flop (didn't bet)
Seat 4: w.m.58 (small blind) collected ($0.04)
Seat 5: lawlex_2 (big blind) folded before Flop
Seat 6: NandoEstrela folded before Flop (didn't bet)



PokerStars Hand #213801709322:  Hold'em No Limit ($0.01/$0.02 USD) - 2020/05/13 19:17:16 MSK [2020/05/13 12:17:16 ET]
Table 'Seginus III' 6-max Seat #4 is the button
Seat 1: MarioStar78 ($1.66 in chips) 
Seat 2: vladbratuha ($2 in chips) 
Seat 4: w.m.58 ($0.49 in chips) 
Seat 5: lawlex_2 ($2.45 in chips) 
Seat 6: NandoEstrela ($2.41 in chips) 
lawlex_2: posts small blind $0.01
NandoEstrela: posts big blind $0.02
*** HOLE CARDS ***
Dealt to lawlex_2 [Ts Jd]
MarioStar78: folds 
vladbratuha: folds 
w.m.58: calls $0.02
lawlex_2: raises $0.03 to $0.05
NandoEstrela: calls $0.03
w.m.58: calls $0.03
*** FLOP *** [Qh Ad 4c]
lawlex_2: checks 
NandoEstrela: bets $0.06
w.m.58: calls $0.06
lawlex_2: folds 
*** TURN *** [Qh Ad 4c] [2c]
NandoEstrela: checks 
w.m.58: bets $0.02
NandoEstrela: calls $0.02
*** RIVER *** [Qh Ad 4c 2c] [Ks]
NandoEstrela: checks 
w.m.58: checks 
*** SHOW DOWN ***
NandoEstrela: shows [7h 7c] (a pair of Sevens)
w.m.58: shows [Qc 3d] (a pair of Queens)
w.m.58 collected $0.30 from pot
*** SUMMARY ***
Total pot $0.31 | Rake $0.01 
Board [Qh Ad 4c 2c Ks]
Seat 1: MarioStar78 folded before Flop (didn't bet)
Seat 2: vladbratuha folded before Flop (didn't bet)
Seat 4: w.m.58 (button) showed [Qc 3d] and won ($0.30) with a pair of Queens
Seat 5: lawlex_2 (small blind) folded on the Flop
Seat 6: NandoEstrela (big blind) showed [7h 7c] and lost with a pair of Sevens



PokerStars Hand #213801748127:  Hold'em No Limit ($0.01/$0.02 USD) - 2020/05/13 19:18:06 MSK [2020/05/13 12:18:06 ET]
Table 'Seginus III' 6-max Seat #5 is the button
Seat 1: MarioStar78 ($1.66 in chips) 
Seat 2: vladbratuha ($2 in chips) 
Seat 3: NKGOK ($2.10 in chips) 
Seat 4: w.m.58 ($0.66 in chips) 
Seat 5: lawlex_2 ($2.40 in chips) 
Seat 6: NandoEstrela ($2.28 in chips) 
NandoEstrela: posts small blind $0.01
MarioStar78: posts big blind $0.02
NKGOK: posts small blind $0.01
*** HOLE CARDS ***
Dealt to lawlex_2 [6c 4c]
vladbratuha: raises $0.04 to $0.06
NKGOK: folds 
w.m.58: folds 
lawlex_2: folds 
NandoEstrela: raises $0.12 to $0.18
MarioStar78: folds 
vladbratuha: raises $0.36 to $0.54
NandoEstrela: calls $0.36
*** FLOP *** [3h Tc 9h]
NandoEstrela: checks 
vladbratuha: bets $0.60
NandoEstrela: raises $1.14 to $1.74 and is all-in
vladbratuha: calls $0.86 and is all-in
Uncalled bet ($0.28) returned to NandoEstrela
*** TURN *** [3h Tc 9h] [7h]
*** RIVER *** [3h Tc 9h 7h] [Ah]
*** SHOW DOWN ***
NandoEstrela: shows [Js Jc] (a pair of Jacks)
vladbratuha: shows [Kc Kd] (a pair of Kings)
vladbratuha collected $3.89 from pot
*** SUMMARY ***
Total pot $4.03 | Rake $0.14 
Board [3h Tc 9h 7h Ah]
Seat 1: MarioStar78 (big blind) folded before Flop
Seat 2: vladbratuha showed [Kc Kd] and won ($3.89) with a pair of Kings
Seat 3: NKGOK folded before Flop (didn't bet)
Seat 4: w.m.58 folded before Flop (didn't bet)
Seat 5: lawlex_2 (button) folded before Flop (didn't bet)
Seat 6: NandoEstrela (small blind) showed [Js Jc] and lost with a pair of Jacks



PokerStars Hand #213801792972:  Hold'em No Limit ($0.01/$0.02 USD) - 2020/05/13 19:19:04 MSK [2020/05/13 12:19:04 ET]
Table 'Seginus III' 6-max Seat #6 is the button
Seat 1: MarioStar78 ($1.64 in chips) 
Seat 2: vladbratuha ($3.89 in chips) 
Seat 3: NKGOK ($2.09 in chips) 
Seat 4: w.m.58 ($0.66 in chips) 
Seat 5: lawlex_2 ($2.40 in chips) 
Seat 6: NandoEstrela ($2 in chips) 
MarioStar78: posts small blind $0.01
vladbratuha: posts big blind $0.02
*** HOLE CARDS ***
Dealt to lawlex_2 [5s 7d]
NKGOK: raises $0.02 to $0.04
w.m.58: folds 
lawlex_2: folds 
NandoEstrela: folds 
MarioStar78: calls $0.03
vladbratuha: folds 
*** FLOP *** [3h Kh Kc]
MarioStar78: bets $0.04
NKGOK: folds 
Uncalled bet ($0.04) returned to MarioStar78
MarioStar78 collected $0.10 from pot
MarioStar78: doesn't show hand 
*** SUMMARY ***
Total pot $0.10 | Rake $0 
Board [3h Kh Kc]
Seat 1: MarioStar78 (small blind) collected ($0.10)
Seat 2: vladbratuha (big blind) folded before Flop
Seat 3: NKGOK folded on the Flop
Seat 4: w.m.58 folded before Flop (didn't bet)
Seat 5: lawlex_2 folded before Flop (didn't bet)
Seat 6: NandoEstrela (button) folded before Flop (didn't bet)



PokerStars Hand #213801816024:  Hold'em No Limit ($0.01/$0.02 USD) - 2020/05/13 19:19:34 MSK [2020/05/13 12:19:34 ET]
Table 'Seginus III' 6-max Seat #1 is the button
Seat 1: MarioStar78 ($1.70 in chips) 
Seat 2: vladbratuha ($3.87 in chips) 
Seat 3: NKGOK ($2.05 in chips) 
Seat 4: w.m.58 ($0.66 in chips) 
Seat 5: lawlex_2 ($2.40 in chips) 
Seat 6: NandoEstrela ($2 in chips) 
vladbratuha: posts small blind $0.01
NKGOK: posts big blind $0.02
*** HOLE CARDS ***
Dealt to lawlex_2 [6h Qs]
w.m.58: calls $0.02
lawlex_2: folds 
NandoEstrela: folds 
MarioStar78: raises $0.02 to $0.04
vladbratuha: folds 
NKGOK: folds 
w.m.58: raises $0.06 to $0.10
MarioStar78: folds 
Uncalled bet ($0.06) returned to w.m.58
w.m.58 collected $0.11 from pot
*** SUMMARY ***
Total pot $0.11 | Rake $0 
Seat 1: MarioStar78 (button) folded before Flop
Seat 2: vladbratuha (small blind) folded before Flop
Seat 3: NKGOK (big blind) folded before Flop
Seat 4: w.m.58 collected ($0.11)
Seat 5: lawlex_2 folded before Flop (didn't bet)
Seat 6: NandoEstrela folded before Flop (didn't bet)



PokerStars Hand #213801834237:  Hold'em No Limit ($0.01/$0.02 USD) - 2020/05/13 19:19:58 MSK [2020/05/13 12:19:58 ET]
Table 'Seginus III' 6-max Seat #2 is the button
Seat 1: MarioStar78 ($1.66 in chips) 
Seat 2: vladbratuha ($3.86 in chips) 
Seat 3: NKGOK ($2.03 in chips) 
Seat 4: w.m.58 ($0.73 in chips) 
Seat 5: lawlex_2 ($2.40 in chips) 
Seat 6: NandoEstrela ($2 in chips) 
NKGOK: posts small blind $0.01
w.m.58: posts big blind $0.02
*** HOLE CARDS ***
Dealt to lawlex_2 [7c 2d]
lawlex_2: folds 
NandoEstrela: raises $0.04 to $0.06
MarioStar78: folds 
vladbratuha: folds 
NKGOK: calls $0.05
w.m.58: raises $0.60 to $0.66
NandoEstrela: raises $0.60 to $1.26
NKGOK: folds 
w.m.58: calls $0.07 and is all-in
Uncalled bet ($0.53) returned to NandoEstrela
w.m.58 has timed out
*** FLOP *** [3s 8h 5h]
*** TURN *** [3s 8h 5h] [8s]
*** RIVER *** [3s 8h 5h 8s] [9h]
*** SHOW DOWN ***
w.m.58: shows [Qc As] (a pair of Eights)
NandoEstrela: shows [Td Ad] (a pair of Eights - lower kicker)
w.m.58 collected $1.47 from pot
*** SUMMARY ***
Total pot $1.52 | Rake $0.05 
Board [3s 8h 5h 8s 9h]
Seat 1: MarioStar78 folded before Flop (didn't bet)
Seat 2: vladbratuha (button) folded before Flop (didn't bet)
Seat 3: NKGOK (small blind) folded before Flop
Seat 4: w.m.58 (big blind) showed [Qc As] and won ($1.47) with a pair of Eights
Seat 5: lawlex_2 folded before Flop (didn't bet)
Seat 6: NandoEstrela showed [Td Ad] and lost with a pair of Eights



PokerStars Hand #213801869153:  Hold'em No Limit ($0.01/$0.02 USD) - 2020/05/13 19:20:44 MSK [2020/05/13 12:20:44 ET]
Table 'Seginus III' 6-max Seat #3 is the button
Seat 1: MarioStar78 ($1.66 in chips) 
Seat 2: vladbratuha ($3.86 in chips) 
Seat 3: NKGOK ($1.97 in chips) 
Seat 4: w.m.58 ($1.47 in chips) 
Seat 5: lawlex_2 ($2.40 in chips) 
Seat 6: NandoEstrela ($2 in chips) 
w.m.58: posts small blind $0.01
lawlex_2: posts big blind $0.02
*** HOLE CARDS ***
Dealt to lawlex_2 [8s As]
NandoEstrela: folds 
MarioStar78: folds 
vladbratuha: folds 
NKGOK: folds 
w.m.58: calls $0.01
lawlex_2: checks 
*** FLOP *** [9c 4d Ah]
w.m.58: bets $0.02
lawlex_2: raises $0.05 to $0.07
w.m.58: calls $0.05
*** TURN *** [9c 4d Ah] [2c]
w.m.58: checks 
lawlex_2: bets $0.11
w.m.58: folds 
Uncalled bet ($0.11) returned to lawlex_2
lawlex_2 collected $0.17 from pot
lawlex_2: doesn't show hand 
*** SUMMARY ***
Total pot $0.18 | Rake $0.01 
Board [9c 4d Ah 2c]
Seat 1: MarioStar78 folded before Flop (didn't bet)
Seat 2: vladbratuha folded before Flop (didn't bet)
Seat 3: NKGOK (button) folded before Flop (didn't bet)
Seat 4: w.m.58 (small blind) folded on the Turn
Seat 5: lawlex_2 (big blind) collected ($0.17)
Seat 6: NandoEstrela folded before Flop (didn't bet)



PokerStars Hand #213801897330:  Hold'em No Limit ($0.01/$0.02 USD) - 2020/05/13 19:21:20 MSK [2020/05/13 12:21:20 ET]
Table 'Seginus III' 6-max Seat #4 is the button
Seat 1: MarioStar78 ($1.66 in chips) 
Seat 2: vladbratuha ($3.86 in chips) 
Seat 3: NKGOK ($1.97 in chips) 
Seat 4: w.m.58 ($1.38 in chips) 
Seat 5: lawlex_2 ($2.48 in chips) 
Seat 6: NandoEstrela ($2 in chips) 
lawlex_2: posts small blind $0.01
NandoEstrela: posts big blind $0.02
*** HOLE CARDS ***
Dealt to lawlex_2 [4s Jd]
MarioStar78: folds 
vladbratuha: folds 
NKGOK: folds 
w.m.58: calls $0.02
lawlex_2: folds 
NandoEstrela: checks 
*** FLOP *** [5d Td 6c]
NandoEstrela: checks 
w.m.58: bets $0.02
NandoEstrela: calls $0.02
*** TURN *** [5d Td 6c] [7h]
NandoEstrela: checks 
w.m.58: bets $0.02
NandoEstrela: calls $0.02
*** RIVER *** [5d Td 6c 7h] [3s]
NandoEstrela: checks 
w.m.58: bets $0.02
NandoEstrela: folds 
Uncalled bet ($0.02) returned to w.m.58
w.m.58 collected $0.13 from pot
*** SUMMARY ***
Total pot $0.13 | Rake $0 
Board [5d Td 6c 7h 3s]
Seat 1: MarioStar78 folded before Flop (didn't bet)
Seat 2: vladbratuha folded before Flop (didn't bet)
Seat 3: NKGOK folded before Flop (didn't bet)
Seat 4: w.m.58 (button) collected ($0.13)
Seat 5: lawlex_2 (small blind) folded before Flop
Seat 6: NandoEstrela (big blind) folded on the River



PokerStars Hand #213801933600:  Hold'em No Limit ($0.01/$0.02 USD) - 2020/05/13 19:21:58 MSK [2020/05/13 12:21:58 ET]
Table 'Seginus III' 6-max Seat #5 is the button
Seat 1: MarioStar78 ($1.66 in chips) 
Seat 2: vladbratuha ($3.86 in chips) 
Seat 3: NKGOK ($1.97 in chips) 
Seat 4: w.m.58 ($1.45 in chips) 
Seat 5: lawlex_2 ($2.47 in chips) 
Seat 6: NandoEstrela ($2 in chips) 
NandoEstrela: posts small blind $0.01
MarioStar78: posts big blind $0.02
*** HOLE CARDS ***
Dealt to lawlex_2 [Kc Th]
vladbratuha: folds 
NKGOK: calls $0.02
w.m.58: folds 
lawlex_2: raises $0.03 to $0.05
NandoEstrela: folds 
MarioStar78: folds 
NKGOK: calls $0.03
*** FLOP *** [8d Ac Tc]
NKGOK: checks 
lawlex_2: bets $0.09
NKGOK: calls $0.09
*** TURN *** [8d Ac Tc] [2d]
NKGOK: checks 
lawlex_2: bets $0.20
NKGOK: calls $0.20
*** RIVER *** [8d Ac Tc 2d] [6d]
NKGOK: bets $0.34
lawlex_2: folds 
Uncalled bet ($0.34) returned to NKGOK
NKGOK collected $0.69 from pot
*** SUMMARY ***
Total pot $0.71 | Rake $0.02 
Board [8d Ac Tc 2d 6d]
Seat 1: MarioStar78 (big blind) folded before Flop
Seat 2: vladbratuha folded before Flop (didn't bet)
Seat 3: NKGOK collected ($0.69)
Seat 4: w.m.58 folded before Flop (didn't bet)
Seat 5: lawlex_2 (button) folded on the River
Seat 6: NandoEstrela (small blind) folded before Flop



PokerStars Hand #213801961311:  Hold'em No Limit ($0.01/$0.02 USD) - 2020/05/13 19:22:35 MSK [2020/05/13 12:22:35 ET]
Table 'Seginus III' 6-max Seat #6 is the button
Seat 1: MarioStar78 ($1.64 in chips) 
Seat 2: vladbratuha ($3.86 in chips) 
Seat 3: NKGOK ($2.32 in chips) 
Seat 4: w.m.58 ($1.45 in chips) 
Seat 5: lawlex_2 ($2.13 in chips) 
Seat 6: NandoEstrela ($1.99 in chips) 
MarioStar78: posts small blind $0.01
vladbratuha: posts big blind $0.02
*** HOLE CARDS ***
Dealt to lawlex_2 [9c 8s]
NKGOK: folds 
w.m.58: calls $0.02
lawlex_2: folds 
NandoEstrela: raises $0.04 to $0.06
MarioStar78: folds 
vladbratuha: folds 
w.m.58: calls $0.04
*** FLOP *** [8h 4c Jc]
w.m.58: checks 
NandoEstrela: bets $0.06
w.m.58: folds 
Uncalled bet ($0.06) returned to NandoEstrela
NandoEstrela collected $0.14 from pot
NandoEstrela: doesn't show hand 
*** SUMMARY ***
Total pot $0.15 | Rake $0.01 
Board [8h 4c Jc]
Seat 1: MarioStar78 (small blind) folded before Flop
Seat 2: vladbratuha (big blind) folded before Flop
Seat 3: NKGOK folded before Flop (didn't bet)
Seat 4: w.m.58 folded on the Flop
Seat 5: lawlex_2 folded before Flop (didn't bet)
Seat 6: NandoEstrela (button) collected ($0.14)



PokerStars Hand #213801979320:  Hold'em No Limit ($0.01/$0.02 USD) - 2020/05/13 19:22:58 MSK [2020/05/13 12:22:58 ET]
Table 'Seginus III' 6-max Seat #1 is the button
Seat 1: MarioStar78 ($1.63 in chips) 
Seat 2: vladbratuha ($3.84 in chips) 
Seat 3: NKGOK ($2.32 in chips) 
Seat 4: w.m.58 ($1.39 in chips) 
Seat 5: lawlex_2 ($2.13 in chips) 
Seat 6: NandoEstrela ($2.07 in chips) 
vladbratuha: posts small blind $0.01
NKGOK: posts big blind $0.02
*** HOLE CARDS ***
Dealt to lawlex_2 [Ks 5s]
w.m.58: folds 
lawlex_2: folds 
NandoEstrela: folds 
w.m.58 leaves the table
MarioStar78: calls $0.02
vladbratuha: folds 
NKGOK: checks 
*** FLOP *** [Kd 8d Kc]
NKGOK: checks 
MarioStar78: bets $0.02
NKGOK: folds 
Uncalled bet ($0.02) returned to MarioStar78
MarioStar78 collected $0.05 from pot
MarioStar78: doesn't show hand 
*** SUMMARY ***
Total pot $0.05 | Rake $0 
Board [Kd 8d Kc]
Seat 1: MarioStar78 (button) collected ($0.05)
Seat 2: vladbratuha (small blind) folded before Flop
Seat 3: NKGOK (big blind) folded on the Flop
Seat 4: w.m.58 folded before Flop (didn't bet)
Seat 5: lawlex_2 folded before Flop (didn't bet)
Seat 6: NandoEstrela folded before Flop (didn't bet)



PokerStars Hand #213801993199:  Hold'em No Limit ($0.01/$0.02 USD) - 2020/05/13 19:23:16 MSK [2020/05/13 12:23:16 ET]
Table 'Seginus III' 6-max Seat #2 is the button
Seat 1: MarioStar78 ($1.66 in chips) 
Seat 2: vladbratuha ($3.83 in chips) 
Seat 3: NKGOK ($2.30 in chips) 
Seat 5: lawlex_2 ($2.13 in chips) 
Seat 6: NandoEstrela ($2.07 in chips) 
NKGOK: posts small blind $0.01
lawlex_2: posts big blind $0.02
*** HOLE CARDS ***
Dealt to lawlex_2 [2c 3d]
NandoEstrela: folds 
MarioStar78: folds 
vladbratuha: raises $0.03 to $0.05
NKGOK: folds 
lawlex_2: folds 
Uncalled bet ($0.03) returned to vladbratuha
vladbratuha collected $0.05 from pot
vladbratuha: doesn't show hand 
*** SUMMARY ***
Total pot $0.05 | Rake $0 
Seat 1: MarioStar78 folded before Flop (didn't bet)
Seat 2: vladbratuha (button) collected ($0.05)
Seat 3: NKGOK (small blind) folded before Flop
Seat 5: lawlex_2 (big blind) folded before Flop
Seat 6: NandoEstrela folded before Flop (didn't bet)



PokerStars Hand #213802003374:  Hold'em No Limit ($0.01/$0.02 USD) - 2020/05/13 19:23:30 MSK [2020/05/13 12:23:30 ET]
Table 'Seginus III' 6-max Seat #3 is the button
Seat 1: MarioStar78 ($1.66 in chips) 
Seat 2: vladbratuha ($3.86 in chips) 
Seat 3: NKGOK ($2.29 in chips) 
Seat 5: lawlex_2 ($2.11 in chips) 
Seat 6: NandoEstrela ($2.07 in chips) 
lawlex_2: posts small blind $0.01
NandoEstrela: posts big blind $0.02
*** HOLE CARDS ***
Dealt to lawlex_2 [8h Td]
MarioStar78: calls $0.02
vladbratuha: raises $0.06 to $0.08
NKGOK: calls $0.08
lawlex_2: folds 
Alex 15073 joins the table at seat #4 
NandoEstrela: folds 
MarioStar78: folds 
*** FLOP *** [Ah Ts 9h]
vladbratuha: bets $0.15
NKGOK: folds 
Uncalled bet ($0.15) returned to vladbratuha
NKGOK leaves the table
vladbratuha collected $0.20 from pot
vladbratuha: doesn't show hand 
*** SUMMARY ***
Total pot $0.21 | Rake $0.01 
Board [Ah Ts 9h]
Seat 1: MarioStar78 folded before Flop
Seat 2: vladbratuha collected ($0.20)
Seat 3: NKGOK (button) folded on the Flop
Seat 5: lawlex_2 (small blind) folded before Flop
Seat 6: NandoEstrela (big blind) folded before Flop



PokerStars Hand #213802027076:  Hold'em No Limit ($0.01/$0.02 USD) - 2020/05/13 19:24:01 MSK [2020/05/13 12:24:01 ET]
Table 'Seginus III' 6-max Seat #5 is the button
Seat 1: MarioStar78 ($1.64 in chips) 
Seat 2: vladbratuha ($3.98 in chips) 
Seat 4: Alex 15073 ($1.33 in chips) 
Seat 5: lawlex_2 ($2.10 in chips) 
Seat 6: NandoEstrela ($2.05 in chips) 
NandoEstrela: posts small blind $0.01
MarioStar78: posts big blind $0.02
Alex 15073: posts big blind $0.02
*** HOLE CARDS ***
Dealt to lawlex_2 [2s 5d]
vladbratuha: raises $0.03 to $0.05
Alex 15073: calls $0.03
lawlex_2: folds 
NandoEstrela: calls $0.04
MarioStar78: calls $0.03
*** FLOP *** [8h 3d Qc]
NandoEstrela: checks 
MarioStar78: bets $0.06
vladbratuha: folds 
Alex 15073: folds 
NandoEstrela: raises $0.10 to $0.16
Paula21110 joins the table at seat #3 
MarioStar78: calls $0.10
*** TURN *** [8h 3d Qc] [7d]
NandoEstrela: bets $0.16
MarioStar78: calls $0.16
*** RIVER *** [8h 3d Qc 7d] [Kc]
NandoEstrela: bets $0.22
MarioStar78: raises $1.05 to $1.27 and is all-in
NandoEstrela: folds 
Uncalled bet ($1.05) returned to MarioStar78
MarioStar78 collected $1.24 from pot
MarioStar78: doesn't show hand 
*** SUMMARY ***
Total pot $1.28 | Rake $0.04 
Board [8h 3d Qc 7d Kc]
Seat 1: MarioStar78 (big blind) collected ($1.24)
Seat 2: vladbratuha folded on the Flop
Seat 4: Alex 15073 folded on the Flop
Seat 5: lawlex_2 (button) folded before Flop (didn't bet)
Seat 6: NandoEstrela (small blind) folded on the River



PokerStars Hand #213802077956:  Hold'em No Limit ($0.01/$0.02 USD) - 2020/05/13 19:25:07 MSK [2020/05/13 12:25:07 ET]
Table 'Seginus III' 6-max Seat #6 is the button
Seat 1: MarioStar78 ($2.29 in chips) 
Seat 2: vladbratuha ($3.93 in chips) 
Seat 4: Alex 15073 ($1.28 in chips) 
Seat 5: lawlex_2 ($2.10 in chips) 
Seat 6: NandoEstrela ($2 in chips) 
MarioStar78: posts small blind $0.01
vladbratuha: posts big blind $0.02
Paula21110: sits out 
*** HOLE CARDS ***
Dealt to lawlex_2 [Qc 9h]
Paula21110 leaves the table
Alex 15073: calls $0.02
lawlex_2: folds 
NandoEstrela: folds 
MarioStar78: calls $0.01
Pajeringa joins the table at seat #3 
vladbratuha: checks 
*** FLOP *** [Td 7h 4s]
MarioStar78: checks 
vladbratuha: checks 
Alex 15073: checks 
*** TURN *** [Td 7h 4s] [8h]
MarioStar78: checks 
vladbratuha: checks 
Alex 15073: checks 
*** RIVER *** [Td 7h 4s 8h] [8c]
MarioStar78: checks 
vladbratuha: checks 
Alex 15073: checks 
*** SHOW DOWN ***
MarioStar78: shows [Jd 4d] (two pair, Eights and Fours)
vladbratuha: mucks hand 
Alex 15073: shows [6s Ts] (two pair, Tens and Eights)
Alex 15073 collected $0.06 from pot
*** SUMMARY ***
Total pot $0.06 | Rake $0 
Board [Td 7h 4s 8h 8c]
Seat 1: MarioStar78 (small blind) showed [Jd 4d] and lost with two pair, Eights and Fours
Seat 2: vladbratuha (big blind) mucked [2d Jc]
Seat 4: Alex 15073 showed [6s Ts] and won ($0.06) with two pair, Tens and Eights
Seat 5: lawlex_2 folded before Flop (didn't bet)
Seat 6: NandoEstrela (button) folded before Flop (didn't bet)



PokerStars Hand #213802110940:  Hold'em No Limit ($0.01/$0.02 USD) - 2020/05/13 19:25:49 MSK [2020/05/13 12:25:49 ET]
Table 'Seginus III' 6-max Seat #1 is the button
Seat 1: MarioStar78 ($2.27 in chips) 
Seat 2: vladbratuha ($3.91 in chips) 
Seat 3: Pajeringa ($2 in chips) 
Seat 4: Alex 15073 ($1.32 in chips) 
Seat 5: lawlex_2 ($2.10 in chips) 
Seat 6: NandoEstrela ($2 in chips) 
vladbratuha: posts small blind $0.01
Pajeringa: posts big blind $0.02
*** HOLE CARDS ***
Dealt to lawlex_2 [7c Ah]
Alex 15073: folds 
lawlex_2: raises $0.03 to $0.05
NandoEstrela: folds 
MarioStar78: folds 
vladbratuha: folds 
Pajeringa: folds 
Uncalled bet ($0.03) returned to lawlex_2
lawlex_2 collected $0.05 from pot
lawlex_2: doesn't show hand 
*** SUMMARY ***
Total pot $0.05 | Rake $0 
Seat 1: MarioStar78 (button) folded before Flop (didn't bet)
Seat 2: vladbratuha (small blind) folded before Flop
Seat 3: Pajeringa (big blind) folded before Flop
Seat 4: Alex 15073 folded before Flop (didn't bet)
Seat 5: lawlex_2 collected ($0.05)
Seat 6: NandoEstrela folded before Flop (didn't bet)



PokerStars Hand #213802122017:  Hold'em No Limit ($0.01/$0.02 USD) - 2020/05/13 19:26:03 MSK [2020/05/13 12:26:03 ET]
Table 'Seginus III' 6-max Seat #2 is the button
Seat 1: MarioStar78 ($2.27 in chips) 
Seat 2: vladbratuha ($3.90 in chips) 
Seat 3: Pajeringa ($2 in chips) 
Seat 4: Alex 15073 ($1.32 in chips) 
Seat 5: lawlex_2 ($2.13 in chips) 
Seat 6: NandoEstrela ($2 in chips) 
Pajeringa: posts small blind $0.01
Alex 15073: posts big blind $0.02
*** HOLE CARDS ***
Dealt to lawlex_2 [2c 8c]
lawlex_2: folds 
NandoEstrela: raises $0.04 to $0.06
MarioStar78: folds 
vladbratuha: folds 
Pajeringa: folds 
Alex 15073: calls $0.04
*** FLOP *** [Qc 5s Qs]
Alex 15073: bets $0.02
NandoEstrela: raises $0.04 to $0.06
Alex 15073: calls $0.04
*** TURN *** [Qc 5s Qs] [3d]
Alex 15073: checks 
NandoEstrela: bets $0.08
Alex 15073: raises $0.08 to $0.16
NandoEstrela: raises $0.12 to $0.28
Alex 15073: raises $0.12 to $0.40
NandoEstrela: calls $0.12
*** RIVER *** [Qc 5s Qs 3d] [7c]
Alex 15073: bets $0.02
NandoEstrela: raises $0.40 to $0.42
Alex 15073: raises $0.38 to $0.80 and is all-in
NandoEstrela: calls $0.38
*** SHOW DOWN ***
Alex 15073: shows [Kd Kh] (two pair, Kings and Queens)
NandoEstrela: shows [Qd Tc] (three of a kind, Queens)
NandoEstrela collected $2.56 from pot
*** SUMMARY ***
Total pot $2.65 | Rake $0.09 
Board [Qc 5s Qs 3d 7c]
Seat 1: MarioStar78 folded before Flop (didn't bet)
Seat 2: vladbratuha (button) folded before Flop (didn't bet)
Seat 3: Pajeringa (small blind) folded before Flop
Seat 4: Alex 15073 (big blind) showed [Kd Kh] and lost with two pair, Kings and Queens
Seat 5: lawlex_2 folded before Flop (didn't bet)
Seat 6: NandoEstrela showed [Qd Tc] and won ($2.56) with three of a kind, Queens



PokerStars Hand #213802178826:  Hold'em No Limit ($0.01/$0.02 USD) - 2020/05/13 19:27:15 MSK [2020/05/13 12:27:15 ET]
Table 'Seginus III' 6-max Seat #3 is the button
Seat 1: MarioStar78 ($2.27 in chips) 
Seat 2: vladbratuha ($3.90 in chips) 
Seat 3: Pajeringa ($2 in chips) 
Seat 5: lawlex_2 ($2.13 in chips) 
Seat 6: NandoEstrela ($3.24 in chips) 
lawlex_2: posts small blind $0.01
NandoEstrela: posts big blind $0.02
*** HOLE CARDS ***
Dealt to lawlex_2 [5s 3c]
MarioStar78: folds 
vladbratuha: folds 
Pajeringa: folds 
lawlex_2: folds 
Uncalled bet ($0.01) returned to NandoEstrela
NandoEstrela collected $0.02 from pot
NandoEstrela: doesn't show hand 
Alex 15073 leaves the table
*** SUMMARY ***
Total pot $0.02 | Rake $0 
Seat 1: MarioStar78 folded before Flop (didn't bet)
Seat 2: vladbratuha folded before Flop (didn't bet)
Seat 3: Pajeringa (button) folded before Flop (didn't bet)
Seat 5: lawlex_2 (small blind) folded before Flop
Seat 6: NandoEstrela (big blind) collected ($0.02)



PokerStars Hand #213802184876:  Hold'em No Limit ($0.01/$0.02 USD) - 2020/05/13 19:27:23 MSK [2020/05/13 12:27:23 ET]
Table 'Seginus III' 6-max Seat #5 is the button
Seat 1: MarioStar78 ($2.27 in chips) 
Seat 2: vladbratuha ($3.90 in chips) 
Seat 3: Pajeringa ($2 in chips) 
Seat 5: lawlex_2 ($2.12 in chips) 
Seat 6: NandoEstrela ($3.25 in chips) 
NandoEstrela: posts small blind $0.01
MarioStar78: posts big blind $0.02
*** HOLE CARDS ***
Dealt to lawlex_2 [9h Qd]
vladbratuha: folds 
Pajeringa: folds 
AVILEZ MATEU joins the table at seat #4 
lawlex_2: folds 
NandoEstrela: folds 
Uncalled bet ($0.01) returned to MarioStar78
MarioStar78 collected $0.02 from pot
MarioStar78: doesn't show hand 
*** SUMMARY ***
Total pot $0.02 | Rake $0 
Seat 1: MarioStar78 (big blind) collected ($0.02)
Seat 2: vladbratuha folded before Flop (didn't bet)
Seat 3: Pajeringa folded before Flop (didn't bet)
Seat 5: lawlex_2 (button) folded before Flop (didn't bet)
Seat 6: NandoEstrela (small blind) folded before Flop



PokerStars Hand #213802198158:  Hold'em No Limit ($0.01/$0.02 USD) - 2020/05/13 19:27:39 MSK [2020/05/13 12:27:39 ET]
Table 'Seginus III' 6-max Seat #6 is the button
Seat 1: MarioStar78 ($2.28 in chips) 
Seat 2: vladbratuha ($3.90 in chips) 
Seat 3: Pajeringa ($2 in chips) 
Seat 4: AVILEZ MATEU ($0.80 in chips) 
Seat 5: lawlex_2 ($2.12 in chips) 
Seat 6: NandoEstrela ($3.24 in chips) 
MarioStar78: posts small blind $0.01
vladbratuha: posts big blind $0.02
AVILEZ MATEU: posts big blind $0.02
*** HOLE CARDS ***
Dealt to lawlex_2 [Jh 5h]
Pajeringa: folds 
AVILEZ MATEU: checks 
lawlex_2: folds 
NandoEstrela: calls $0.02
MarioStar78: calls $0.01
vladbratuha: checks 
*** FLOP *** [Th Qh Td]
MarioStar78: checks 
vladbratuha: checks 
AVILEZ MATEU: checks 
NandoEstrela: checks 
*** TURN *** [Th Qh Td] [Kd]
MarioStar78: checks 
vladbratuha: checks 
AVILEZ MATEU: checks 
NandoEstrela: checks 
*** RIVER *** [Th Qh Td Kd] [Ah]
MarioStar78: checks 
vladbratuha: checks 
AVILEZ MATEU: checks 
NandoEstrela: bets $0.04
MarioStar78: folds 
vladbratuha: folds 
AVILEZ MATEU: folds 
Uncalled bet ($0.04) returned to NandoEstrela
NandoEstrela collected $0.08 from pot
NandoEstrela: doesn't show hand 
*** SUMMARY ***
Total pot $0.08 | Rake $0 
Board [Th Qh Td Kd Ah]
Seat 1: MarioStar78 (small blind) folded on the River
Seat 2: vladbratuha (big blind) folded on the River
Seat 3: Pajeringa folded before Flop (didn't bet)
Seat 4: AVILEZ MATEU folded on the River (didn't bet)
Seat 5: lawlex_2 folded before Flop (didn't bet)
Seat 6: NandoEstrela (button) collected ($0.08)



PokerStars Hand #213802249399:  Hold'em No Limit ($0.01/$0.02 USD) - 2020/05/13 19:28:44 MSK [2020/05/13 12:28:44 ET]
Table 'Seginus III' 6-max Seat #1 is the button
Seat 1: MarioStar78 ($2.26 in chips) 
Seat 2: vladbratuha ($3.88 in chips) 
Seat 3: Pajeringa ($2 in chips) 
Seat 4: AVILEZ MATEU ($0.78 in chips) 
Seat 5: lawlex_2 ($2.12 in chips) 
Seat 6: NandoEstrela ($3.30 in chips) 
vladbratuha: posts small blind $0.01
Pajeringa: posts big blind $0.02
*** HOLE CARDS ***
Dealt to lawlex_2 [2c Th]
AVILEZ MATEU: calls $0.02
lawlex_2: folds 
NandoEstrela: folds 
MarioStar78: raises $0.02 to $0.04
vladbratuha: folds 
Pajeringa: folds 
AVILEZ MATEU: calls $0.02
*** FLOP *** [Ks Qs Qd]
AVILEZ MATEU: checks 
MarioStar78: bets $0.02
AVILEZ MATEU: folds 
Uncalled bet ($0.02) returned to MarioStar78
MarioStar78 collected $0.11 from pot
MarioStar78: doesn't show hand 
*** SUMMARY ***
Total pot $0.11 | Rake $0 
Board [Ks Qs Qd]
Seat 1: MarioStar78 (button) collected ($0.11)
Seat 2: vladbratuha (small blind) folded before Flop
Seat 3: Pajeringa (big blind) folded before Flop
Seat 4: AVILEZ MATEU folded on the Flop
Seat 5: lawlex_2 folded before Flop (didn't bet)
Seat 6: NandoEstrela folded before Flop (didn't bet)



PokerStars Hand #213802268593:  Hold'em No Limit ($0.01/$0.02 USD) - 2020/05/13 19:29:08 MSK [2020/05/13 12:29:08 ET]
Table 'Seginus III' 6-max Seat #2 is the button
Seat 1: MarioStar78 ($2.33 in chips) 
Seat 2: vladbratuha ($3.87 in chips) 
Seat 3: Pajeringa ($2 in chips) 
Seat 4: AVILEZ MATEU ($0.74 in chips) 
Seat 5: lawlex_2 ($2.12 in chips) 
Seat 6: NandoEstrela ($3.30 in chips) 
Pajeringa: posts small blind $0.01
AVILEZ MATEU: posts big blind $0.02
*** HOLE CARDS ***
Dealt to lawlex_2 [9c Qh]
lawlex_2: folds 
NandoEstrela: raises $0.04 to $0.06
MarioStar78: folds 
vladbratuha: folds 
Pajeringa: folds 
AVILEZ MATEU: calls $0.04
*** FLOP *** [3c Tc 2s]
AVILEZ MATEU: checks 
NandoEstrela: bets $0.08
AVILEZ MATEU: calls $0.08
*** TURN *** [3c Tc 2s] [3d]
AVILEZ MATEU: checks 
NandoEstrela: bets $0.10
AVILEZ MATEU: calls $0.10
*** RIVER *** [3c Tc 2s 3d] [Qc]
AVILEZ MATEU: checks 
NandoEstrela: checks 
*** SHOW DOWN ***
AVILEZ MATEU: shows [Ah Jh] (a pair of Threes)
NandoEstrela: shows [7h 7s] (two pair, Sevens and Threes)
NandoEstrela collected $0.47 from pot
*** SUMMARY ***
Total pot $0.49 | Rake $0.02 
Board [3c Tc 2s 3d Qc]
Seat 1: MarioStar78 folded before Flop (didn't bet)
Seat 2: vladbratuha (button) folded before Flop (didn't bet)
Seat 3: Pajeringa (small blind) folded before Flop
Seat 4: AVILEZ MATEU (big blind) showed [Ah Jh] and lost with a pair of Threes
Seat 5: lawlex_2 folded before Flop (didn't bet)
Seat 6: NandoEstrela showed [7h 7s] and won ($0.47) with two pair, Sevens and Threes



PokerStars Hand #213802298656:  Hold'em No Limit ($0.01/$0.02 USD) - 2020/05/13 19:29:46 MSK [2020/05/13 12:29:46 ET]
Table 'Seginus III' 6-max Seat #3 is the button
Seat 1: MarioStar78 ($2.33 in chips) 
Seat 2: vladbratuha ($3.87 in chips) 
Seat 3: Pajeringa ($2 in chips) 
Seat 4: AVILEZ MATEU ($0.50 in chips) 
Seat 5: lawlex_2 ($2.12 in chips) 
Seat 6: NandoEstrela ($3.53 in chips) 
AVILEZ MATEU: posts small blind $0.01
lawlex_2: posts big blind $0.02
*** HOLE CARDS ***
Dealt to lawlex_2 [Ad 6d]
NandoEstrela: folds 
MarioStar78: folds 
vladbratuha: folds 
Pajeringa: folds 
AVILEZ MATEU: calls $0.01
lawlex_2: checks 
*** FLOP *** [8d 3h 2s]
AVILEZ MATEU: checks 
lawlex_2: bets $0.03
AVILEZ MATEU: folds 
Uncalled bet ($0.03) returned to lawlex_2
lawlex_2 collected $0.04 from pot
lawlex_2: doesn't show hand 
*** SUMMARY ***
Total pot $0.04 | Rake $0 
Board [8d 3h 2s]
Seat 1: MarioStar78 folded before Flop (didn't bet)
Seat 2: vladbratuha folded before Flop (didn't bet)
Seat 3: Pajeringa (button) folded before Flop (didn't bet)
Seat 4: AVILEZ MATEU (small blind) folded on the Flop
Seat 5: lawlex_2 (big blind) collected ($0.04)
Seat 6: NandoEstrela folded before Flop (didn't bet)



PokerStars Hand #213802332740:  Hold'em No Limit ($0.01/$0.02 USD) - 2020/05/13 19:30:28 MSK [2020/05/13 12:30:28 ET]
Table 'Seginus III' 6-max Seat #4 is the button
Seat 1: MarioStar78 ($2.33 in chips) 
Seat 2: vladbratuha ($3.87 in chips) 
Seat 3: Pajeringa ($2 in chips) 
Seat 4: AVILEZ MATEU ($0.48 in chips) 
Seat 5: lawlex_2 ($2.14 in chips) 
Seat 6: NandoEstrela ($3.53 in chips) 
lawlex_2: posts small blind $0.01
NandoEstrela: posts big blind $0.02
*** HOLE CARDS ***
Dealt to lawlex_2 [Qh 6h]
MarioStar78: folds 
vladbratuha: folds 
Pajeringa: folds 
AVILEZ MATEU: calls $0.02
lawlex_2: folds 
NandoEstrela: checks 
*** FLOP *** [Td 5h 3s]
NandoEstrela: checks 
AVILEZ MATEU: checks 
*** TURN *** [Td 5h 3s] [5d]
NandoEstrela: bets $0.04
AVILEZ MATEU: calls $0.04
*** RIVER *** [Td 5h 3s 5d] [6s]
NandoEstrela: bets $0.12
AVILEZ MATEU: calls $0.12
*** SHOW DOWN ***
NandoEstrela: shows [2h 4s] (a straight, Deuce to Six)
AVILEZ MATEU: mucks hand 
NandoEstrela collected $0.36 from pot
*** SUMMARY ***
Total pot $0.37 | Rake $0.01 
Board [Td 5h 3s 5d 6s]
Seat 1: MarioStar78 folded before Flop (didn't bet)
Seat 2: vladbratuha folded before Flop (didn't bet)
Seat 3: Pajeringa folded before Flop (didn't bet)
Seat 4: AVILEZ MATEU (button) mucked [Th 3d]
Seat 5: lawlex_2 (small blind) folded before Flop
Seat 6: NandoEstrela (big blind) showed [2h 4s] and won ($0.36) with a straight, Deuce to Six



PokerStars Hand #213802361503:  Hold'em No Limit ($0.01/$0.02 USD) - 2020/05/13 19:31:04 MSK [2020/05/13 12:31:04 ET]
Table 'Seginus III' 6-max Seat #5 is the button
Seat 1: MarioStar78 ($2.33 in chips) 
Seat 2: vladbratuha ($3.87 in chips) 
Seat 3: Pajeringa ($2 in chips) 
Seat 4: AVILEZ MATEU ($0.30 in chips) 
Seat 5: lawlex_2 ($2.13 in chips) 
Seat 6: NandoEstrela ($3.71 in chips) 
NandoEstrela: posts small blind $0.01
MarioStar78: posts big blind $0.02
*** HOLE CARDS ***
Dealt to lawlex_2 [9d Td]
vladbratuha: raises $0.04 to $0.06
Pajeringa: folds 
AVILEZ MATEU: calls $0.06
lawlex_2: calls $0.06
NandoEstrela: folds 
MarioStar78: calls $0.04
*** FLOP *** [Jc Jh Qd]
MarioStar78: checks 
vladbratuha: checks 
AVILEZ MATEU: checks 
lawlex_2: bets $0.16
MarioStar78: folds 
vladbratuha: folds 
AVILEZ MATEU: folds 
Uncalled bet ($0.16) returned to lawlex_2
lawlex_2 collected $0.24 from pot
lawlex_2: doesn't show hand 
*** SUMMARY ***
Total pot $0.25 | Rake $0.01 
Board [Jc Jh Qd]
Seat 1: MarioStar78 (big blind) folded on the Flop
Seat 2: vladbratuha folded on the Flop
Seat 3: Pajeringa folded before Flop (didn't bet)
Seat 4: AVILEZ MATEU folded on the Flop
Seat 5: lawlex_2 (button) collected ($0.24)
Seat 6: NandoEstrela (small blind) folded before Flop



PokerStars Hand #213802391456:  Hold'em No Limit ($0.01/$0.02 USD) - 2020/05/13 19:31:42 MSK [2020/05/13 12:31:42 ET]
Table 'Seginus III' 6-max Seat #6 is the button
Seat 1: MarioStar78 ($2.27 in chips) 
Seat 2: vladbratuha ($3.81 in chips) 
Seat 3: Pajeringa ($2 in chips) 
Seat 4: AVILEZ MATEU ($0.24 in chips) 
Seat 5: lawlex_2 ($2.31 in chips) 
Seat 6: NandoEstrela ($3.70 in chips) 
MarioStar78: posts small blind $0.01
vladbratuha: posts big blind $0.02
*** HOLE CARDS ***
Dealt to lawlex_2 [Ah Ts]
Pajeringa: folds 
AVILEZ MATEU: calls $0.02
lawlex_2: raises $0.03 to $0.05
NandoEstrela: folds 
MarioStar78: calls $0.04
vladbratuha: folds 
AVILEZ MATEU: calls $0.03
*** FLOP *** [6s 3h 6d]
MarioStar78: checks 
AVILEZ MATEU: checks 
lawlex_2: bets $0.11
MarioStar78: folds 
AVILEZ MATEU: calls $0.11
*** TURN *** [6s 3h 6d] [8d]
AVILEZ MATEU: checks 
lawlex_2: bets $0.08
AVILEZ MATEU: folds 
Uncalled bet ($0.08) returned to lawlex_2
lawlex_2 collected $0.38 from pot
lawlex_2: doesn't show hand 
*** SUMMARY ***
Total pot $0.39 | Rake $0.01 
Board [6s 3h 6d 8d]
Seat 1: MarioStar78 (small blind) folded on the Flop
Seat 2: vladbratuha (big blind) folded before Flop
Seat 3: Pajeringa folded before Flop (didn't bet)
Seat 4: AVILEZ MATEU folded on the Turn
Seat 5: lawlex_2 collected ($0.38)
Seat 6: NandoEstrela (button) folded before Flop (didn't bet)



PokerStars Hand #213802434799:  Hold'em No Limit ($0.01/$0.02 USD) - 2020/05/13 19:32:35 MSK [2020/05/13 12:32:35 ET]
Table 'Seginus III' 6-max Seat #1 is the button
Seat 1: MarioStar78 ($2.22 in chips) 
Seat 2: vladbratuha ($3.79 in chips) 
Seat 3: Pajeringa ($2 in chips) 
Seat 4: AVILEZ MATEU ($0.08 in chips) 
Seat 5: lawlex_2 ($2.53 in chips) 
Seat 6: NandoEstrela ($3.70 in chips) 
vladbratuha: posts small blind $0.01
Pajeringa: posts big blind $0.02
*** HOLE CARDS ***
Dealt to lawlex_2 [Ts 6s]
AVILEZ MATEU: calls $0.02
lawlex_2: folds 
NandoEstrela: folds 
MarioStar78: calls $0.02
vladbratuha: folds 
Pajeringa: checks 
*** FLOP *** [4s 5c 8d]
Pajeringa: checks 
AVILEZ MATEU: bets $0.06 and is all-in
MarioStar78: calls $0.06
Pajeringa: folds 
*** TURN *** [4s 5c 8d] [5d]
*** RIVER *** [4s 5c 8d 5d] [8c]
*** SHOW DOWN ***
AVILEZ MATEU: shows [5s Jc] (a full house, Fives full of Eights)
MarioStar78: shows [7c Ks] (two pair, Eights and Fives)
AVILEZ MATEU collected $0.18 from pot
*** SUMMARY ***
Total pot $0.19 | Rake $0.01 
Board [4s 5c 8d 5d 8c]
Seat 1: MarioStar78 (button) showed [7c Ks] and lost with two pair, Eights and Fives
Seat 2: vladbratuha (small blind) folded before Flop
Seat 3: Pajeringa (big blind) folded on the Flop
Seat 4: AVILEZ MATEU showed [5s Jc] and won ($0.18) with a full house, Fives full of Eights
Seat 5: lawlex_2 folded before Flop (didn't bet)
Seat 6: NandoEstrela folded before Flop (didn't bet)



PokerStars Hand #213802481759:  Hold'em No Limit ($0.01/$0.02 USD) - 2020/05/13 19:33:33 MSK [2020/05/13 12:33:33 ET]
Table 'Seginus III' 6-max Seat #2 is the button
Seat 1: MarioStar78 ($2.14 in chips) 
Seat 2: vladbratuha ($3.78 in chips) 
Seat 3: Pajeringa ($2 in chips) 
Seat 4: AVILEZ MATEU ($0.18 in chips) 
Seat 5: lawlex_2 ($2.53 in chips) 
Seat 6: NandoEstrela ($3.70 in chips) 
Pajeringa: posts small blind $0.01
AVILEZ MATEU: posts big blind $0.02
*** HOLE CARDS ***
Dealt to lawlex_2 [Ac Td]
lawlex_2: raises $0.03 to $0.05
NandoEstrela: folds 
MarioStar78: calls $0.05
vladbratuha: folds 
Pajeringa: folds 
AVILEZ MATEU: calls $0.03
*** FLOP *** [5d Js Kh]
AVILEZ MATEU: checks 
lawlex_2: bets $0.10
MarioStar78: calls $0.10
AVILEZ MATEU: folds 
*** TURN *** [5d Js Kh] [2h]
lawlex_2: bets $0.23
MarioStar78: calls $0.23
*** RIVER *** [5d Js Kh 2h] [6c]
lawlex_2: checks 
MarioStar78: checks 
*** SHOW DOWN ***
lawlex_2: shows [Ac Td] (high card Ace)
MarioStar78: shows [4c Kd] (a pair of Kings)
MarioStar78 collected $0.79 from pot
*** SUMMARY ***
Total pot $0.82 | Rake $0.03 
Board [5d Js Kh 2h 6c]
Seat 1: MarioStar78 showed [4c Kd] and won ($0.79) with a pair of Kings
Seat 2: vladbratuha (button) folded before Flop (didn't bet)
Seat 3: Pajeringa (small blind) folded before Flop
Seat 4: AVILEZ MATEU (big blind) folded on the Flop
Seat 5: lawlex_2 showed [Ac Td] and lost with high card Ace
Seat 6: NandoEstrela folded before Flop (didn't bet)



PokerStars Hand #213802522545:  Hold'em No Limit ($0.01/$0.02 USD) - 2020/05/13 19:34:13 MSK [2020/05/13 12:34:13 ET]
Table 'Seginus III' 6-max Seat #3 is the button
Seat 1: MarioStar78 ($2.55 in chips) 
Seat 2: vladbratuha ($3.78 in chips) 
Seat 3: Pajeringa ($2 in chips) 
Seat 4: AVILEZ MATEU ($0.13 in chips) 
Seat 5: lawlex_2 ($2.15 in chips) 
Seat 6: NandoEstrela ($3.70 in chips) 
AVILEZ MATEU: posts small blind $0.01
lawlex_2: posts big blind $0.02
*** HOLE CARDS ***
Dealt to lawlex_2 [Ts 4s]
NandoEstrela: folds 
MarioStar78: raises $0.04 to $0.06
vladbratuha: folds 
Pajeringa: calls $0.06
AVILEZ MATEU: calls $0.05
lawlex_2: folds 
*** FLOP *** [Qh Jc Td]
AVILEZ MATEU: checks 
MarioStar78: bets $0.04
Pajeringa: folds 
AVILEZ MATEU: calls $0.04
*** TURN *** [Qh Jc Td] [7h]
AVILEZ MATEU: checks 
MarioStar78: bets $0.08
AVILEZ MATEU: calls $0.03 and is all-in
Uncalled bet ($0.05) returned to MarioStar78
*** RIVER *** [Qh Jc Td 7h] [4h]
*** SHOW DOWN ***
AVILEZ MATEU: shows [Ad 3s] (high card Ace)
MarioStar78: shows [Qc Ah] (a pair of Queens)
MarioStar78 collected $0.33 from pot
AVILEZ MATEU cashed out the hand for $0.02
*** SUMMARY ***
Total pot $0.34 | Rake $0.01 
Board [Qh Jc Td 7h 4h]
Seat 1: MarioStar78 showed [Qc Ah] and won ($0.33) with a pair of Queens
Seat 2: vladbratuha folded before Flop (didn't bet)
Seat 3: Pajeringa (button) folded on the Flop
Seat 4: AVILEZ MATEU (small blind) showed [Ad 3s] and lost with high card Ace (cashed out).
Seat 5: lawlex_2 (big blind) folded before Flop
Seat 6: NandoEstrela folded before Flop (didn't bet)



PokerStars Hand #213802559789:  Hold'em No Limit ($0.01/$0.02 USD) - 2020/05/13 19:34:59 MSK [2020/05/13 12:34:59 ET]
Table 'Seginus III' 6-max Seat #4 is the button
Seat 1: MarioStar78 ($2.75 in chips) 
Seat 2: vladbratuha ($3.78 in chips) 
Seat 3: Pajeringa ($2 in chips) 
Seat 4: AVILEZ MATEU ($0.02 in chips) 
Seat 5: lawlex_2 ($2.13 in chips) 
lawlex_2: posts small blind $0.01
NandoEstrela: is sitting out 
MarioStar78: posts big blind $0.02
*** HOLE CARDS ***
Dealt to lawlex_2 [4s 8h]
vladbratuha: folds 
Pajeringa: raises $0.04 to $0.06
AVILEZ MATEU: calls $0.02 and is all-in
lawlex_2: folds 
MarioStar78: calls $0.04
*** FLOP *** [Js 5s Jh]
MarioStar78: checks 
Pajeringa: bets $0.05
MarioStar78: folds 
Uncalled bet ($0.05) returned to Pajeringa
*** TURN *** [Js 5s Jh] [7h]
*** RIVER *** [Js 5s Jh 7h] [5d]
*** SHOW DOWN ***
Pajeringa: shows [8d 8s] (two pair, Jacks and Eights)
Pajeringa collected $0.07 from side pot
AVILEZ MATEU: shows [2s Td] (two pair, Jacks and Fives)
Pajeringa collected $0.07 from main pot
*** SUMMARY ***
Total pot $0.15 Main pot $0.07. Side pot $0.07. | Rake $0.01 
Board [Js 5s Jh 7h 5d]
Seat 1: MarioStar78 (big blind) folded on the Flop
Seat 2: vladbratuha folded before Flop (didn't bet)
Seat 3: Pajeringa showed [8d 8s] and won ($0.14) with two pair, Jacks and Eights
Seat 4: AVILEZ MATEU (button) showed [2s Td] and lost with two pair, Jacks and Fives
Seat 5: lawlex_2 (small blind) folded before Flop



PokerStars Hand #213802592605:  Hold'em No Limit ($0.01/$0.02 USD) - 2020/05/13 19:35:40 MSK [2020/05/13 12:35:40 ET]
Table 'Seginus III' 6-max Seat #5 is the button
Seat 1: MarioStar78 ($2.69 in chips) 
Seat 2: vladbratuha ($3.78 in chips) 
Seat 3: Pajeringa ($2.08 in chips) 
Seat 5: lawlex_2 ($2.12 in chips) 
MarioStar78: posts small blind $0.01
vladbratuha: posts big blind $0.02
*** HOLE CARDS ***
Dealt to lawlex_2 [2d 9d]
Pajeringa: folds 
lawlex_2: folds 
MarioStar78: calls $0.01
vladbratuha: checks 
*** FLOP *** [Js 9s 3c]
MarioStar78: bets $0.02
vladbratuha: calls $0.02
*** TURN *** [Js 9s 3c] [2s]
NandoEstrela leaves the table
MarioStar78: bets $0.04
AVILEZ MATEU leaves the table
vladbratuha: calls $0.04
*** RIVER *** [Js 9s 3c 2s] [Th]
MarioStar78: checks 
vladbratuha: bets $0.10
MarioStar78: folds 
Uncalled bet ($0.10) returned to vladbratuha
vladbratuha collected $0.15 from pot
neesTY joins the table at seat #6 
vladbratuha: doesn't show hand 
*** SUMMARY ***
Total pot $0.16 | Rake $0.01 
Board [Js 9s 3c 2s Th]
Seat 1: MarioStar78 (small blind) folded on the River
Seat 2: vladbratuha (big blind) collected ($0.15)
Seat 3: Pajeringa folded before Flop (didn't bet)
Seat 5: lawlex_2 (button) folded before Flop (didn't bet)



PokerStars Hand #213802617467:  Hold'em No Limit ($0.01/$0.02 USD) - 2020/05/13 19:36:10 MSK [2020/05/13 12:36:10 ET]
Table 'Seginus III' 6-max Seat #1 is the button
Seat 1: MarioStar78 ($2.61 in chips) 
Seat 2: vladbratuha ($3.85 in chips) 
Seat 3: Pajeringa ($2.08 in chips) 
Seat 5: lawlex_2 ($2.12 in chips) 
vladbratuha: posts small blind $0.01
Pajeringa: posts big blind $0.02
neesTY: sits out 
*** HOLE CARDS ***
Dealt to lawlex_2 [6d 6s]
lawlex_2: raises $0.03 to $0.05
MarioStar78: folds 
AndrBye joins the table at seat #4 
vladbratuha: folds 
Pajeringa: folds 
Uncalled bet ($0.03) returned to lawlex_2
lawlex_2 collected $0.05 from pot
lawlex_2: doesn't show hand 
*** SUMMARY ***
Total pot $0.05 | Rake $0 
Seat 1: MarioStar78 (button) folded before Flop (didn't bet)
Seat 2: vladbratuha (small blind) folded before Flop
Seat 3: Pajeringa (big blind) folded before Flop
Seat 5: lawlex_2 collected ($0.05)



PokerStars Hand #213802626597:  Hold'em No Limit ($0.01/$0.02 USD) - 2020/05/13 19:36:22 MSK [2020/05/13 12:36:22 ET]
Table 'Seginus III' 6-max Seat #2 is the button
Seat 1: MarioStar78 ($2.61 in chips) 
Seat 2: vladbratuha ($3.84 in chips) 
Seat 3: Pajeringa ($2.06 in chips) 
Seat 4: AndrBye ($2 in chips) 
Seat 5: lawlex_2 ($2.15 in chips) 
Pajeringa: posts small blind $0.01
AndrBye: posts big blind $0.02
neesTY: sits out 
*** HOLE CARDS ***
Dealt to lawlex_2 [9c 5c]
lawlex_2: folds 
MarioStar78: calls $0.02
vladbratuha: folds 
Pajeringa: raises $0.08 to $0.10
AndrBye: folds 
MarioStar78: folds 
Uncalled bet ($0.08) returned to Pajeringa
Pajeringa collected $0.06 from pot
Pajeringa: doesn't show hand 
*** SUMMARY ***
Total pot $0.06 | Rake $0 
Seat 1: MarioStar78 folded before Flop
Seat 2: vladbratuha (button) folded before Flop (didn't bet)
Seat 3: Pajeringa (small blind) collected ($0.06)
Seat 4: AndrBye (big blind) folded before Flop
Seat 5: lawlex_2 folded before Flop (didn't bet)



PokerStars Hand #213802645667:  Hold'em No Limit ($0.01/$0.02 USD) - 2020/05/13 19:36:45 MSK [2020/05/13 12:36:45 ET]
Table 'Seginus III' 6-max Seat #3 is the button
Seat 1: MarioStar78 ($2.59 in chips) 
Seat 2: vladbratuha ($3.84 in chips) 
Seat 3: Pajeringa ($2.10 in chips) 
Seat 4: AndrBye ($2 in chips) 
Seat 5: lawlex_2 ($2.15 in chips) 
AndrBye: posts small blind $0.01
lawlex_2: posts big blind $0.02
neesTY: sits out 
*** HOLE CARDS ***
Dealt to lawlex_2 [3c Jc]
MarioStar78: raises $0.02 to $0.04
vladbratuha: folds 
Pajeringa: folds 
AndrBye: folds 
lawlex_2: folds 
Uncalled bet ($0.02) returned to MarioStar78
MarioStar78 collected $0.05 from pot
MarioStar78: doesn't show hand 
*** SUMMARY ***
Total pot $0.05 | Rake $0 
Seat 1: MarioStar78 collected ($0.05)
Seat 2: vladbratuha folded before Flop (didn't bet)
Seat 3: Pajeringa (button) folded before Flop (didn't bet)
Seat 4: AndrBye (small blind) folded before Flop
Seat 5: lawlex_2 (big blind) folded before Flop



PokerStars Hand #213802657976:  Hold'em No Limit ($0.01/$0.02 USD) - 2020/05/13 19:37:00 MSK [2020/05/13 12:37:00 ET]
Table 'Seginus III' 6-max Seat #4 is the button
Seat 1: MarioStar78 ($2.62 in chips) 
Seat 2: vladbratuha ($3.84 in chips) 
Seat 3: Pajeringa ($2.10 in chips) 
Seat 4: AndrBye ($2 in chips) 
Seat 5: lawlex_2 ($2.13 in chips) 
Seat 6: neesTY ($2 in chips) 
lawlex_2: posts small blind $0.01
neesTY: posts big blind $0.02
*** HOLE CARDS ***
Dealt to lawlex_2 [Js 5c]
MarioStar78: folds 
vladbratuha: folds 
Pajeringa: raises $0.04 to $0.06
AndrBye: folds 
lawlex_2: folds 
neesTY: folds 
Uncalled bet ($0.04) returned to Pajeringa
Pajeringa collected $0.05 from pot
*** SUMMARY ***
Total pot $0.05 | Rake $0 
Seat 1: MarioStar78 folded before Flop (didn't bet)
Seat 2: vladbratuha folded before Flop (didn't bet)
Seat 3: Pajeringa collected ($0.05)
Seat 4: AndrBye (button) folded before Flop (didn't bet)
Seat 5: lawlex_2 (small blind) folded before Flop
Seat 6: neesTY (big blind) folded before Flop



PokerStars Hand #213802678386:  Hold'em No Limit ($0.01/$0.02 USD) - 2020/05/13 19:37:25 MSK [2020/05/13 12:37:25 ET]
Table 'Seginus III' 6-max Seat #5 is the button
Seat 1: MarioStar78 ($2.62 in chips) 
Seat 2: vladbratuha ($3.84 in chips) 
Seat 3: Pajeringa ($2.13 in chips) 
Seat 4: AndrBye ($2 in chips) 
Seat 5: lawlex_2 ($2.12 in chips) 
Seat 6: neesTY ($1.98 in chips) 
neesTY: posts small blind $0.01
MarioStar78: posts big blind $0.02
*** HOLE CARDS ***
Dealt to lawlex_2 [Qc 7d]
vladbratuha: folds 
Pajeringa: folds 
AndrBye: folds 
lawlex_2: folds 
neesTY: calls $0.01
MarioStar78: checks 
*** FLOP *** [6c 8h 3h]
neesTY: checks 
MarioStar78: bets $0.02
neesTY: calls $0.02
*** TURN *** [6c 8h 3h] [9d]
neesTY: checks 
MarioStar78: checks 
*** RIVER *** [6c 8h 3h 9d] [4h]
neesTY: checks 
MarioStar78: checks 
*** SHOW DOWN ***
neesTY: shows [7c 6s] (a pair of Sixes)
MarioStar78: mucks hand 
neesTY collected $0.08 from pot
*** SUMMARY ***
Total pot $0.08 | Rake $0 
Board [6c 8h 3h 9d 4h]
Seat 1: MarioStar78 (big blind) mucked [5h 5d]
Seat 2: vladbratuha folded before Flop (didn't bet)
Seat 3: Pajeringa folded before Flop (didn't bet)
Seat 4: AndrBye folded before Flop (didn't bet)
Seat 5: lawlex_2 (button) folded before Flop (didn't bet)
Seat 6: neesTY (small blind) showed [7c 6s] and won ($0.08) with a pair of Sixes



PokerStars Hand #213802753443:  Hold'em No Limit ($0.01/$0.02 USD) - 2020/05/13 19:38:58 MSK [2020/05/13 12:38:58 ET]
Table 'Seginus III' 6-max Seat #6 is the button
Seat 1: MarioStar78 ($2.58 in chips) 
Seat 2: vladbratuha ($3.84 in chips) 
Seat 3: Pajeringa ($2.13 in chips) 
Seat 4: AndrBye ($2 in chips) 
Seat 5: lawlex_2 ($2.12 in chips) 
Seat 6: neesTY ($2.02 in chips) 
MarioStar78: posts small blind $0.01
vladbratuha: posts big blind $0.02
*** HOLE CARDS ***
Dealt to lawlex_2 [Qs 9c]
Pajeringa: folds 
AndrBye: raises $0.03 to $0.05
lawlex_2: folds 
neesTY: folds 
MarioStar78: folds 
vladbratuha: folds 
Uncalled bet ($0.03) returned to AndrBye
AndrBye collected $0.05 from pot
AndrBye: doesn't show hand 
*** SUMMARY ***
Total pot $0.05 | Rake $0 
Seat 1: MarioStar78 (small blind) folded before Flop
Seat 2: vladbratuha (big blind) folded before Flop
Seat 3: Pajeringa folded before Flop (didn't bet)
Seat 4: AndrBye collected ($0.05)
Seat 5: lawlex_2 folded before Flop (didn't bet)
Seat 6: neesTY (button) folded before Flop (didn't bet)



PokerStars Hand #213802767043:  Hold'em No Limit ($0.01/$0.02 USD) - 2020/05/13 19:39:14 MSK [2020/05/13 12:39:14 ET]
Table 'Seginus III' 6-max Seat #1 is the button
Seat 1: MarioStar78 ($2.57 in chips) 
Seat 2: vladbratuha ($3.82 in chips) 
Seat 3: Pajeringa ($2.13 in chips) 
Seat 4: AndrBye ($2.03 in chips) 
Seat 5: lawlex_2 ($2.12 in chips) 
Seat 6: neesTY ($2.02 in chips) 
vladbratuha: posts small blind $0.01
Pajeringa: posts big blind $0.02
*** HOLE CARDS ***
Dealt to lawlex_2 [Qh 8s]
AndrBye: folds 
lawlex_2: folds 
neesTY: folds 
MarioStar78: calls $0.02
vladbratuha: raises $0.08 to $0.10
Pajeringa: folds 
MarioStar78: folds 
Uncalled bet ($0.08) returned to vladbratuha
vladbratuha collected $0.06 from pot
vladbratuha: doesn't show hand 
*** SUMMARY ***
Total pot $0.06 | Rake $0 
Seat 1: MarioStar78 (button) folded before Flop
Seat 2: vladbratuha (small blind) collected ($0.06)
Seat 3: Pajeringa (big blind) folded before Flop
Seat 4: AndrBye folded before Flop (didn't bet)
Seat 5: lawlex_2 folded before Flop (didn't bet)
Seat 6: neesTY folded before Flop (didn't bet)



PokerStars Hand #213802784877:  Hold'em No Limit ($0.01/$0.02 USD) - 2020/05/13 19:39:36 MSK [2020/05/13 12:39:36 ET]
Table 'Seginus III' 6-max Seat #2 is the button
Seat 1: MarioStar78 ($2.55 in chips) 
Seat 2: vladbratuha ($3.86 in chips) 
Seat 3: Pajeringa ($2.11 in chips) 
Seat 4: AndrBye ($2.03 in chips) 
Seat 5: lawlex_2 ($2.12 in chips) 
Seat 6: neesTY ($2.02 in chips) 
Pajeringa: posts small blind $0.01
AndrBye: posts big blind $0.02
*** HOLE CARDS ***
Dealt to lawlex_2 [5c 6s]
lawlex_2: folds 
neesTY: folds 
MarioStar78: raises $0.04 to $0.06
vladbratuha: calls $0.06
Pajeringa: folds 
AndrBye: folds 
*** FLOP *** [2c Ks Kd]
MarioStar78: bets $0.04
vladbratuha: calls $0.04
*** TURN *** [2c Ks Kd] [6d]
MarioStar78: bets $0.04
vladbratuha: calls $0.04
*** RIVER *** [2c Ks Kd 6d] [Td]
MarioStar78: bets $0.30
vladbratuha: folds 
Uncalled bet ($0.30) returned to MarioStar78
MarioStar78 collected $0.30 from pot
MarioStar78: doesn't show hand 
*** SUMMARY ***
Total pot $0.31 | Rake $0.01 
Board [2c Ks Kd 6d Td]
Seat 1: MarioStar78 collected ($0.30)
Seat 2: vladbratuha (button) folded on the River
Seat 3: Pajeringa (small blind) folded before Flop
Seat 4: AndrBye (big blind) folded before Flop
Seat 5: lawlex_2 folded before Flop (didn't bet)
Seat 6: neesTY folded before Flop (didn't bet)



PokerStars Hand #213802829486:  Hold'em No Limit ($0.01/$0.02 USD) - 2020/05/13 19:40:24 MSK [2020/05/13 12:40:24 ET]
Table 'Seginus III' 6-max Seat #3 is the button
Seat 1: MarioStar78 ($2.71 in chips) 
Seat 2: vladbratuha ($3.72 in chips) 
Seat 3: Pajeringa ($2.10 in chips) 
Seat 4: AndrBye ($2.01 in chips) 
Seat 5: lawlex_2 ($2.12 in chips) 
Seat 6: neesTY ($2.02 in chips) 
AndrBye: posts small blind $0.01
lawlex_2: posts big blind $0.02
*** HOLE CARDS ***
Dealt to lawlex_2 [4h 8d]
neesTY: calls $0.02
MarioStar78: folds 
vladbratuha: folds 
Pajeringa: folds 
AndrBye: calls $0.01
lawlex_2: checks 
*** FLOP *** [6h Ah Td]
AndrBye: checks 
lawlex_2: checks 
neesTY: checks 
*** TURN *** [6h Ah Td] [2d]
AndrBye: checks 
lawlex_2: checks 
neesTY: checks 
*** RIVER *** [6h Ah Td 2d] [3d]
AndrBye: checks 
lawlex_2: checks 
neesTY: checks 
*** SHOW DOWN ***
AndrBye: shows [Qh 6s] (a pair of Sixes)
lawlex_2: mucks hand 
neesTY: mucks hand 
AndrBye collected $0.06 from pot
*** SUMMARY ***
Total pot $0.06 | Rake $0 
Board [6h Ah Td 2d 3d]
Seat 1: MarioStar78 folded before Flop (didn't bet)
Seat 2: vladbratuha folded before Flop (didn't bet)
Seat 3: Pajeringa (button) folded before Flop (didn't bet)
Seat 4: AndrBye (small blind) showed [Qh 6s] and won ($0.06) with a pair of Sixes
Seat 5: lawlex_2 (big blind) mucked [4h 8d]
Seat 6: neesTY mucked [Qd Kh]



PokerStars Hand #213802866091:  Hold'em No Limit ($0.01/$0.02 USD) - 2020/05/13 19:41:08 MSK [2020/05/13 12:41:08 ET]
Table 'Seginus III' 6-max Seat #4 is the button
Seat 1: MarioStar78 ($2.71 in chips) 
Seat 2: vladbratuha ($3.72 in chips) 
Seat 3: Pajeringa ($2.10 in chips) 
Seat 4: AndrBye ($2.05 in chips) 
Seat 5: lawlex_2 ($2.10 in chips) 
Seat 6: neesTY ($2 in chips) 
lawlex_2: posts small blind $0.01
neesTY: posts big blind $0.02
*** HOLE CARDS ***
Dealt to lawlex_2 [Th Td]
MarioStar78: raises $0.02 to $0.04
vladbratuha: folds 
Pajeringa: folds 
AndrBye: folds 
lawlex_2: calls $0.03
neesTY: folds 
*** FLOP *** [Kh 8c 7h]
lawlex_2: checks 
MarioStar78: bets $0.04
lawlex_2: calls $0.04
*** TURN *** [Kh 8c 7h] [5s]
lawlex_2: checks 
MarioStar78: bets $0.06
lawlex_2: calls $0.06
*** RIVER *** [Kh 8c 7h 5s] [6c]
lawlex_2: bets $0.19
MarioStar78: calls $0.19
*** SHOW DOWN ***
lawlex_2: shows [Th Td] (a pair of Tens)
MarioStar78: shows [Kc Jd] (a pair of Kings)
MarioStar78 collected $0.66 from pot
*** SUMMARY ***
Total pot $0.68 | Rake $0.02 
Board [Kh 8c 7h 5s 6c]
Seat 1: MarioStar78 showed [Kc Jd] and won ($0.66) with a pair of Kings
Seat 2: vladbratuha folded before Flop (didn't bet)
Seat 3: Pajeringa folded before Flop (didn't bet)
Seat 4: AndrBye (button) folded before Flop (didn't bet)
Seat 5: lawlex_2 (small blind) showed [Th Td] and lost with a pair of Tens
Seat 6: neesTY (big blind) folded before Flop



PokerStars Hand #213802901181:  Hold'em No Limit ($0.01/$0.02 USD) - 2020/05/13 19:41:52 MSK [2020/05/13 12:41:52 ET]
Table 'Seginus III' 6-max Seat #5 is the button
Seat 1: MarioStar78 ($3.04 in chips) 
Seat 2: vladbratuha ($3.72 in chips) 
Seat 3: Pajeringa ($2.10 in chips) 
Seat 4: AndrBye ($2.05 in chips) 
Seat 5: lawlex_2 ($1.77 in chips) 
Seat 6: neesTY ($1.98 in chips) 
neesTY: posts small blind $0.01
MarioStar78: posts big blind $0.02
*** HOLE CARDS ***
Dealt to lawlex_2 [Jh Qc]
vladbratuha: folds 
Pajeringa: raises $0.04 to $0.06
AndrBye: folds 
lawlex_2: folds 
neesTY: folds 
MarioStar78: folds 
Uncalled bet ($0.04) returned to Pajeringa
Pajeringa collected $0.05 from pot
Pajeringa: doesn't show hand 
*** SUMMARY ***
Total pot $0.05 | Rake $0 
Seat 1: MarioStar78 (big blind) folded before Flop
Seat 2: vladbratuha folded before Flop (didn't bet)
Seat 3: Pajeringa collected ($0.05)
Seat 4: AndrBye folded before Flop (didn't bet)
Seat 5: lawlex_2 (button) folded before Flop (didn't bet)
Seat 6: neesTY (small blind) folded before Flop



PokerStars Hand #213802918974:  Hold'em No Limit ($0.01/$0.02 USD) - 2020/05/13 19:42:13 MSK [2020/05/13 12:42:13 ET]
Table 'Seginus III' 6-max Seat #6 is the button
Seat 1: MarioStar78 ($3.02 in chips) 
Seat 2: vladbratuha ($3.72 in chips) 
Seat 3: Pajeringa ($2.13 in chips) 
Seat 4: AndrBye ($2.05 in chips) 
Seat 5: lawlex_2 ($1.77 in chips) 
Seat 6: neesTY ($1.97 in chips) 
MarioStar78: posts small blind $0.01
vladbratuha: posts big blind $0.02
*** HOLE CARDS ***
Dealt to lawlex_2 [3s 3c]
Pajeringa: raises $0.04 to $0.06
AndrBye: folds 
lawlex_2: calls $0.06
neesTY: folds 
MarioStar78: calls $0.05
vladbratuha: folds 
*** FLOP *** [3h 8s As]
MarioStar78: checks 
Pajeringa: bets $0.05
lawlex_2: calls $0.05
MarioStar78: folds 
*** TURN *** [3h 8s As] [7c]
Pajeringa: bets $0.06
lawlex_2: calls $0.06
*** RIVER *** [3h 8s As 7c] [5h]
Pajeringa: bets $0.64
lawlex_2: calls $0.64
*** SHOW DOWN ***
Pajeringa: shows [Ts Ks] (high card Ace)
lawlex_2: shows [3s 3c] (three of a kind, Threes)
lawlex_2 collected $1.64 from pot
*** SUMMARY ***
Total pot $1.70 | Rake $0.06 
Board [3h 8s As 7c 5h]
Seat 1: MarioStar78 (small blind) folded on the Flop
Seat 2: vladbratuha (big blind) folded before Flop
Seat 3: Pajeringa showed [Ts Ks] and lost with high card Ace
Seat 4: AndrBye folded before Flop (didn't bet)
Seat 5: lawlex_2 showed [3s 3c] and won ($1.64) with three of a kind, Threes
Seat 6: neesTY (button) folded before Flop (didn't bet)



PokerStars Hand #213802976313:  Hold'em No Limit ($0.01/$0.02 USD) - 2020/05/13 19:43:24 MSK [2020/05/13 12:43:24 ET]
Table 'Seginus III' 6-max Seat #1 is the button
Seat 1: MarioStar78 ($2.96 in chips) 
Seat 2: vladbratuha ($3.70 in chips) 
Seat 4: AndrBye ($2.05 in chips) 
Seat 5: lawlex_2 ($2.60 in chips) 
Seat 6: neesTY ($1.97 in chips) 
vladbratuha: posts small blind $0.01
Pajeringa: is sitting out 
AndrBye: posts big blind $0.02
*** HOLE CARDS ***
Dealt to lawlex_2 [Ac 8s]
Pajeringa leaves the table
lawlex_2: raises $0.03 to $0.05
neesTY: folds 
MarioStar78: folds 
vladbratuha: folds 
AndrBye: folds 
Uncalled bet ($0.03) returned to lawlex_2
lawlex_2 collected $0.05 from pot
lawlex_2: doesn't show hand 
*** SUMMARY ***
Total pot $0.05 | Rake $0 
Seat 1: MarioStar78 (button) folded before Flop (didn't bet)
Seat 2: vladbratuha (small blind) folded before Flop
Seat 4: AndrBye (big blind) folded before Flop
Seat 5: lawlex_2 collected ($0.05)
Seat 6: neesTY folded before Flop (didn't bet)



PokerStars Hand #213802985391:  Hold'em No Limit ($0.01/$0.02 USD) - 2020/05/13 19:43:35 MSK [2020/05/13 12:43:35 ET]
Table 'Seginus III' 6-max Seat #2 is the button
Seat 1: MarioStar78 ($2.96 in chips) 
Seat 2: vladbratuha ($3.69 in chips) 
Seat 4: AndrBye ($2.03 in chips) 
Seat 5: lawlex_2 ($2.63 in chips) 
Seat 6: neesTY ($1.97 in chips) 
AndrBye: posts small blind $0.01
lawlex_2: posts big blind $0.02
*** HOLE CARDS ***
Dealt to lawlex_2 [Qc 9h]
Giocoso15 joins the table at seat #3 
neesTY: raises $0.04 to $0.06
MarioStar78: folds 
vladbratuha: calls $0.06
AndrBye: folds 
lawlex_2: folds 
*** FLOP *** [3c 7h 8s]
neesTY: checks 
vladbratuha: bets $0.11
neesTY: folds 
Uncalled bet ($0.11) returned to vladbratuha
vladbratuha collected $0.14 from pot
vladbratuha: doesn't show hand 
*** SUMMARY ***
Total pot $0.15 | Rake $0.01 
Board [3c 7h 8s]
Seat 1: MarioStar78 folded before Flop (didn't bet)
Seat 2: vladbratuha (button) collected ($0.14)
Seat 4: AndrBye (small blind) folded before Flop
Seat 5: lawlex_2 (big blind) folded before Flop
Seat 6: neesTY folded on the Flop



PokerStars Hand #213803011476:  Hold'em No Limit ($0.01/$0.02 USD) - 2020/05/13 19:44:07 MSK [2020/05/13 12:44:07 ET]
Table 'Seginus III' 6-max Seat #4 is the button
Seat 1: MarioStar78 ($2.96 in chips) 
Seat 2: vladbratuha ($3.77 in chips) 
Seat 3: Giocoso15 ($0.80 in chips) 
Seat 4: AndrBye ($2.02 in chips) 
Seat 5: lawlex_2 ($2.61 in chips) 
Seat 6: neesTY ($1.91 in chips) 
lawlex_2: posts small blind $0.01
neesTY: posts big blind $0.02
Giocoso15: posts big blind $0.02
*** HOLE CARDS ***
Dealt to lawlex_2 [3c 5h]
MarioStar78: folds 
vladbratuha: folds 
Giocoso15: checks 
AndrBye: folds 
lawlex_2: folds 
neesTY: checks 
*** FLOP *** [Ks 9d 3d]
neesTY: checks 
Giocoso15: checks 
*** TURN *** [Ks 9d 3d] [Qd]
neesTY: checks 
Giocoso15: checks 
*** RIVER *** [Ks 9d 3d Qd] [4c]
neesTY: checks 
Giocoso15: checks 
*** SHOW DOWN ***
neesTY: shows [Ac 3s] (a pair of Threes)
Giocoso15: mucks hand 
neesTY collected $0.05 from pot
*** SUMMARY ***
Total pot $0.05 | Rake $0 
Board [Ks 9d 3d Qd 4c]
Seat 1: MarioStar78 folded before Flop (didn't bet)
Seat 2: vladbratuha folded before Flop (didn't bet)
Seat 3: Giocoso15 mucked [5s 7h]
Seat 4: AndrBye (button) folded before Flop (didn't bet)
Seat 5: lawlex_2 (small blind) folded before Flop
Seat 6: neesTY (big blind) showed [Ac 3s] and won ($0.05) with a pair of Threes



PokerStars Hand #213803029399:  Hold'em No Limit ($0.01/$0.02 USD) - 2020/05/13 19:44:29 MSK [2020/05/13 12:44:29 ET]
Table 'Seginus III' 6-max Seat #5 is the button
Seat 1: MarioStar78 ($2.96 in chips) 
Seat 2: vladbratuha ($3.77 in chips) 
Seat 3: Giocoso15 ($0.78 in chips) 
Seat 4: AndrBye ($2.02 in chips) 
Seat 5: lawlex_2 ($2.60 in chips) 
Seat 6: neesTY ($1.94 in chips) 
neesTY: posts small blind $0.01
MarioStar78: posts big blind $0.02
*** HOLE CARDS ***
Dealt to lawlex_2 [Tc 3s]
vladbratuha: raises $0.04 to $0.06
Giocoso15: calls $0.06
AndrBye: folds 
lawlex_2: folds 
neesTY: folds 
MarioStar78: folds 
*** FLOP *** [7s 8c 8d]
vladbratuha: bets $0.07
Giocoso15: calls $0.07
*** TURN *** [7s 8c 8d] [Th]
vladbratuha: checks 
Giocoso15: checks 
*** RIVER *** [7s 8c 8d Th] [9h]
vladbratuha: bets $0.18
Giocoso15: calls $0.18
*** SHOW DOWN ***
vladbratuha: shows [Jc Ad] (a straight, Seven to Jack)
Giocoso15: mucks hand 
vladbratuha collected $0.63 from pot
*** SUMMARY ***
Total pot $0.65 | Rake $0.02 
Board [7s 8c 8d Th 9h]
Seat 1: MarioStar78 (big blind) folded before Flop
Seat 2: vladbratuha showed [Jc Ad] and won ($0.63) with a straight, Seven to Jack
Seat 3: Giocoso15 mucked [Kc 9d]
Seat 4: AndrBye folded before Flop (didn't bet)
Seat 5: lawlex_2 (button) folded before Flop (didn't bet)
Seat 6: neesTY (small blind) folded before Flop



PokerStars Hand #213803069163:  Hold'em No Limit ($0.01/$0.02 USD) - 2020/05/13 19:45:17 MSK [2020/05/13 12:45:17 ET]
Table 'Seginus III' 6-max Seat #6 is the button
Seat 1: MarioStar78 ($2.94 in chips) 
Seat 2: vladbratuha ($4.09 in chips) 
Seat 3: Giocoso15 ($0.47 in chips) 
Seat 4: AndrBye ($2.02 in chips) 
Seat 5: lawlex_2 ($2.60 in chips) 
Seat 6: neesTY ($1.93 in chips) 
MarioStar78: posts small blind $0.01
vladbratuha: posts big blind $0.02
*** HOLE CARDS ***
Dealt to lawlex_2 [6s 6h]
Giocoso15: folds 
AndrBye: raises $0.03 to $0.05
lawlex_2: calls $0.05
neesTY: folds 
MarioStar78: folds 
vladbratuha: folds 
*** FLOP *** [5h 9d Qc]
AndrBye: checks 
lawlex_2: checks 
*** TURN *** [5h 9d Qc] [Qh]
AndrBye: checks 
lawlex_2: checks 
*** RIVER *** [5h 9d Qc Qh] [Kh]
AndrBye: checks 
lawlex_2: checks 
*** SHOW DOWN ***
AndrBye: shows [As Jd] (a pair of Queens)
lawlex_2: shows [6s 6h] (two pair, Queens and Sixes)
lawlex_2 collected $0.13 from pot
*** SUMMARY ***
Total pot $0.13 | Rake $0 
Board [5h 9d Qc Qh Kh]
Seat 1: MarioStar78 (small blind) folded before Flop
Seat 2: vladbratuha (big blind) folded before Flop
Seat 3: Giocoso15 folded before Flop (didn't bet)
Seat 4: AndrBye showed [As Jd] and lost with a pair of Queens
Seat 5: lawlex_2 showed [6s 6h] and won ($0.13) with two pair, Queens and Sixes
Seat 6: neesTY (button) folded before Flop (didn't bet)



PokerStars Hand #213803114888:  Hold'em No Limit ($0.01/$0.02 USD) - 2020/05/13 19:46:13 MSK [2020/05/13 12:46:13 ET]
Table 'Seginus III' 6-max Seat #1 is the button
Seat 1: MarioStar78 ($2.93 in chips) 
Seat 2: vladbratuha ($4.07 in chips) 
Seat 3: Giocoso15 ($0.47 in chips) 
Seat 4: AndrBye ($2 in chips) 
Seat 5: lawlex_2 ($2.68 in chips) 
Seat 6: neesTY ($1.93 in chips) 
vladbratuha: posts small blind $0.01
Giocoso15: posts big blind $0.02
*** HOLE CARDS ***
Dealt to lawlex_2 [Ah Jc]
AndrBye: folds 
lawlex_2: raises $0.03 to $0.05
neesTY: folds 
MarioStar78: folds 
vladbratuha: folds 
Giocoso15: calls $0.03
*** FLOP *** [Td Ad 2s]
Giocoso15: checks 
lawlex_2: bets $0.07
Giocoso15: calls $0.07
*** TURN *** [Td Ad 2s] [Qd]
Giocoso15: checks 
lawlex_2: bets $0.16
Giocoso15: calls $0.16
*** RIVER *** [Td Ad 2s Qd] [Ac]
Giocoso15: checks 
lawlex_2: checks 
*** SHOW DOWN ***
Giocoso15: shows [5d 3h] (a pair of Aces)
lawlex_2: shows [Ah Jc] (three of a kind, Aces)
lawlex_2 collected $0.55 from pot
*** SUMMARY ***
Total pot $0.57 | Rake $0.02 
Board [Td Ad 2s Qd Ac]
Seat 1: MarioStar78 (button) folded before Flop (didn't bet)
Seat 2: vladbratuha (small blind) folded before Flop
Seat 3: Giocoso15 (big blind) showed [5d 3h] and lost with a pair of Aces
Seat 4: AndrBye folded before Flop (didn't bet)
Seat 5: lawlex_2 showed [Ah Jc] and won ($0.55) with three of a kind, Aces
Seat 6: neesTY folded before Flop (didn't bet)



PokerStars Hand #213803144077:  Hold'em No Limit ($0.01/$0.02 USD) - 2020/05/13 19:46:48 MSK [2020/05/13 12:46:48 ET]
Table 'Seginus III' 6-max Seat #2 is the button
Seat 1: MarioStar78 ($2.93 in chips) 
Seat 2: vladbratuha ($4.06 in chips) 
Seat 3: Giocoso15 ($0.19 in chips) 
Seat 4: AndrBye ($2 in chips) 
Seat 5: lawlex_2 ($2.95 in chips) 
Seat 6: neesTY ($1.93 in chips) 
Giocoso15: posts small blind $0.01
AndrBye: posts big blind $0.02
*** HOLE CARDS ***
Dealt to lawlex_2 [7h 8c]
lawlex_2: folds 
neesTY: folds 
MarioStar78: calls $0.02
vladbratuha: folds 
Giocoso15: calls $0.01
AndrBye: checks 
*** FLOP *** [6h 6c 9h]
Giocoso15: checks 
AndrBye: checks 
MarioStar78: checks 
*** TURN *** [6h 6c 9h] [2s]
Giocoso15: checks 
AndrBye: checks 
MarioStar78: checks 
*** RIVER *** [6h 6c 9h 2s] [4h]
Giocoso15: checks 
AndrBye: bets $0.04
MarioStar78: folds 
Giocoso15: folds 
Uncalled bet ($0.04) returned to AndrBye
AndrBye collected $0.06 from pot
AndrBye: doesn't show hand 
*** SUMMARY ***
Total pot $0.06 | Rake $0 
Board [6h 6c 9h 2s 4h]
Seat 1: MarioStar78 folded on the River
Seat 2: vladbratuha (button) folded before Flop (didn't bet)
Seat 3: Giocoso15 (small blind) folded on the River
Seat 4: AndrBye (big blind) collected ($0.06)
Seat 5: lawlex_2 folded before Flop (didn't bet)
Seat 6: neesTY folded before Flop (didn't bet)



PokerStars Hand #213803198634:  Hold'em No Limit ($0.01/$0.02 USD) - 2020/05/13 19:47:55 MSK [2020/05/13 12:47:55 ET]
Table 'Seginus III' 6-max Seat #3 is the button
Seat 1: MarioStar78 ($2.91 in chips) 
Seat 2: vladbratuha ($4.06 in chips) 
Seat 3: Giocoso15 ($0.17 in chips) 
Seat 4: AndrBye ($2.04 in chips) 
Seat 5: lawlex_2 ($2.95 in chips) 
Seat 6: neesTY ($1.93 in chips) 
AndrBye: posts small blind $0.01
lawlex_2: posts big blind $0.02
*** HOLE CARDS ***
Dealt to lawlex_2 [Jc 8c]
neesTY: folds 
MarioStar78: folds 
vladbratuha: folds 
Giocoso15: raises $0.15 to $0.17 and is all-in
AndrBye: folds 
lawlex_2: folds 
Uncalled bet ($0.15) returned to Giocoso15
Giocoso15 collected $0.05 from pot
Giocoso15: doesn't show hand 
*** SUMMARY ***
Total pot $0.05 | Rake $0 
Seat 1: MarioStar78 folded before Flop (didn't bet)
Seat 2: vladbratuha folded before Flop (didn't bet)
Seat 3: Giocoso15 (button) collected ($0.05)
Seat 4: AndrBye (small blind) folded before Flop
Seat 5: lawlex_2 (big blind) folded before Flop
Seat 6: neesTY folded before Flop (didn't bet)



PokerStars Hand #213803211032:  Hold'em No Limit ($0.01/$0.02 USD) - 2020/05/13 19:48:10 MSK [2020/05/13 12:48:10 ET]
Table 'Seginus III' 6-max Seat #4 is the button
Seat 1: MarioStar78 ($2.91 in chips) 
Seat 2: vladbratuha ($4.06 in chips) 
Seat 3: Giocoso15 ($0.20 in chips) 
Seat 4: AndrBye ($2.03 in chips) 
Seat 5: lawlex_2 ($2.93 in chips) 
Seat 6: neesTY ($1.93 in chips) 
lawlex_2: posts small blind $0.01
neesTY: posts big blind $0.02
*** HOLE CARDS ***
Dealt to lawlex_2 [5d 6d]
MarioStar78: raises $0.02 to $0.04
vladbratuha: calls $0.04
Giocoso15: folds 
AndrBye: folds 
lawlex_2: folds 
neesTY: folds 
*** FLOP *** [Ac 8h Qs]
MarioStar78: bets $0.04
vladbratuha: folds 
Uncalled bet ($0.04) returned to MarioStar78
MarioStar78 collected $0.11 from pot
MarioStar78: doesn't show hand 
*** SUMMARY ***
Total pot $0.11 | Rake $0 
Board [Ac 8h Qs]
Seat 1: MarioStar78 collected ($0.11)
Seat 2: vladbratuha folded on the Flop
Seat 3: Giocoso15 folded before Flop (didn't bet)
Seat 4: AndrBye (button) folded before Flop (didn't bet)
Seat 5: lawlex_2 (small blind) folded before Flop
Seat 6: neesTY (big blind) folded before Flop



PokerStars Hand #213803228510:  Hold'em No Limit ($0.01/$0.02 USD) - 2020/05/13 19:48:31 MSK [2020/05/13 12:48:31 ET]
Table 'Seginus III' 6-max Seat #5 is the button
Seat 1: MarioStar78 ($2.98 in chips) 
Seat 2: vladbratuha ($4.02 in chips) 
Seat 3: Giocoso15 ($0.20 in chips) 
Seat 4: AndrBye ($2.03 in chips) 
Seat 5: lawlex_2 ($2.92 in chips) 
Seat 6: neesTY ($1.91 in chips) 
neesTY: posts small blind $0.01
MarioStar78: posts big blind $0.02
*** HOLE CARDS ***
Dealt to lawlex_2 [5h 3h]
vladbratuha: folds 
Giocoso15: folds 
AndrBye: folds 
lawlex_2: folds 
neesTY: folds 
Uncalled bet ($0.01) returned to MarioStar78
MarioStar78 collected $0.02 from pot
MarioStar78: doesn't show hand 
*** SUMMARY ***
Total pot $0.02 | Rake $0 
Seat 1: MarioStar78 (big blind) collected ($0.02)
Seat 2: vladbratuha folded before Flop (didn't bet)
Seat 3: Giocoso15 folded before Flop (didn't bet)
Seat 4: AndrBye folded before Flop (didn't bet)
Seat 5: lawlex_2 (button) folded before Flop (didn't bet)
Seat 6: neesTY (small blind) folded before Flop



PokerStars Hand #213803242328:  Hold'em No Limit ($0.01/$0.02 USD) - 2020/05/13 19:48:48 MSK [2020/05/13 12:48:48 ET]
Table 'Seginus III' 6-max Seat #6 is the button
Seat 1: MarioStar78 ($2.99 in chips) 
Seat 2: vladbratuha ($4.02 in chips) 
Seat 3: Giocoso15 ($0.20 in chips) 
Seat 4: AndrBye ($2.03 in chips) 
Seat 5: lawlex_2 ($2.92 in chips) 
Seat 6: neesTY ($1.90 in chips) 
MarioStar78: posts small blind $0.01
vladbratuha: posts big blind $0.02
*** HOLE CARDS ***
Dealt to lawlex_2 [3s 5s]
Giocoso15: raises $0.18 to $0.20 and is all-in
AndrBye: calls $0.20
lawlex_2: folds 
neesTY: folds 
MarioStar78: calls $0.19
vladbratuha: folds 
*** FLOP *** [5c 8d 7d]
MarioStar78: bets $0.10
AndrBye: raises $0.14 to $0.24
MarioStar78: calls $0.14
*** TURN *** [5c 8d 7d] [Kh]
MarioStar78: checks 
AndrBye: checks 
*** RIVER *** [5c 8d 7d Kh] [3h]
MarioStar78: checks 
AndrBye: checks 
*** SHOW DOWN ***
MarioStar78: shows [Jc Jh] (a pair of Jacks)
AndrBye: mucks hand 
MarioStar78 collected $0.46 from side pot
Giocoso15: mucks hand 
MarioStar78 collected $0.60 from main pot
*** SUMMARY ***
Total pot $1.10 Main pot $0.60. Side pot $0.46. | Rake $0.04 
Board [5c 8d 7d Kh 3h]
Seat 1: MarioStar78 (small blind) showed [Jc Jh] and won ($1.06) with a pair of Jacks
Seat 2: vladbratuha (big blind) folded before Flop
Seat 3: Giocoso15 mucked [5h Qh]
Seat 4: AndrBye mucked [9s 9d]
Seat 5: lawlex_2 folded before Flop (didn't bet)
Seat 6: neesTY (button) folded before Flop (didn't bet)



PokerStars Hand #213803311739:  Hold'em No Limit ($0.01/$0.02 USD) - 2020/05/13 19:50:12 MSK [2020/05/13 12:50:12 ET]
Table 'Seginus III' 6-max Seat #1 is the button
Seat 1: MarioStar78 ($3.61 in chips) 
Seat 2: vladbratuha ($4 in chips) 
Seat 4: AndrBye ($2 in chips) 
Seat 5: lawlex_2 ($2.92 in chips) 
Seat 6: neesTY ($1.90 in chips) 
vladbratuha: posts small blind $0.01
AndrBye: posts big blind $0.02
*** HOLE CARDS ***
Dealt to lawlex_2 [6s 6c]
lawlex_2: raises $0.03 to $0.05
neesTY: folds 
Giocoso15 leaves the table
MarioStar78: folds 
vladbratuha: raises $0.13 to $0.18
AndrBye: raises $0.34 to $0.52
lawlex_2: folds 
jack77777777777 joins the table at seat #3 
vladbratuha: folds 
Uncalled bet ($0.34) returned to AndrBye
AndrBye collected $0.41 from pot
AndrBye: doesn't show hand 
*** SUMMARY ***
Total pot $0.41 | Rake $0 
Seat 1: MarioStar78 (button) folded before Flop (didn't bet)
Seat 2: vladbratuha (small blind) folded before Flop
Seat 4: AndrBye (big blind) collected ($0.41)
Seat 5: lawlex_2 folded before Flop
Seat 6: neesTY folded before Flop (didn't bet)



PokerStars Hand #213803357082:  Hold'em No Limit ($0.01/$0.02 USD) - 2020/05/13 19:51:07 MSK [2020/05/13 12:51:07 ET]
Table 'Seginus III' 6-max Seat #2 is the button
Seat 1: MarioStar78 ($3.61 in chips) 
Seat 2: vladbratuha ($3.82 in chips) 
Seat 4: AndrBye ($2.23 in chips) 
Seat 5: lawlex_2 ($2.87 in chips) 
Seat 6: neesTY ($1.90 in chips) 
AndrBye: posts small blind $0.01
lawlex_2: posts big blind $0.02
*** HOLE CARDS ***
Dealt to lawlex_2 [Ah 8c]
neesTY: raises $0.04 to $0.06
MarioStar78: calls $0.06
vladbratuha: folds 
AndrBye: folds 
lawlex_2: folds 
*** FLOP *** [Kh Jh Ac]
neesTY: bets $0.07
MarioStar78: folds [Kd]
Uncalled bet ($0.07) returned to neesTY
neesTY collected $0.14 from pot
*** SUMMARY ***
Total pot $0.15 | Rake $0.01 
Board [Kh Jh Ac]
Seat 1: MarioStar78 folded on the Flop
Seat 2: vladbratuha (button) folded before Flop (didn't bet)
Seat 4: AndrBye (small blind) folded before Flop
Seat 5: lawlex_2 (big blind) folded before Flop
Seat 6: neesTY collected ($0.14)



PokerStars Hand #213803378967:  Hold'em No Limit ($0.01/$0.02 USD) - 2020/05/13 19:51:33 MSK [2020/05/13 12:51:33 ET]
Table 'Seginus III' 6-max Seat #4 is the button
Seat 1: MarioStar78 ($3.55 in chips) 
Seat 2: vladbratuha ($3.82 in chips) 
Seat 3: jack77777777777 ($0.80 in chips) 
Seat 4: AndrBye ($2.22 in chips) 
Seat 5: lawlex_2 ($2.85 in chips) 
Seat 6: neesTY ($1.98 in chips) 
lawlex_2: posts small blind $0.01
neesTY: posts big blind $0.02
jack77777777777: posts big blind $0.02
*** HOLE CARDS ***
Dealt to lawlex_2 [7c 9s]
MarioStar78: calls $0.02
vladbratuha: folds 
jack77777777777 has timed out
jack77777777777: checks 
AndrBye: folds 
lawlex_2: folds 
neesTY: checks 
*** FLOP *** [3h Qh 4h]
neesTY: checks 
MarioStar78: checks 
jack77777777777: checks 
*** TURN *** [3h Qh 4h] [4c]
neesTY: bets $0.04
MarioStar78: folds 
jack77777777777: calls $0.04
*** RIVER *** [3h Qh 4h 4c] [3c]
neesTY: bets $0.07
jack77777777777: raises $0.28 to $0.35
neesTY: calls $0.28
*** SHOW DOWN ***
jack77777777777: shows [4s Kd] (a full house, Fours full of Threes)
neesTY: mucks hand 
jack77777777777 collected $0.82 from pot
*** SUMMARY ***
Total pot $0.85 | Rake $0.03 
Board [3h Qh 4h 4c 3c]
Seat 1: MarioStar78 folded on the Turn
Seat 2: vladbratuha folded before Flop (didn't bet)
Seat 3: jack77777777777 showed [4s Kd] and won ($0.82) with a full house, Fours full of Threes
Seat 4: AndrBye (button) folded before Flop (didn't bet)
Seat 5: lawlex_2 (small blind) folded before Flop
Seat 6: neesTY (big blind) mucked [Jh Th]



PokerStars Hand #213803444454:  Hold'em No Limit ($0.01/$0.02 USD) - 2020/05/13 19:52:53 MSK [2020/05/13 12:52:53 ET]
Table 'Seginus III' 6-max Seat #5 is the button
Seat 1: MarioStar78 ($3.53 in chips) 
Seat 2: vladbratuha ($3.82 in chips) 
Seat 3: jack77777777777 ($1.21 in chips) 
Seat 4: AndrBye ($2.22 in chips) 
Seat 5: lawlex_2 ($2.84 in chips) 
Seat 6: neesTY ($1.57 in chips) 
neesTY: posts small blind $0.01
MarioStar78: posts big blind $0.02
*** HOLE CARDS ***
Dealt to lawlex_2 [Ah Kd]
vladbratuha: raises $0.04 to $0.06
jack77777777777: folds 
AndrBye: folds 
lawlex_2: raises $0.15 to $0.21
neesTY: folds 
MarioStar78: folds 
vladbratuha: folds 
Uncalled bet ($0.15) returned to lawlex_2
lawlex_2 collected $0.15 from pot
lawlex_2: doesn't show hand 
*** SUMMARY ***
Total pot $0.15 | Rake $0 
Seat 1: MarioStar78 (big blind) folded before Flop
Seat 2: vladbratuha folded before Flop
Seat 3: jack77777777777 folded before Flop (didn't bet)
Seat 4: AndrBye folded before Flop (didn't bet)
Seat 5: lawlex_2 (button) collected ($0.15)
Seat 6: neesTY (small blind) folded before Flop



PokerStars Hand #213803477311:  Hold'em No Limit ($0.01/$0.02 USD) - 2020/05/13 19:53:33 MSK [2020/05/13 12:53:33 ET]
Table 'Seginus III' 6-max Seat #6 is the button
Seat 1: MarioStar78 ($3.51 in chips) 
Seat 2: vladbratuha ($3.76 in chips) 
Seat 3: jack77777777777 ($1.21 in chips) 
Seat 4: AndrBye ($2.22 in chips) 
Seat 5: lawlex_2 ($2.93 in chips) 
Seat 6: neesTY ($1.56 in chips) 
MarioStar78: posts small blind $0.01
vladbratuha: posts big blind $0.02
*** HOLE CARDS ***
Dealt to lawlex_2 [Jh 3s]
jack77777777777 has timed out
jack77777777777: folds 
AndrBye: raises $0.03 to $0.05
lawlex_2: folds 
neesTY: folds 
MarioStar78: folds 
vladbratuha: folds 
Uncalled bet ($0.03) returned to AndrBye
AndrBye collected $0.05 from pot
AndrBye: doesn't show hand 
*** SUMMARY ***
Total pot $0.05 | Rake $0 
Seat 1: MarioStar78 (small blind) folded before Flop
Seat 2: vladbratuha (big blind) folded before Flop
Seat 3: jack77777777777 folded before Flop (didn't bet)
Seat 4: AndrBye collected ($0.05)
Seat 5: lawlex_2 folded before Flop (didn't bet)
Seat 6: neesTY (button) folded before Flop (didn't bet)



PokerStars Hand #213803493425:  Hold'em No Limit ($0.01/$0.02 USD) - 2020/05/13 19:53:53 MSK [2020/05/13 12:53:53 ET]
Table 'Seginus III' 6-max Seat #1 is the button
Seat 1: MarioStar78 ($3.50 in chips) 
Seat 2: vladbratuha ($3.74 in chips) 
Seat 3: jack77777777777 ($1.21 in chips) 
Seat 4: AndrBye ($2.25 in chips) 
Seat 5: lawlex_2 ($2.93 in chips) 
Seat 6: neesTY ($1.56 in chips) 
vladbratuha: posts small blind $0.01
jack77777777777: posts big blind $0.02
*** HOLE CARDS ***
Dealt to lawlex_2 [Ah 4s]
AndrBye: raises $0.02 to $0.04
lawlex_2: folds 
neesTY: raises $1.52 to $1.56 and is all-in
MarioStar78: folds 
vladbratuha: folds 
jack77777777777: folds 
AndrBye: folds 
Uncalled bet ($1.52) returned to neesTY
neesTY collected $0.11 from pot
*** SUMMARY ***
Total pot $0.11 | Rake $0 
Seat 1: MarioStar78 (button) folded before Flop (didn't bet)
Seat 2: vladbratuha (small blind) folded before Flop
Seat 3: jack77777777777 (big blind) folded before Flop
Seat 4: AndrBye folded before Flop
Seat 5: lawlex_2 folded before Flop (didn't bet)
Seat 6: neesTY collected ($0.11)



PokerStars Hand #213803514519:  Hold'em No Limit ($0.01/$0.02 USD) - 2020/05/13 19:54:17 MSK [2020/05/13 12:54:17 ET]
Table 'Seginus III' 6-max Seat #2 is the button
Seat 1: MarioStar78 ($3.50 in chips) 
Seat 2: vladbratuha ($3.73 in chips) 
Seat 3: jack77777777777 ($1.19 in chips) 
Seat 5: lawlex_2 ($2.93 in chips) 
Seat 6: neesTY ($1.63 in chips) 
jack77777777777: posts small blind $0.01
AndrBye: is sitting out 
lawlex_2: posts big blind $0.02
*** HOLE CARDS ***
Dealt to lawlex_2 [Tc 5d]
AndrBye leaves the table
neesTY: folds 
MarioStar78: folds 
vladbratuha: folds 
jack77777777777: folds 
Uncalled bet ($0.01) returned to lawlex_2
lawlex_2 collected $0.02 from pot
lawlex_2: doesn't show hand 
*** SUMMARY ***
Total pot $0.02 | Rake $0 
Seat 1: MarioStar78 folded before Flop (didn't bet)
Seat 2: vladbratuha (button) folded before Flop (didn't bet)
Seat 3: jack77777777777 (small blind) folded before Flop
Seat 5: lawlex_2 (big blind) collected ($0.02)
Seat 6: neesTY folded before Flop (didn't bet)



PokerStars Hand #213803525604:  Hold'em No Limit ($0.01/$0.02 USD) - 2020/05/13 19:54:30 MSK [2020/05/13 12:54:30 ET]
Table 'Seginus III' 6-max Seat #3 is the button
Seat 1: MarioStar78 ($3.50 in chips) 
Seat 2: vladbratuha ($3.73 in chips) 
Seat 3: jack77777777777 ($1.18 in chips) 
Seat 5: lawlex_2 ($2.94 in chips) 
Seat 6: neesTY ($1.63 in chips) 
lawlex_2: posts small blind $0.01
neesTY: posts big blind $0.02
*** HOLE CARDS ***
Dealt to lawlex_2 [Ks Kd]
MarioStar78: folds 
vladbratuha: folds 
jack77777777777: folds 
lawlex_2: raises $0.03 to $0.05
neesTY: folds 
Uncalled bet ($0.03) returned to lawlex_2
lawlex_2 collected $0.04 from pot
lawlex_2: doesn't show hand 
*** SUMMARY ***
Total pot $0.04 | Rake $0 
Seat 1: MarioStar78 folded before Flop (didn't bet)
Seat 2: vladbratuha folded before Flop (didn't bet)
Seat 3: jack77777777777 (button) folded before Flop (didn't bet)
Seat 5: lawlex_2 (small blind) collected ($0.04)
Seat 6: neesTY (big blind) folded before Flop



PokerStars Hand #213803539204:  Hold'em No Limit ($0.01/$0.02 USD) - 2020/05/13 19:54:47 MSK [2020/05/13 12:54:47 ET]
Table 'Seginus III' 6-max Seat #5 is the button
Seat 1: MarioStar78 ($3.50 in chips) 
Seat 2: vladbratuha ($3.73 in chips) 
Seat 3: jack77777777777 ($1.18 in chips) 
Seat 5: lawlex_2 ($2.96 in chips) 
Seat 6: neesTY ($1.61 in chips) 
neesTY: posts small blind $0.01
MarioStar78: posts big blind $0.02
*** HOLE CARDS ***
Dealt to lawlex_2 [3c 5c]
vladbratuha: folds 
wagggo joins the table at seat #4 
jack77777777777: folds 
lawlex_2: folds 
neesTY: folds 
Uncalled bet ($0.01) returned to MarioStar78
MarioStar78 collected $0.02 from pot
MarioStar78: doesn't show hand 
*** SUMMARY ***
Total pot $0.02 | Rake $0 
Seat 1: MarioStar78 (big blind) collected ($0.02)
Seat 2: vladbratuha folded before Flop (didn't bet)
Seat 3: jack77777777777 folded before Flop (didn't bet)
Seat 5: lawlex_2 (button) folded before Flop (didn't bet)
Seat 6: neesTY (small blind) folded before Flop



PokerStars Hand #213803546171:  Hold'em No Limit ($0.01/$0.02 USD) - 2020/05/13 19:54:56 MSK [2020/05/13 12:54:56 ET]
Table 'Seginus III' 6-max Seat #6 is the button
Seat 1: MarioStar78 ($3.51 in chips) 
Seat 2: vladbratuha ($3.73 in chips) 
Seat 3: jack77777777777 ($1.18 in chips) 
Seat 5: lawlex_2 ($2.96 in chips) 
Seat 6: neesTY ($1.60 in chips) 
MarioStar78: posts small blind $0.01
vladbratuha: posts big blind $0.02
wagggo: sits out 
*** HOLE CARDS ***
Dealt to lawlex_2 [2h 6d]
jack77777777777: calls $0.02
lawlex_2: folds 
neesTY: folds 
MarioStar78: calls $0.01
vladbratuha: checks 
*** FLOP *** [Ac 2c 4h]
MarioStar78: bets $0.02
vladbratuha: calls $0.02
jack77777777777: folds 
*** TURN *** [Ac 2c 4h] [6s]
MarioStar78: bets $0.02
vladbratuha: calls $0.02
*** RIVER *** [Ac 2c 4h 6s] [7d]
MarioStar78: checks 
vladbratuha: checks 
*** SHOW DOWN ***
MarioStar78: shows [5h 4d] (a pair of Fours)
vladbratuha: shows [As 3d] (a pair of Aces)
vladbratuha collected $0.14 from pot
*** SUMMARY ***
Total pot $0.14 | Rake $0 
Board [Ac 2c 4h 6s 7d]
Seat 1: MarioStar78 (small blind) showed [5h 4d] and lost with a pair of Fours
Seat 2: vladbratuha (big blind) showed [As 3d] and won ($0.14) with a pair of Aces
Seat 3: jack77777777777 folded on the Flop
Seat 5: lawlex_2 folded before Flop (didn't bet)
Seat 6: neesTY (button) folded before Flop (didn't bet)



PokerStars Hand #213803576228:  Hold'em No Limit ($0.01/$0.02 USD) - 2020/05/13 19:55:41 MSK [2020/05/13 12:55:41 ET]
Table 'Seginus III' 6-max Seat #1 is the button
Seat 1: MarioStar78 ($3.45 in chips) 
Seat 2: vladbratuha ($3.81 in chips) 
Seat 3: jack77777777777 ($1.16 in chips) 
Seat 5: lawlex_2 ($2.96 in chips) 
Seat 6: neesTY ($1.60 in chips) 
vladbratuha: posts small blind $0.01
jack77777777777: posts big blind $0.02
wagggo: sits out 
*** HOLE CARDS ***
Dealt to lawlex_2 [Jc 6c]
lawlex_2: folds 
neesTY: folds 
MarioStar78: folds 
vladbratuha: folds 
Uncalled bet ($0.01) returned to jack77777777777
jack77777777777 collected $0.02 from pot
*** SUMMARY ***
Total pot $0.02 | Rake $0 
Seat 1: MarioStar78 (button) folded before Flop (didn't bet)
Seat 2: vladbratuha (small blind) folded before Flop
Seat 3: jack77777777777 (big blind) collected ($0.02)
Seat 5: lawlex_2 folded before Flop (didn't bet)
Seat 6: neesTY folded before Flop (didn't bet)



PokerStars Hand #213803583150:  Hold'em No Limit ($0.01/$0.02 USD) - 2020/05/13 19:55:52 MSK [2020/05/13 12:55:52 ET]
Table 'Seginus III' 6-max Seat #2 is the button
Seat 1: MarioStar78 ($3.45 in chips) 
Seat 2: vladbratuha ($3.80 in chips) 
Seat 3: jack77777777777 ($1.17 in chips) 
Seat 4: wagggo ($0.80 in chips) 
Seat 5: lawlex_2 ($2.96 in chips) 
Seat 6: neesTY ($1.60 in chips) 
jack77777777777: posts small blind $0.01
wagggo: posts big blind $0.02
*** HOLE CARDS ***
Dealt to lawlex_2 [9c 6c]
lawlex_2: folds 
neesTY: folds 
MarioStar78: raises $0.02 to $0.04
vladbratuha: folds 
jack77777777777: folds 
wagggo: calls $0.02
*** FLOP *** [8d Ac 7h]
wagggo: checks 
MarioStar78: bets $0.06
wagggo: folds 
Uncalled bet ($0.06) returned to MarioStar78
MarioStar78 collected $0.09 from pot
MarioStar78: doesn't show hand 
*** SUMMARY ***
Total pot $0.09 | Rake $0 
Board [8d Ac 7h]
Seat 1: MarioStar78 collected ($0.09)
Seat 2: vladbratuha (button) folded before Flop (didn't bet)
Seat 3: jack77777777777 (small blind) folded before Flop
Seat 4: wagggo (big blind) folded on the Flop
Seat 5: lawlex_2 folded before Flop (didn't bet)
Seat 6: neesTY folded before Flop (didn't bet)



PokerStars Hand #213803599519:  Hold'em No Limit ($0.01/$0.02 USD) - 2020/05/13 19:56:18 MSK [2020/05/13 12:56:18 ET]
Table 'Seginus III' 6-max Seat #3 is the button
Seat 1: MarioStar78 ($3.50 in chips) 
Seat 2: vladbratuha ($3.80 in chips) 
Seat 3: jack77777777777 ($1.16 in chips) 
Seat 4: wagggo ($0.76 in chips) 
Seat 5: lawlex_2 ($2.96 in chips) 
Seat 6: neesTY ($1.60 in chips) 
wagggo: posts small blind $0.01
lawlex_2: posts big blind $0.02
*** HOLE CARDS ***
Dealt to lawlex_2 [9h Kd]
neesTY: folds 
MarioStar78: calls $0.02
vladbratuha: folds 
jack77777777777: raises $0.10 to $0.12
wagggo: folds 
lawlex_2: folds 
MarioStar78: folds 
Uncalled bet ($0.10) returned to jack77777777777
jack77777777777 collected $0.07 from pot
*** SUMMARY ***
Total pot $0.07 | Rake $0 
Seat 1: MarioStar78 folded before Flop
Seat 2: vladbratuha folded before Flop (didn't bet)
Seat 3: jack77777777777 (button) collected ($0.07)
Seat 4: wagggo (small blind) folded before Flop
Seat 5: lawlex_2 (big blind) folded before Flop
Seat 6: neesTY folded before Flop (didn't bet)



PokerStars Hand #213803613332:  Hold'em No Limit ($0.01/$0.02 USD) - 2020/05/13 19:56:40 MSK [2020/05/13 12:56:40 ET]
Table 'Seginus III' 6-max Seat #4 is the button
Seat 1: MarioStar78 ($3.48 in chips) 
Seat 2: vladbratuha ($3.80 in chips) 
Seat 3: jack77777777777 ($1.21 in chips) 
Seat 4: wagggo ($0.75 in chips) 
Seat 5: lawlex_2 ($2.94 in chips) 
Seat 6: neesTY ($1.60 in chips) 
lawlex_2: posts small blind $0.01
neesTY: posts big blind $0.02
*** HOLE CARDS ***
Dealt to lawlex_2 [4s 7h]
MarioStar78: folds 
vladbratuha: folds 
jack77777777777: raises $0.04 to $0.06
wagggo: calls $0.06
lawlex_2: folds 
neesTY: folds 
*** FLOP *** [2d As 3h]
jack77777777777: checks 
wagggo: bets $0.02
jack77777777777: calls $0.02
*** TURN *** [2d As 3h] [Td]
jack77777777777: checks 
wagggo: bets $0.18
jack77777777777: calls $0.18
*** RIVER *** [2d As 3h Td] [Kh]
jack77777777777: checks 
wagggo: bets $0.49 and is all-in
jack77777777777: calls $0.49
*** SHOW DOWN ***
wagggo: shows [Kc Ks] (three of a kind, Kings)
jack77777777777: shows [Qh Qc] (a pair of Queens)
wagggo collected $1.48 from pot
*** SUMMARY ***
Total pot $1.53 | Rake $0.05 
Board [2d As 3h Td Kh]
Seat 1: MarioStar78 folded before Flop (didn't bet)
Seat 2: vladbratuha folded before Flop (didn't bet)
Seat 3: jack77777777777 showed [Qh Qc] and lost with a pair of Queens
Seat 4: wagggo (button) showed [Kc Ks] and won ($1.48) with three of a kind, Kings
Seat 5: lawlex_2 (small blind) folded before Flop
Seat 6: neesTY (big blind) folded before Flop



PokerStars Hand #213803651759:  Hold'em No Limit ($0.01/$0.02 USD) - 2020/05/13 19:57:40 MSK [2020/05/13 12:57:40 ET]
Table 'Seginus III' 6-max Seat #5 is the button
Seat 1: MarioStar78 ($3.48 in chips) 
Seat 2: vladbratuha ($3.80 in chips) 
Seat 3: jack77777777777 ($0.46 in chips) 
Seat 4: wagggo ($1.48 in chips) 
Seat 5: lawlex_2 ($2.93 in chips) 
Seat 6: neesTY ($1.58 in chips) 
neesTY: posts small blind $0.01
MarioStar78: posts big blind $0.02
*** HOLE CARDS ***
Dealt to lawlex_2 [Ac 4h]
vladbratuha: folds 
jack77777777777: folds 
wagggo has timed out
wagggo: folds 
lawlex_2: raises $0.03 to $0.05
neesTY: folds 
MarioStar78: folds 
Uncalled bet ($0.03) returned to lawlex_2
lawlex_2 collected $0.05 from pot
lawlex_2: doesn't show hand 
*** SUMMARY ***
Total pot $0.05 | Rake $0 
Seat 1: MarioStar78 (big blind) folded before Flop
Seat 2: vladbratuha folded before Flop (didn't bet)
Seat 3: jack77777777777 folded before Flop (didn't bet)
Seat 4: wagggo folded before Flop (didn't bet)
Seat 5: lawlex_2 (button) collected ($0.05)
Seat 6: neesTY (small blind) folded before Flop



PokerStars Hand #213803668014:  Hold'em No Limit ($0.01/$0.02 USD) - 2020/05/13 19:57:59 MSK [2020/05/13 12:57:59 ET]
Table 'Seginus III' 6-max Seat #6 is the button
Seat 1: MarioStar78 ($3.46 in chips) 
Seat 2: vladbratuha ($3.80 in chips) 
Seat 3: jack77777777777 ($0.46 in chips) 
Seat 4: wagggo ($1.48 in chips) 
Seat 5: lawlex_2 ($2.96 in chips) 
Seat 6: neesTY ($1.57 in chips) 
MarioStar78: posts small blind $0.01
vladbratuha: posts big blind $0.02
*** HOLE CARDS ***
Dealt to lawlex_2 [7h 9s]
jack77777777777: raises $0.04 to $0.06
wagggo has timed out
wagggo: folds 
lawlex_2: folds 
neesTY: folds 
MarioStar78: calls $0.05
vladbratuha: folds 
*** FLOP *** [7c 9h 9c]
MarioStar78: checks 
jack77777777777: checks 
*** TURN *** [7c 9h 9c] [Jc]
MarioStar78: checks 
jack77777777777: bets $0.40 and is all-in
MarioStar78: folds 
Uncalled bet ($0.40) returned to jack77777777777
jack77777777777 collected $0.14 from pot
*** SUMMARY ***
Total pot $0.14 | Rake $0 
Board [7c 9h 9c Jc]
Seat 1: MarioStar78 (small blind) folded on the Turn
Seat 2: vladbratuha (big blind) folded before Flop
Seat 3: jack77777777777 collected ($0.14)
Seat 4: wagggo folded before Flop (didn't bet)
Seat 5: lawlex_2 folded before Flop (didn't bet)
Seat 6: neesTY (button) folded before Flop (didn't bet)



PokerStars Hand #213803688412:  Hold'em No Limit ($0.01/$0.02 USD) - 2020/05/13 19:58:31 MSK [2020/05/13 12:58:31 ET]
Table 'Seginus III' 6-max Seat #1 is the button
Seat 1: MarioStar78 ($3.40 in chips) 
Seat 2: vladbratuha ($3.78 in chips) 
Seat 3: jack77777777777 ($0.54 in chips) 
Seat 5: lawlex_2 ($2.96 in chips) 
Seat 6: neesTY ($1.57 in chips) 
vladbratuha: posts small blind $0.01
jack77777777777: posts big blind $0.02
*** HOLE CARDS ***
Dealt to lawlex_2 [3h 6s]
wagggo is disconnected 
lawlex_2: folds 
neesTY: folds 
MarioStar78: raises $0.02 to $0.04
vladbratuha: folds 
jack77777777777: calls $0.02
*** FLOP *** [Qc Qd 9h]
jack77777777777: checks 
MarioStar78: checks 
*** TURN *** [Qc Qd 9h] [Ad]
jack77777777777: checks 
MarioStar78: bets $0.04
jack77777777777: calls $0.04
*** RIVER *** [Qc Qd 9h Ad] [Ks]
jack77777777777: checks 
MarioStar78: checks 
*** SHOW DOWN ***
jack77777777777: shows [9s 6c] (two pair, Queens and Nines)
MarioStar78: mucks hand 
jack77777777777 collected $0.16 from pot
*** SUMMARY ***
Total pot $0.17 | Rake $0.01 
Board [Qc Qd 9h Ad Ks]
Seat 1: MarioStar78 (button) mucked [5d 5h]
Seat 2: vladbratuha (small blind) folded before Flop
Seat 3: jack77777777777 (big blind) showed [9s 6c] and won ($0.16) with two pair, Queens and Nines
Seat 5: lawlex_2 folded before Flop (didn't bet)
Seat 6: neesTY folded before Flop (didn't bet)



PokerStars Hand #213803719392:  Hold'em No Limit ($0.01/$0.02 USD) - 2020/05/13 19:59:19 MSK [2020/05/13 12:59:19 ET]
Table 'Seginus III' 6-max Seat #2 is the button
Seat 1: MarioStar78 ($3.32 in chips) 
Seat 2: vladbratuha ($3.77 in chips) 
Seat 3: jack77777777777 ($0.62 in chips) 
Seat 4: wagggo ($1.48 in chips) 
Seat 5: lawlex_2 ($2.96 in chips) 
Seat 6: neesTY ($1.57 in chips) 
jack77777777777: posts small blind $0.01
wagggo: posts big blind $0.02
*** HOLE CARDS ***
Dealt to lawlex_2 [Ad 9c]
lawlex_2: raises $0.03 to $0.05
neesTY: folds 
MarioStar78: folds 
vladbratuha: raises $0.11 to $0.16
jack77777777777: folds 
wagggo: folds 
lawlex_2: folds 
Uncalled bet ($0.11) returned to vladbratuha
vladbratuha collected $0.13 from pot
vladbratuha: doesn't show hand 
*** SUMMARY ***
Total pot $0.13 | Rake $0 
Seat 1: MarioStar78 folded before Flop (didn't bet)
Seat 2: vladbratuha (button) collected ($0.13)
Seat 3: jack77777777777 (small blind) folded before Flop
Seat 4: wagggo (big blind) folded before Flop
Seat 5: lawlex_2 folded before Flop
Seat 6: neesTY folded before Flop (didn't bet)



PokerStars Hand #213803729558:  Hold'em No Limit ($0.01/$0.02 USD) - 2020/05/13 19:59:36 MSK [2020/05/13 12:59:36 ET]
Table 'Seginus III' 6-max Seat #3 is the button
Seat 1: MarioStar78 ($3.32 in chips) 
Seat 2: vladbratuha ($3.85 in chips) 
Seat 3: jack77777777777 ($0.61 in chips) 
Seat 4: wagggo ($1.46 in chips) 
Seat 5: lawlex_2 ($2.91 in chips) 
Seat 6: neesTY ($1.57 in chips) 
wagggo: posts small blind $0.01
lawlex_2: posts big blind $0.02
*** HOLE CARDS ***
Dealt to lawlex_2 [Ah 8c]
neesTY: folds 
MarioStar78: calls $0.02
vladbratuha: folds 
jack77777777777: calls $0.02
wagggo: calls $0.01
lawlex_2: checks 
*** FLOP *** [8d Jh 2s]
wagggo: checks 
lawlex_2: bets $0.05
MarioStar78: folds 
jack77777777777: calls $0.05
wagggo: folds 
*** TURN *** [8d Jh 2s] [Ac]
wagggo leaves the table
Ivey9687 joins the table at seat #4 
lawlex_2: bets $0.11
jack77777777777: calls $0.11
*** RIVER *** [8d Jh 2s Ac] [Ts]
lawlex_2: bets $0.26
jack77777777777: raises $0.17 to $0.43 and is all-in
lawlex_2: calls $0.17
*** SHOW DOWN ***
jack77777777777: shows [Th Js] (two pair, Jacks and Tens)
lawlex_2: shows [Ah 8c] (two pair, Aces and Eights)
lawlex_2 collected $1.22 from pot
*** SUMMARY ***
Total pot $1.26 | Rake $0.04 
Board [8d Jh 2s Ac Ts]
Seat 1: MarioStar78 folded on the Flop
Seat 2: vladbratuha folded before Flop (didn't bet)
Seat 3: jack77777777777 (button) showed [Th Js] and lost with two pair, Jacks and Tens
Seat 4: wagggo (small blind) folded on the Flop
Seat 5: lawlex_2 (big blind) showed [Ah 8c] and won ($1.22) with two pair, Aces and Eights
Seat 6: neesTY folded before Flop (didn't bet)



PokerStars Hand #213803767336:  Hold'em No Limit ($0.01/$0.02 USD) - 2020/05/13 20:00:32 MSK [2020/05/13 13:00:32 ET]
Table 'Seginus III' 6-max Seat #5 is the button
Seat 1: MarioStar78 ($3.30 in chips) 
Seat 2: vladbratuha ($3.85 in chips) 
Seat 5: lawlex_2 ($3.52 in chips) 
Seat 6: neesTY ($1.57 in chips) 
neesTY: posts small blind $0.01
MarioStar78: posts big blind $0.02
Ivey9687: sits out 
*** HOLE CARDS ***
Dealt to lawlex_2 [3s Ks]
vladbratuha: folds 
lawlex_2: folds 
neesTY: calls $0.01
MarioStar78: checks 
*** FLOP *** [5c 9h 5h]
neesTY: checks 
MarioStar78: bets $0.02
neesTY: folds 
Uncalled bet ($0.02) returned to MarioStar78
MarioStar78 collected $0.04 from pot
MarioStar78: doesn't show hand 
*** SUMMARY ***
Total pot $0.04 | Rake $0 
Board [5c 9h 5h]
Seat 1: MarioStar78 (big blind) collected ($0.04)
Seat 2: vladbratuha folded before Flop (didn't bet)
Seat 5: lawlex_2 (button) folded before Flop (didn't bet)
Seat 6: neesTY (small blind) folded on the Flop



PokerStars Hand #213803778647:  Hold'em No Limit ($0.01/$0.02 USD) - 2020/05/13 20:00:48 MSK [2020/05/13 13:00:48 ET]
Table 'Seginus III' 6-max Seat #6 is the button
Seat 1: MarioStar78 ($3.32 in chips) 
Seat 2: vladbratuha ($3.85 in chips) 
Seat 5: lawlex_2 ($3.52 in chips) 
Seat 6: neesTY ($1.55 in chips) 
MarioStar78: posts small blind $0.01
vladbratuha: posts big blind $0.02
Ivey9687: sits out 
*** HOLE CARDS ***
Dealt to lawlex_2 [6h 4c]
lawlex_2: folds 
neesTY: calls $0.02
MarioStar78: calls $0.01
vladbratuha: checks 
*** FLOP *** [Js 5h 7h]
MarioStar78: checks 
vladbratuha: checks 
neesTY: checks 
*** TURN *** [Js 5h 7h] [Qs]
MarioStar78: checks 
vladbratuha: bets $0.05
neesTY: folds 
MarioStar78: folds 
Uncalled bet ($0.05) returned to vladbratuha
vladbratuha collected $0.06 from pot
vladbratuha: doesn't show hand 
*** SUMMARY ***
Total pot $0.06 | Rake $0 
Board [Js 5h 7h Qs]
Seat 1: MarioStar78 (small blind) folded on the Turn
Seat 2: vladbratuha (big blind) collected ($0.06)
Seat 5: lawlex_2 folded before Flop (didn't bet)
Seat 6: neesTY (button) folded on the Turn



PokerStars Hand #213803844983:  Hold'em No Limit ($0.01/$0.02 USD) - 2020/05/13 20:02:14 MSK [2020/05/13 13:02:14 ET]
Table 'Seginus III' 6-max Seat #1 is the button
Seat 1: MarioStar78 ($3.30 in chips) 
Seat 2: vladbratuha ($3.89 in chips) 
Seat 3: jack77777777777 ($0.80 in chips) 
Seat 5: lawlex_2 ($3.52 in chips) 
Seat 6: neesTY ($1.53 in chips) 
vladbratuha: posts small blind $0.01
jack77777777777: posts big blind $0.02
Ivey9687: sits out 
*** HOLE CARDS ***
Dealt to lawlex_2 [4s 3c]
lawlex_2: folds 
neesTY: calls $0.02
MarioStar78: raises $0.04 to $0.06
vladbratuha: folds 
jack77777777777: folds 
neesTY: folds 
Uncalled bet ($0.04) returned to MarioStar78
MarioStar78 collected $0.07 from pot
MarioStar78: doesn't show hand 
*** SUMMARY ***
Total pot $0.07 | Rake $0 
Seat 1: MarioStar78 (button) collected ($0.07)
Seat 2: vladbratuha (small blind) folded before Flop
Seat 3: jack77777777777 (big blind) folded before Flop
Seat 5: lawlex_2 folded before Flop (didn't bet)
Seat 6: neesTY folded before Flop



PokerStars Hand #213803864134:  Hold'em No Limit ($0.01/$0.02 USD) - 2020/05/13 20:02:38 MSK [2020/05/13 13:02:38 ET]
Table 'Seginus III' 6-max Seat #2 is the button
Seat 1: MarioStar78 ($3.35 in chips) 
Seat 2: vladbratuha ($3.88 in chips) 
Seat 3: jack77777777777 ($0.78 in chips) 
Seat 4: Ivey9687 ($1.60 in chips) 
Seat 5: lawlex_2 ($3.52 in chips) 
Seat 6: neesTY ($1.51 in chips) 
jack77777777777: posts small blind $0.01
Ivey9687: posts big blind $0.02
*** HOLE CARDS ***
Dealt to lawlex_2 [2c 4d]
lawlex_2: folds 
neesTY: folds 
MarioStar78: calls $0.02
vladbratuha: folds 
jack77777777777: folds 
Ivey9687: checks 
*** FLOP *** [7d 9s 4s]
Ivey9687: checks 
MarioStar78: bets $0.02
Ivey9687: calls $0.02
*** TURN *** [7d 9s 4s] [Ad]
Ivey9687: checks 
MarioStar78: bets $0.04
Ivey9687: raises $0.06 to $0.10
MarioStar78: raises $0.10 to $0.20
Ivey9687: calls $0.10
*** RIVER *** [7d 9s 4s Ad] [6s]
Ivey9687: checks 
MarioStar78: bets $0.28
Ivey9687: calls $0.28
*** SHOW DOWN ***
MarioStar78: shows [7c Ah] (two pair, Aces and Sevens)
Ivey9687: mucks hand 
MarioStar78 collected $1.01 from pot
*** SUMMARY ***
Total pot $1.05 | Rake $0.04 
Board [7d 9s 4s Ad 6s]
Seat 1: MarioStar78 showed [7c Ah] and won ($1.01) with two pair, Aces and Sevens
Seat 2: vladbratuha (button) folded before Flop (didn't bet)
Seat 3: jack77777777777 (small blind) folded before Flop
Seat 4: Ivey9687 (big blind) mucked [Jd 7s]
Seat 5: lawlex_2 folded before Flop (didn't bet)
Seat 6: neesTY folded before Flop (didn't bet)



PokerStars Hand #213803929800:  Hold'em No Limit ($0.01/$0.02 USD) - 2020/05/13 20:03:57 MSK [2020/05/13 13:03:57 ET]
Table 'Seginus III' 6-max Seat #3 is the button
Seat 1: MarioStar78 ($3.84 in chips) 
Seat 2: vladbratuha ($3.88 in chips) 
Seat 3: jack77777777777 ($0.77 in chips) 
Seat 4: Ivey9687 ($1.08 in chips) 
Seat 5: lawlex_2 ($3.52 in chips) 
Seat 6: neesTY ($1.51 in chips) 
Ivey9687: posts small blind $0.01
lawlex_2: posts big blind $0.02
*** HOLE CARDS ***
Dealt to lawlex_2 [Js 4s]
neesTY: folds 
MarioStar78: folds 
vladbratuha: raises $0.03 to $0.05
jack77777777777: folds 
Ivey9687: folds 
lawlex_2: folds 
Uncalled bet ($0.03) returned to vladbratuha
vladbratuha collected $0.05 from pot
vladbratuha: doesn't show hand 
*** SUMMARY ***
Total pot $0.05 | Rake $0 
Seat 1: MarioStar78 folded before Flop (didn't bet)
Seat 2: vladbratuha collected ($0.05)
Seat 3: jack77777777777 (button) folded before Flop (didn't bet)
Seat 4: Ivey9687 (small blind) folded before Flop
Seat 5: lawlex_2 (big blind) folded before Flop
Seat 6: neesTY folded before Flop (didn't bet)



PokerStars Hand #213803944787:  Hold'em No Limit ($0.01/$0.02 USD) - 2020/05/13 20:04:14 MSK [2020/05/13 13:04:14 ET]
Table 'Seginus III' 6-max Seat #4 is the button
Seat 1: MarioStar78 ($3.84 in chips) 
Seat 2: vladbratuha ($3.91 in chips) 
Seat 3: jack77777777777 ($0.77 in chips) 
Seat 4: Ivey9687 ($1.07 in chips) 
Seat 5: lawlex_2 ($3.50 in chips) 
Seat 6: neesTY ($1.51 in chips) 
lawlex_2: posts small blind $0.01
neesTY: posts big blind $0.02
*** HOLE CARDS ***
Dealt to lawlex_2 [8h 4d]
MarioStar78: folds 
vladbratuha: folds 
jack77777777777: folds 
Ivey9687: calls $0.02
lawlex_2: folds 
neesTY: checks 
*** FLOP *** [2c Qh Tc]
neesTY: checks 
Ivey9687: checks 
*** TURN *** [2c Qh Tc] [7c]
neesTY: checks 
Ivey9687: bets $0.10
neesTY: folds 
Uncalled bet ($0.10) returned to Ivey9687
Ivey9687 collected $0.05 from pot
Ivey9687: doesn't show hand 
*** SUMMARY ***
Total pot $0.05 | Rake $0 
Board [2c Qh Tc 7c]
Seat 1: MarioStar78 folded before Flop (didn't bet)
Seat 2: vladbratuha folded before Flop (didn't bet)
Seat 3: jack77777777777 folded before Flop (didn't bet)
Seat 4: Ivey9687 (button) collected ($0.05)
Seat 5: lawlex_2 (small blind) folded before Flop
Seat 6: neesTY (big blind) folded on the Turn



PokerStars Hand #213803974294:  Hold'em No Limit ($0.01/$0.02 USD) - 2020/05/13 20:04:50 MSK [2020/05/13 13:04:50 ET]
Table 'Seginus III' 6-max Seat #5 is the button
Seat 1: MarioStar78 ($3.84 in chips) 
Seat 2: vladbratuha ($3.91 in chips) 
Seat 3: jack77777777777 ($0.77 in chips) 
Seat 4: Ivey9687 ($1.10 in chips) 
Seat 5: lawlex_2 ($3.49 in chips) 
Seat 6: neesTY ($1.49 in chips) 
neesTY: posts small blind $0.01
MarioStar78: posts big blind $0.02
*** HOLE CARDS ***
Dealt to lawlex_2 [Th 2h]
vladbratuha: folds 
jack77777777777 has timed out
jack77777777777: folds 
Ivey9687: raises $0.04 to $0.06
lawlex_2: folds 
neesTY: calls $0.05
MarioStar78: folds 
*** FLOP *** [Ad Jd Td]
neesTY: checks 
Ivey9687: bets $0.06
neesTY: folds 
Uncalled bet ($0.06) returned to Ivey9687
Ivey9687 collected $0.14 from pot
Ivey9687: doesn't show hand 
*** SUMMARY ***
Total pot $0.14 | Rake $0 
Board [Ad Jd Td]
Seat 1: MarioStar78 (big blind) folded before Flop
Seat 2: vladbratuha folded before Flop (didn't bet)
Seat 3: jack77777777777 folded before Flop (didn't bet)
Seat 4: Ivey9687 collected ($0.14)
Seat 5: lawlex_2 (button) folded before Flop (didn't bet)
Seat 6: neesTY (small blind) folded on the Flop



PokerStars Hand #213804004000:  Hold'em No Limit ($0.01/$0.02 USD) - 2020/05/13 20:05:23 MSK [2020/05/13 13:05:23 ET]
Table 'Seginus III' 6-max Seat #6 is the button
Seat 1: MarioStar78 ($3.82 in chips) 
Seat 2: vladbratuha ($3.91 in chips) 
Seat 3: jack77777777777 ($0.77 in chips) 
Seat 4: Ivey9687 ($1.18 in chips) 
Seat 5: lawlex_2 ($3.49 in chips) 
Seat 6: neesTY ($1.43 in chips) 
MarioStar78: posts small blind $0.01
vladbratuha: posts big blind $0.02
*** HOLE CARDS ***
Dealt to lawlex_2 [9d Ks]
jack77777777777: raises $0.04 to $0.06
Ivey9687: folds 
lawlex_2: folds 
neesTY: folds 
MarioStar78: folds 
vladbratuha: folds 
Uncalled bet ($0.04) returned to jack77777777777
jack77777777777 collected $0.05 from pot
*** SUMMARY ***
Total pot $0.05 | Rake $0 
Seat 1: MarioStar78 (small blind) folded before Flop
Seat 2: vladbratuha (big blind) folded before Flop
Seat 3: jack77777777777 collected ($0.05)
Seat 4: Ivey9687 folded before Flop (didn't bet)
Seat 5: lawlex_2 folded before Flop (didn't bet)
Seat 6: neesTY (button) folded before Flop (didn't bet)



PokerStars Hand #213804015351:  Hold'em No Limit ($0.01/$0.02 USD) - 2020/05/13 20:05:36 MSK [2020/05/13 13:05:36 ET]
Table 'Seginus III' 6-max Seat #1 is the button
Seat 1: MarioStar78 ($3.81 in chips) 
Seat 2: vladbratuha ($3.89 in chips) 
Seat 3: jack77777777777 ($0.80 in chips) 
Seat 4: Ivey9687 ($1.18 in chips) 
Seat 5: lawlex_2 ($3.49 in chips) 
Seat 6: neesTY ($1.43 in chips) 
vladbratuha: posts small blind $0.01
jack77777777777: posts big blind $0.02
*** HOLE CARDS ***
Dealt to lawlex_2 [5s Jc]
Ivey9687: raises $0.04 to $0.06
lawlex_2: folds 
neesTY: folds 
MarioStar78: calls $0.06
vladbratuha: folds 
jack77777777777: calls $0.04
*** FLOP *** [Js 3s Tc]
jack77777777777: checks 
Ivey9687: checks 
MarioStar78: checks 
*** TURN *** [Js 3s Tc] [Ah]
jack77777777777: checks 
Ivey9687: bets $0.06
MarioStar78: folds 
jack77777777777: calls $0.06
*** RIVER *** [Js 3s Tc Ah] [Qd]
jack77777777777: checks 
Ivey9687: bets $0.10
jack77777777777: folds 
Uncalled bet ($0.10) returned to Ivey9687
Ivey9687 collected $0.30 from pot
Ivey9687: doesn't show hand 
*** SUMMARY ***
Total pot $0.31 | Rake $0.01 
Board [Js 3s Tc Ah Qd]
Seat 1: MarioStar78 (button) folded on the Turn
Seat 2: vladbratuha (small blind) folded before Flop
Seat 3: jack77777777777 (big blind) folded on the River
Seat 4: Ivey9687 collected ($0.30)
Seat 5: lawlex_2 folded before Flop (didn't bet)
Seat 6: neesTY folded before Flop (didn't bet)



PokerStars Hand #213804050281:  Hold'em No Limit ($0.01/$0.02 USD) - 2020/05/13 20:06:14 MSK [2020/05/13 13:06:14 ET]
Table 'Seginus III' 6-max Seat #2 is the button
Seat 1: MarioStar78 ($3.75 in chips) 
Seat 2: vladbratuha ($3.88 in chips) 
Seat 3: jack77777777777 ($0.68 in chips) 
Seat 4: Ivey9687 ($1.36 in chips) 
Seat 5: lawlex_2 ($3.49 in chips) 
Seat 6: neesTY ($1.43 in chips) 
jack77777777777: posts small blind $0.01
Ivey9687: posts big blind $0.02
*** HOLE CARDS ***
Dealt to lawlex_2 [5h 6h]
lawlex_2: folds 
neesTY: folds 
MarioStar78: calls $0.02
vladbratuha: folds 
jack77777777777: folds 
Ivey9687: checks 
*** FLOP *** [6s 8c Tc]
Ivey9687: checks 
MarioStar78: bets $0.02
Ivey9687: calls $0.02
*** TURN *** [6s 8c Tc] [9s]
Ivey9687: checks 
MarioStar78: bets $0.08
Ivey9687: folds 
Uncalled bet ($0.08) returned to MarioStar78
MarioStar78 collected $0.09 from pot
MarioStar78: doesn't show hand 
*** SUMMARY ***
Total pot $0.09 | Rake $0 
Board [6s 8c Tc 9s]
Seat 1: MarioStar78 collected ($0.09)
Seat 2: vladbratuha (button) folded before Flop (didn't bet)
Seat 3: jack77777777777 (small blind) folded before Flop
Seat 4: Ivey9687 (big blind) folded on the Turn
Seat 5: lawlex_2 folded before Flop (didn't bet)
Seat 6: neesTY folded before Flop (didn't bet)



PokerStars Hand #213804088114:  Hold'em No Limit ($0.01/$0.02 USD) - 2020/05/13 20:06:56 MSK [2020/05/13 13:06:56 ET]
Table 'Seginus III' 6-max Seat #3 is the button
Seat 1: MarioStar78 ($3.80 in chips) 
Seat 2: vladbratuha ($3.88 in chips) 
Seat 3: jack77777777777 ($0.67 in chips) 
Seat 4: Ivey9687 ($1.32 in chips) 
Seat 5: lawlex_2 ($3.49 in chips) 
Seat 6: neesTY ($1.43 in chips) 
Ivey9687: posts small blind $0.01
lawlex_2: posts big blind $0.02
*** HOLE CARDS ***
Dealt to lawlex_2 [Qd 9c]
neesTY: calls $0.02
MarioStar78: calls $0.02
vladbratuha: folds 
jack77777777777: raises $0.09 to $0.11
Ivey9687: folds 
lawlex_2: folds 
neesTY: folds 
MarioStar78: folds 
Uncalled bet ($0.09) returned to jack77777777777
jack77777777777 collected $0.09 from pot
*** SUMMARY ***
Total pot $0.09 | Rake $0 
Seat 1: MarioStar78 folded before Flop
Seat 2: vladbratuha folded before Flop (didn't bet)
Seat 3: jack77777777777 (button) collected ($0.09)
Seat 4: Ivey9687 (small blind) folded before Flop
Seat 5: lawlex_2 (big blind) folded before Flop
Seat 6: neesTY folded before Flop



PokerStars Hand #213804105863:  Hold'em No Limit ($0.01/$0.02 USD) - 2020/05/13 20:07:15 MSK [2020/05/13 13:07:15 ET]
Table 'Seginus III' 6-max Seat #4 is the button
Seat 1: MarioStar78 ($3.78 in chips) 
Seat 2: vladbratuha ($3.88 in chips) 
Seat 3: jack77777777777 ($0.74 in chips) 
Seat 4: Ivey9687 ($1.31 in chips) 
Seat 5: lawlex_2 ($3.47 in chips) 
Seat 6: neesTY ($1.41 in chips) 
lawlex_2: posts small blind $0.01
neesTY: posts big blind $0.02
*** HOLE CARDS ***
Dealt to lawlex_2 [2c 6s]
MarioStar78: folds 
vladbratuha: raises $0.04 to $0.06
jack77777777777: folds 
Ivey9687: folds 
lawlex_2: folds 
neesTY: folds 
Uncalled bet ($0.04) returned to vladbratuha
vladbratuha collected $0.05 from pot
vladbratuha: doesn't show hand 
*** SUMMARY ***
Total pot $0.05 | Rake $0 
Seat 1: MarioStar78 folded before Flop (didn't bet)
Seat 2: vladbratuha collected ($0.05)
Seat 3: jack77777777777 folded before Flop (didn't bet)
Seat 4: Ivey9687 (button) folded before Flop (didn't bet)
Seat 5: lawlex_2 (small blind) folded before Flop
Seat 6: neesTY (big blind) folded before Flop



PokerStars Hand #213804120429:  Hold'em No Limit ($0.01/$0.02 USD) - 2020/05/13 20:07:31 MSK [2020/05/13 13:07:31 ET]
Table 'Seginus III' 6-max Seat #5 is the button
Seat 1: MarioStar78 ($3.78 in chips) 
Seat 2: vladbratuha ($3.91 in chips) 
Seat 3: jack77777777777 ($0.74 in chips) 
Seat 4: Ivey9687 ($1.31 in chips) 
Seat 5: lawlex_2 ($3.46 in chips) 
Seat 6: neesTY ($1.39 in chips) 
neesTY: posts small blind $0.01
MarioStar78: posts big blind $0.02
*** HOLE CARDS ***
Dealt to lawlex_2 [7d 3h]
vladbratuha: raises $0.04 to $0.06
jack77777777777: folds 
Ivey9687: folds 
lawlex_2: folds 
neesTY: folds 
MarioStar78: calls $0.04
*** FLOP *** [Th 7s 2h]
MarioStar78: bets $0.04
vladbratuha: calls $0.04
*** TURN *** [Th 7s 2h] [Jc]
MarioStar78: bets $0.04
vladbratuha: folds 
Uncalled bet ($0.04) returned to MarioStar78
MarioStar78 collected $0.20 from pot
MarioStar78: doesn't show hand 
*** SUMMARY ***
Total pot $0.21 | Rake $0.01 
Board [Th 7s 2h Jc]
Seat 1: MarioStar78 (big blind) collected ($0.20)
Seat 2: vladbratuha folded on the Turn
Seat 3: jack77777777777 folded before Flop (didn't bet)
Seat 4: Ivey9687 folded before Flop (didn't bet)
Seat 5: lawlex_2 (button) folded before Flop (didn't bet)
Seat 6: neesTY (small blind) folded before Flop



PokerStars Hand #213804158882:  Hold'em No Limit ($0.01/$0.02 USD) - 2020/05/13 20:08:14 MSK [2020/05/13 13:08:14 ET]
Table 'Seginus III' 6-max Seat #6 is the button
Seat 1: MarioStar78 ($3.88 in chips) 
Seat 2: vladbratuha ($3.81 in chips) 
Seat 3: jack77777777777 ($0.74 in chips) 
Seat 4: Ivey9687 ($1.31 in chips) 
Seat 5: lawlex_2 ($3.46 in chips) 
Seat 6: neesTY ($1.38 in chips) 
MarioStar78: posts small blind $0.01
vladbratuha: posts big blind $0.02
*** HOLE CARDS ***
Dealt to lawlex_2 [4d 7c]
jack77777777777: calls $0.02
Ivey9687: folds 
lawlex_2: folds 
neesTY: folds 
MarioStar78: calls $0.01
vladbratuha: checks 
*** FLOP *** [Jc Qc Ac]
MarioStar78: bets $0.02
vladbratuha: folds 
jack77777777777: calls $0.02
*** TURN *** [Jc Qc Ac] [5h]
MarioStar78: bets $0.02
jack77777777777: calls $0.02
*** RIVER *** [Jc Qc Ac 5h] [Kh]
MarioStar78: bets $0.02
jack77777777777: raises $0.09 to $0.11
MarioStar78: calls $0.09
*** SHOW DOWN ***
jack77777777777: shows [Th Kd] (a straight, Ten to Ace)
MarioStar78: mucks hand 
jack77777777777 collected $0.35 from pot
*** SUMMARY ***
Total pot $0.36 | Rake $0.01 
Board [Jc Qc Ac 5h Kh]
Seat 1: MarioStar78 (small blind) mucked [Qs Jh]
Seat 2: vladbratuha (big blind) folded on the Flop
Seat 3: jack77777777777 showed [Th Kd] and won ($0.35) with a straight, Ten to Ace
Seat 4: Ivey9687 folded before Flop (didn't bet)
Seat 5: lawlex_2 folded before Flop (didn't bet)
Seat 6: neesTY (button) folded before Flop (didn't bet)



PokerStars Hand #213804192274:  Hold'em No Limit ($0.01/$0.02 USD) - 2020/05/13 20:08:51 MSK [2020/05/13 13:08:51 ET]
Table 'Seginus III' 6-max Seat #1 is the button
Seat 1: MarioStar78 ($3.71 in chips) 
Seat 2: vladbratuha ($3.79 in chips) 
Seat 3: jack77777777777 ($0.92 in chips) 
Seat 4: Ivey9687 ($1.31 in chips) 
Seat 5: lawlex_2 ($3.46 in chips) 
Seat 6: neesTY ($1.38 in chips) 
vladbratuha: posts small blind $0.01
jack77777777777: posts big blind $0.02
*** HOLE CARDS ***
Dealt to lawlex_2 [5c 3d]
Ivey9687: folds 
lawlex_2: folds 
neesTY: folds 
MarioStar78: folds 
vladbratuha: folds 
Uncalled bet ($0.01) returned to jack77777777777
jack77777777777 collected $0.02 from pot
*** SUMMARY ***
Total pot $0.02 | Rake $0 
Seat 1: MarioStar78 (button) folded before Flop (didn't bet)
Seat 2: vladbratuha (small blind) folded before Flop
Seat 3: jack77777777777 (big blind) collected ($0.02)
Seat 4: Ivey9687 folded before Flop (didn't bet)
Seat 5: lawlex_2 folded before Flop (didn't bet)
Seat 6: neesTY folded before Flop (didn't bet)



PokerStars Hand #213804211939:  Hold'em No Limit ($0.01/$0.02 USD) - 2020/05/13 20:09:07 MSK [2020/05/13 13:09:07 ET]
Table 'Seginus III' 6-max Seat #2 is the button
Seat 1: MarioStar78 ($3.71 in chips) 
Seat 2: vladbratuha ($3.78 in chips) 
Seat 3: jack77777777777 ($0.93 in chips) 
Seat 4: Ivey9687 ($1.31 in chips) 
Seat 5: lawlex_2 ($3.46 in chips) 
Seat 6: neesTY ($1.38 in chips) 
jack77777777777: posts small blind $0.01
Ivey9687: posts big blind $0.02
*** HOLE CARDS ***
Dealt to lawlex_2 [Ac Kc]
lawlex_2: raises $0.03 to $0.05
neesTY: folds 
MarioStar78: folds 
vladbratuha: folds 
jack77777777777: folds 
Ivey9687: calls $0.03
*** FLOP *** [8h 3h 7h]
Ivey9687: checks 
lawlex_2: bets $0.07
Ivey9687: folds 
Uncalled bet ($0.07) returned to lawlex_2
lawlex_2 collected $0.11 from pot
lawlex_2: doesn't show hand 
*** SUMMARY ***
Total pot $0.11 | Rake $0 
Board [8h 3h 7h]
Seat 1: MarioStar78 folded before Flop (didn't bet)
Seat 2: vladbratuha (button) folded before Flop (didn't bet)
Seat 3: jack77777777777 (small blind) folded before Flop
Seat 4: Ivey9687 (big blind) folded on the Flop
Seat 5: lawlex_2 collected ($0.11)
Seat 6: neesTY folded before Flop (didn't bet)



PokerStars Hand #213804270125:  Hold'em No Limit ($0.01/$0.02 USD) - 2020/05/13 20:10:07 MSK [2020/05/13 13:10:07 ET]
Table 'Seginus III' 6-max Seat #3 is the button
Seat 1: MarioStar78 ($3.71 in chips) 
Seat 2: vladbratuha ($3.78 in chips) 
Seat 3: jack77777777777 ($0.92 in chips) 
Seat 4: Ivey9687 ($1.26 in chips) 
Seat 5: lawlex_2 ($3.52 in chips) 
Seat 6: neesTY ($1.38 in chips) 
Ivey9687: posts small blind $0.01
lawlex_2: posts big blind $0.02
*** HOLE CARDS ***
Dealt to lawlex_2 [4d Td]
neesTY: folds 
MarioStar78: folds 
vladbratuha: raises $0.04 to $0.06
jack77777777777: folds 
Ivey9687: folds 
lawlex_2: folds 
Uncalled bet ($0.04) returned to vladbratuha
vladbratuha collected $0.05 from pot
vladbratuha: doesn't show hand 
*** SUMMARY ***
Total pot $0.05 | Rake $0 
Seat 1: MarioStar78 folded before Flop (didn't bet)
Seat 2: vladbratuha collected ($0.05)
Seat 3: jack77777777777 (button) folded before Flop (didn't bet)
Seat 4: Ivey9687 (small blind) folded before Flop
Seat 5: lawlex_2 (big blind) folded before Flop
Seat 6: neesTY folded before Flop (didn't bet)



PokerStars Hand #213804284298:  Hold'em No Limit ($0.01/$0.02 USD) - 2020/05/13 20:10:23 MSK [2020/05/13 13:10:23 ET]
Table 'Seginus III' 6-max Seat #4 is the button
Seat 1: MarioStar78 ($3.71 in chips) 
Seat 2: vladbratuha ($3.81 in chips) 
Seat 3: jack77777777777 ($0.92 in chips) 
Seat 4: Ivey9687 ($1.25 in chips) 
Seat 5: lawlex_2 ($3.50 in chips) 
Seat 6: neesTY ($1.38 in chips) 
lawlex_2: posts small blind $0.01
neesTY: posts big blind $0.02
*** HOLE CARDS ***
Dealt to lawlex_2 [Jc Tc]
MarioStar78: calls $0.02
vladbratuha: folds 
jack77777777777: raises $0.07 to $0.09
Ivey9687: folds 
lawlex_2: folds 
neesTY: folds 
MarioStar78: calls $0.07
*** FLOP *** [3d As 7h]
MarioStar78: checks 
jack77777777777: checks 
*** TURN *** [3d As 7h] [Qh]
MarioStar78: checks 
jack77777777777: bets $0.20
MarioStar78: folds 
Uncalled bet ($0.20) returned to jack77777777777
jack77777777777 collected $0.20 from pot
*** SUMMARY ***
Total pot $0.21 | Rake $0.01 
Board [3d As 7h Qh]
Seat 1: MarioStar78 folded on the Turn
Seat 2: vladbratuha folded before Flop (didn't bet)
Seat 3: jack77777777777 collected ($0.20)
Seat 4: Ivey9687 (button) folded before Flop (didn't bet)
Seat 5: lawlex_2 (small blind) folded before Flop
Seat 6: neesTY (big blind) folded before Flop



PokerStars Hand #213804325071:  Hold'em No Limit ($0.01/$0.02 USD) - 2020/05/13 20:11:09 MSK [2020/05/13 13:11:09 ET]
Table 'Seginus III' 6-max Seat #5 is the button
Seat 1: MarioStar78 ($3.62 in chips) 
Seat 2: vladbratuha ($3.81 in chips) 
Seat 3: jack77777777777 ($1.03 in chips) 
Seat 4: Ivey9687 ($1.25 in chips) 
Seat 5: lawlex_2 ($3.49 in chips) 
Seat 6: neesTY ($1.36 in chips) 
neesTY: posts small blind $0.01
MarioStar78: posts big blind $0.02
*** HOLE CARDS ***
Dealt to lawlex_2 [4h 2h]
vladbratuha: folds 
jack77777777777: raises $0.05 to $0.07
Ivey9687: calls $0.07
lawlex_2: folds 
neesTY: raises $1.29 to $1.36 and is all-in
MarioStar78: folds 
jack77777777777: calls $0.96 and is all-in
Ivey9687: folds 
Uncalled bet ($0.33) returned to neesTY
*** FLOP *** [9s Ts 5d]
*** TURN *** [9s Ts 5d] [Qh]
*** RIVER *** [9s Ts 5d Qh] [5h]
*** SHOW DOWN ***
neesTY: shows [8d 8s] (two pair, Eights and Fives)
jack77777777777: shows [Qc Ah] (two pair, Queens and Fives)
jack77777777777 collected $2.07 from pot
*** SUMMARY ***
Total pot $2.15 | Rake $0.08 
Board [9s Ts 5d Qh 5h]
Seat 1: MarioStar78 (big blind) folded before Flop
Seat 2: vladbratuha folded before Flop (didn't bet)
Seat 3: jack77777777777 showed [Qc Ah] and won ($2.07) with two pair, Queens and Fives
Seat 4: Ivey9687 folded before Flop
Seat 5: lawlex_2 (button) folded before Flop (didn't bet)
Seat 6: neesTY (small blind) showed [8d 8s] and lost with two pair, Eights and Fives



PokerStars Hand #213804369363:  Hold'em No Limit ($0.01/$0.02 USD) - 2020/05/13 20:11:59 MSK [2020/05/13 13:11:59 ET]
Table 'Seginus III' 6-max Seat #6 is the button
Seat 1: MarioStar78 ($3.60 in chips) 
Seat 2: vladbratuha ($3.81 in chips) 
Seat 3: jack77777777777 ($2.07 in chips) 
Seat 4: Ivey9687 ($1.18 in chips) 
Seat 5: lawlex_2 ($3.49 in chips) 
Seat 6: neesTY ($0.33 in chips) 
MarioStar78: posts small blind $0.01
vladbratuha: posts big blind $0.02
*** HOLE CARDS ***
Dealt to lawlex_2 [4s 9h]
jack77777777777: folds 
Ivey9687: folds 
lawlex_2: folds 
neesTY: raises $0.31 to $0.33 and is all-in
MarioStar78: calls $0.32
vladbratuha: folds 
*** FLOP *** [Jd 5h Ks]
*** TURN *** [Jd 5h Ks] [Js]
*** RIVER *** [Jd 5h Ks Js] [Td]
*** SHOW DOWN ***
MarioStar78: shows [Kd Qh] (two pair, Kings and Jacks)
neesTY: shows [Tc Qs] (two pair, Jacks and Tens)
MarioStar78 collected $0.66 from pot
*** SUMMARY ***
Total pot $0.68 | Rake $0.02 
Board [Jd 5h Ks Js Td]
Seat 1: MarioStar78 (small blind) showed [Kd Qh] and won ($0.66) with two pair, Kings and Jacks
Seat 2: vladbratuha (big blind) folded before Flop
Seat 3: jack77777777777 folded before Flop (didn't bet)
Seat 4: Ivey9687 folded before Flop (didn't bet)
Seat 5: lawlex_2 folded before Flop (didn't bet)
Seat 6: neesTY (button) showed [Tc Qs] and lost with two pair, Jacks and Tens



PokerStars Hand #213804392968:  Hold'em No Limit ($0.01/$0.02 USD) - 2020/05/13 20:12:26 MSK [2020/05/13 13:12:26 ET]
Table 'Seginus III' 6-max Seat #1 is the button
Seat 1: MarioStar78 ($3.93 in chips) 
Seat 2: vladbratuha ($3.79 in chips) 
Seat 3: jack77777777777 ($2.07 in chips) 
Seat 4: Ivey9687 ($1.18 in chips) 
Seat 5: lawlex_2 ($3.49 in chips) 
vladbratuha: posts small blind $0.01
jack77777777777: posts big blind $0.02
*** HOLE CARDS ***
Dealt to lawlex_2 [Tc 4h]
Ivey9687: raises $0.04 to $0.06
neesTY leaves the table
lawlex_2: folds 
IceAngel82 joins the table at seat #6 
MarioStar78: calls $0.06
vladbratuha: calls $0.05
jack77777777777: folds 
*** FLOP *** [9d Ts Qs]
vladbratuha: checks 
Ivey9687: bets $0.10
MarioStar78: calls $0.10
vladbratuha: folds 
*** TURN *** [9d Ts Qs] [Jh]
Ivey9687: checks 
MarioStar78: bets $0.20
Ivey9687: calls $0.20
*** RIVER *** [9d Ts Qs Jh] [3s]
Ivey9687: bets $0.24
MarioStar78: calls $0.24
*** SHOW DOWN ***
Ivey9687: shows [5s As] (a flush, Ace high)
MarioStar78: mucks hand 
Ivey9687 collected $1.24 from pot
*** SUMMARY ***
Total pot $1.28 | Rake $0.04 
Board [9d Ts Qs Jh 3s]
Seat 1: MarioStar78 (button) mucked [Kc Kh]
Seat 2: vladbratuha (small blind) folded on the Flop
Seat 3: jack77777777777 (big blind) folded before Flop
Seat 4: Ivey9687 showed [5s As] and won ($1.24) with a flush, Ace high
Seat 5: lawlex_2 folded before Flop (didn't bet)



PokerStars Hand #213804461040:  Hold'em No Limit ($0.01/$0.02 USD) - 2020/05/13 20:13:44 MSK [2020/05/13 13:13:44 ET]
Table 'Seginus III' 6-max Seat #2 is the button
Seat 1: MarioStar78 ($3.33 in chips) 
Seat 2: vladbratuha ($3.73 in chips) 
Seat 3: jack77777777777 ($2.05 in chips) 
Seat 4: Ivey9687 ($1.82 in chips) 
Seat 5: lawlex_2 ($3.49 in chips) 
jack77777777777: posts small blind $0.01
Ivey9687: posts big blind $0.02
IceAngel82: sits out 
*** HOLE CARDS ***
Dealt to lawlex_2 [2h Tc]
lawlex_2: folds 
MarioStar78 has timed out
MarioStar78: folds 
vladbratuha: folds 
jack77777777777: folds 
Uncalled bet ($0.01) returned to Ivey9687
Ivey9687 collected $0.02 from pot
Ivey9687: doesn't show hand 
*** SUMMARY ***
Total pot $0.02 | Rake $0 
Seat 1: MarioStar78 folded before Flop (didn't bet)
Seat 2: vladbratuha (button) folded before Flop (didn't bet)
Seat 3: jack77777777777 (small blind) folded before Flop
Seat 4: Ivey9687 (big blind) collected ($0.02)
Seat 5: lawlex_2 folded before Flop (didn't bet)



PokerStars Hand #213804484940:  Hold'em No Limit ($0.01/$0.02 USD) - 2020/05/13 20:14:12 MSK [2020/05/13 13:14:12 ET]
Table 'Seginus III' 6-max Seat #3 is the button
Seat 1: MarioStar78 ($3.33 in chips) 
Seat 2: vladbratuha ($3.73 in chips) 
Seat 3: jack77777777777 ($2.04 in chips) 
Seat 4: Ivey9687 ($1.83 in chips) 
Seat 5: lawlex_2 ($3.49 in chips) 
Ivey9687: posts small blind $0.01
lawlex_2: posts big blind $0.02
IceAngel82: sits out 
*** HOLE CARDS ***
Dealt to lawlex_2 [7h 6h]
MarioStar78: folds 
vladbratuha: folds 
jack77777777777 has timed out
jack77777777777: folds 
Ivey9687: raises $0.04 to $0.06
lawlex_2: folds 
Uncalled bet ($0.04) returned to Ivey9687
Ivey9687 collected $0.04 from pot
Ivey9687: doesn't show hand 
*** SUMMARY ***
Total pot $0.04 | Rake $0 
Seat 1: MarioStar78 folded before Flop (didn't bet)
Seat 2: vladbratuha folded before Flop (didn't bet)
Seat 3: jack77777777777 (button) folded before Flop (didn't bet)
Seat 4: Ivey9687 (small blind) collected ($0.04)
Seat 5: lawlex_2 (big blind) folded before Flop



PokerStars Hand #213804508945:  Hold'em No Limit ($0.01/$0.02 USD) - 2020/05/13 20:14:39 MSK [2020/05/13 13:14:39 ET]
Table 'Seginus III' 6-max Seat #4 is the button
Seat 1: MarioStar78 ($3.33 in chips) 
Seat 2: vladbratuha ($3.73 in chips) 
Seat 3: jack77777777777 ($2.04 in chips) 
Seat 4: Ivey9687 ($1.85 in chips) 
Seat 5: lawlex_2 ($3.47 in chips) 
Seat 6: IceAngel82 ($2 in chips) 
lawlex_2: posts small blind $0.01
IceAngel82: posts big blind $0.02
*** HOLE CARDS ***
Dealt to lawlex_2 [Qd 5c]
MarioStar78: folds 
vladbratuha: raises $0.04 to $0.06
jack77777777777: calls $0.06
Ivey9687: folds 
lawlex_2: folds 
IceAngel82: folds 
*** FLOP *** [Ac Jh 3s]
vladbratuha: checks 
jack77777777777: bets $0.07
vladbratuha: folds 
Uncalled bet ($0.07) returned to jack77777777777
jack77777777777 collected $0.14 from pot
*** SUMMARY ***
Total pot $0.15 | Rake $0.01 
Board [Ac Jh 3s]
Seat 1: MarioStar78 folded before Flop (didn't bet)
Seat 2: vladbratuha folded on the Flop
Seat 3: jack77777777777 collected ($0.14)
Seat 4: Ivey9687 (button) folded before Flop (didn't bet)
Seat 5: lawlex_2 (small blind) folded before Flop
Seat 6: IceAngel82 (big blind) folded before Flop



PokerStars Hand #213804532887:  Hold'em No Limit ($0.01/$0.02 USD) - 2020/05/13 20:15:07 MSK [2020/05/13 13:15:07 ET]
Table 'Seginus III' 6-max Seat #5 is the button
Seat 1: MarioStar78 ($3.33 in chips) 
Seat 2: vladbratuha ($3.67 in chips) 
Seat 3: jack77777777777 ($2.12 in chips) 
Seat 4: Ivey9687 ($1.85 in chips) 
Seat 5: lawlex_2 ($3.46 in chips) 
Seat 6: IceAngel82 ($1.98 in chips) 
IceAngel82: posts small blind $0.01
MarioStar78: posts big blind $0.02
*** HOLE CARDS ***
Dealt to lawlex_2 [7h 8h]
vladbratuha: folds 
jack77777777777: folds 
Ivey9687: raises $0.04 to $0.06
lawlex_2: folds 
IceAngel82: folds 
MarioStar78: calls $0.04
*** FLOP *** [9h Td 5d]
MarioStar78: checks 
Ivey9687: checks 
*** TURN *** [9h Td 5d] [8d]
MarioStar78: bets $0.04
Ivey9687: raises $0.06 to $0.10
MarioStar78: calls $0.06
*** RIVER *** [9h Td 5d 8d] [3s]
MarioStar78: checks 
Ivey9687: checks 
*** SHOW DOWN ***
MarioStar78: shows [Kd Kc] (a pair of Kings)
Ivey9687: mucks hand 
MarioStar78 collected $0.32 from pot
*** SUMMARY ***
Total pot $0.33 | Rake $0.01 
Board [9h Td 5d 8d 3s]
Seat 1: MarioStar78 (big blind) showed [Kd Kc] and won ($0.32) with a pair of Kings
Seat 2: vladbratuha folded before Flop (didn't bet)
Seat 3: jack77777777777 folded before Flop (didn't bet)
Seat 4: Ivey9687 mucked [8s Ah]
Seat 5: lawlex_2 (button) folded before Flop (didn't bet)
Seat 6: IceAngel82 (small blind) folded before Flop



PokerStars Hand #213804570093:  Hold'em No Limit ($0.01/$0.02 USD) - 2020/05/13 20:15:49 MSK [2020/05/13 13:15:49 ET]
Table 'Seginus III' 6-max Seat #6 is the button
Seat 1: MarioStar78 ($3.49 in chips) 
Seat 2: vladbratuha ($3.67 in chips) 
Seat 3: jack77777777777 ($2.12 in chips) 
Seat 4: Ivey9687 ($1.69 in chips) 
Seat 5: lawlex_2 ($3.46 in chips) 
Seat 6: IceAngel82 ($1.97 in chips) 
MarioStar78: posts small blind $0.01
vladbratuha: posts big blind $0.02
*** HOLE CARDS ***
Dealt to lawlex_2 [8s Th]
jack77777777777: calls $0.02
Ivey9687: folds 
lawlex_2: folds 
IceAngel82: folds 
MarioStar78: calls $0.01
vladbratuha: checks 
*** FLOP *** [3d Ah Qc]
MarioStar78: checks 
vladbratuha: checks 
jack77777777777: bets $0.02
MarioStar78: folds 
vladbratuha: folds 
Uncalled bet ($0.02) returned to jack77777777777
jack77777777777 collected $0.06 from pot
*** SUMMARY ***
Total pot $0.06 | Rake $0 
Board [3d Ah Qc]
Seat 1: MarioStar78 (small blind) folded on the Flop
Seat 2: vladbratuha (big blind) folded on the Flop
Seat 3: jack77777777777 collected ($0.06)
Seat 4: Ivey9687 folded before Flop (didn't bet)
Seat 5: lawlex_2 folded before Flop (didn't bet)
Seat 6: IceAngel82 (button) folded before Flop (didn't bet)



PokerStars Hand #213804598312:  Hold'em No Limit ($0.01/$0.02 USD) - 2020/05/13 20:16:22 MSK [2020/05/13 13:16:22 ET]
Table 'Seginus III' 6-max Seat #1 is the button
Seat 1: MarioStar78 ($3.47 in chips) 
Seat 2: vladbratuha ($3.65 in chips) 
Seat 3: jack77777777777 ($2.16 in chips) 
Seat 4: Ivey9687 ($1.69 in chips) 
Seat 5: lawlex_2 ($3.46 in chips) 
Seat 6: IceAngel82 ($1.97 in chips) 
vladbratuha: posts small blind $0.01
jack77777777777: posts big blind $0.02
*** HOLE CARDS ***
Dealt to lawlex_2 [Kd 4d]
Ivey9687: folds 
lawlex_2: folds 
IceAngel82: folds 
MarioStar78: calls $0.02
vladbratuha: folds 
jack77777777777: checks 
*** FLOP *** [8h Td 2c]
jack77777777777: checks 
MarioStar78: bets $0.02
jack77777777777: folds 
Uncalled bet ($0.02) returned to MarioStar78
MarioStar78 collected $0.05 from pot
MarioStar78: doesn't show hand 
*** SUMMARY ***
Total pot $0.05 | Rake $0 
Board [8h Td 2c]
Seat 1: MarioStar78 (button) collected ($0.05)
Seat 2: vladbratuha (small blind) folded before Flop
Seat 3: jack77777777777 (big blind) folded on the Flop
Seat 4: Ivey9687 folded before Flop (didn't bet)
Seat 5: lawlex_2 folded before Flop (didn't bet)
Seat 6: IceAngel82 folded before Flop (didn't bet)



PokerStars Hand #213804633918:  Hold'em No Limit ($0.01/$0.02 USD) - 2020/05/13 20:17:02 MSK [2020/05/13 13:17:02 ET]
Table 'Seginus III' 6-max Seat #2 is the button
Seat 1: MarioStar78 ($3.50 in chips) 
Seat 2: vladbratuha ($3.64 in chips) 
Seat 3: jack77777777777 ($2.14 in chips) 
Seat 4: Ivey9687 ($1.69 in chips) 
Seat 5: lawlex_2 ($3.46 in chips) 
Seat 6: IceAngel82 ($1.97 in chips) 
jack77777777777: posts small blind $0.01
Ivey9687: posts big blind $0.02
*** HOLE CARDS ***
Dealt to lawlex_2 [2d Qs]
lawlex_2: folds 
IceAngel82: folds 
MarioStar78: raises $0.02 to $0.04
vladbratuha: folds 
jack77777777777: folds 
Ivey9687: calls $0.02
*** FLOP *** [Ts 9s 3s]
Ivey9687: checks 
MarioStar78: checks 
*** TURN *** [Ts 9s 3s] [Jc]
Ivey9687: bets $0.06
MarioStar78: folds 
Uncalled bet ($0.06) returned to Ivey9687
Ivey9687 collected $0.09 from pot
Ivey9687: doesn't show hand 
*** SUMMARY ***
Total pot $0.09 | Rake $0 
Board [Ts 9s 3s Jc]
Seat 1: MarioStar78 folded on the Turn
Seat 2: vladbratuha (button) folded before Flop (didn't bet)
Seat 3: jack77777777777 (small blind) folded before Flop
Seat 4: Ivey9687 (big blind) collected ($0.09)
Seat 5: lawlex_2 folded before Flop (didn't bet)
Seat 6: IceAngel82 folded before Flop (didn't bet)



PokerStars Hand #213804661268:  Hold'em No Limit ($0.01/$0.02 USD) - 2020/05/13 20:17:33 MSK [2020/05/13 13:17:33 ET]
Table 'Seginus III' 6-max Seat #3 is the button
Seat 1: MarioStar78 ($3.46 in chips) 
Seat 2: vladbratuha ($3.64 in chips) 
Seat 3: jack77777777777 ($2.13 in chips) 
Seat 4: Ivey9687 ($1.74 in chips) 
Seat 5: lawlex_2 ($3.46 in chips) 
Seat 6: IceAngel82 ($1.97 in chips) 
Ivey9687: posts small blind $0.01
lawlex_2: posts big blind $0.02
*** HOLE CARDS ***
Dealt to lawlex_2 [8d 9d]
IceAngel82: folds 
MarioStar78: folds 
vladbratuha: folds 
jack77777777777: raises $0.05 to $0.07
Ivey9687: folds 
lawlex_2: folds 
Uncalled bet ($0.05) returned to jack77777777777
jack77777777777 collected $0.05 from pot
*** SUMMARY ***
Total pot $0.05 | Rake $0 
Seat 1: MarioStar78 folded before Flop (didn't bet)
Seat 2: vladbratuha folded before Flop (didn't bet)
Seat 3: jack77777777777 (button) collected ($0.05)
Seat 4: Ivey9687 (small blind) folded before Flop
Seat 5: lawlex_2 (big blind) folded before Flop
Seat 6: IceAngel82 folded before Flop (didn't bet)



PokerStars Hand #213804679740:  Hold'em No Limit ($0.01/$0.02 USD) - 2020/05/13 20:17:54 MSK [2020/05/13 13:17:54 ET]
Table 'Seginus III' 6-max Seat #4 is the button
Seat 1: MarioStar78 ($3.46 in chips) 
Seat 2: vladbratuha ($3.64 in chips) 
Seat 3: jack77777777777 ($2.16 in chips) 
Seat 4: Ivey9687 ($1.73 in chips) 
Seat 5: lawlex_2 ($3.44 in chips) 
Seat 6: IceAngel82 ($1.97 in chips) 
lawlex_2: posts small blind $0.01
IceAngel82: posts big blind $0.02
*** HOLE CARDS ***
Dealt to lawlex_2 [Kd 7h]
MarioStar78: folds 
vladbratuha: folds 
jack77777777777: raises $0.04 to $0.06
Ivey9687: calls $0.06
lawlex_2: folds 
IceAngel82: folds 
*** FLOP *** [8c Th 2s]
jack77777777777: bets $0.07
Ivey9687: folds 
Uncalled bet ($0.07) returned to jack77777777777
jack77777777777 collected $0.14 from pot
*** SUMMARY ***
Total pot $0.15 | Rake $0.01 
Board [8c Th 2s]
Seat 1: MarioStar78 folded before Flop (didn't bet)
Seat 2: vladbratuha folded before Flop (didn't bet)
Seat 3: jack77777777777 collected ($0.14)
Seat 4: Ivey9687 (button) folded on the Flop
Seat 5: lawlex_2 (small blind) folded before Flop
Seat 6: IceAngel82 (big blind) folded before Flop



PokerStars Hand #213804704241:  Hold'em No Limit ($0.01/$0.02 USD) - 2020/05/13 20:18:22 MSK [2020/05/13 13:18:22 ET]
Table 'Seginus III' 6-max Seat #5 is the button
Seat 1: MarioStar78 ($3.46 in chips) 
Seat 2: vladbratuha ($3.64 in chips) 
Seat 3: jack77777777777 ($2.24 in chips) 
Seat 4: Ivey9687 ($1.67 in chips) 
Seat 5: lawlex_2 ($3.43 in chips) 
Seat 6: IceAngel82 ($1.95 in chips) 
IceAngel82: posts small blind $0.01
MarioStar78: posts big blind $0.02
*** HOLE CARDS ***
Dealt to lawlex_2 [Td Ts]
vladbratuha: raises $0.04 to $0.06
jack77777777777: folds 
Ivey9687: folds 
lawlex_2: calls $0.06
IceAngel82: folds 
MarioStar78: calls $0.04
*** FLOP *** [8c 7h Qc]
MarioStar78: checks 
vladbratuha: bets $0.14
lawlex_2: folds 
MarioStar78: folds 
Uncalled bet ($0.14) returned to vladbratuha
vladbratuha collected $0.18 from pot
vladbratuha: doesn't show hand 
*** SUMMARY ***
Total pot $0.19 | Rake $0.01 
Board [8c 7h Qc]
Seat 1: MarioStar78 (big blind) folded on the Flop
Seat 2: vladbratuha collected ($0.18)
Seat 3: jack77777777777 folded before Flop (didn't bet)
Seat 4: Ivey9687 folded before Flop (didn't bet)
Seat 5: lawlex_2 (button) folded on the Flop
Seat 6: IceAngel82 (small blind) folded before Flop



PokerStars Hand #213804729610:  Hold'em No Limit ($0.01/$0.02 USD) - 2020/05/13 20:18:51 MSK [2020/05/13 13:18:51 ET]
Table 'Seginus III' 6-max Seat #6 is the button
Seat 1: MarioStar78 ($3.40 in chips) 
Seat 2: vladbratuha ($3.76 in chips) 
Seat 3: jack77777777777 ($2.24 in chips) 
Seat 4: Ivey9687 ($1.67 in chips) 
Seat 5: lawlex_2 ($3.37 in chips) 
Seat 6: IceAngel82 ($1.94 in chips) 
MarioStar78: posts small blind $0.01
vladbratuha: posts big blind $0.02
*** HOLE CARDS ***
Dealt to lawlex_2 [5h Kd]
jack77777777777 has timed out
jack77777777777: folds 
Ivey9687: folds 
lawlex_2: folds 
IceAngel82: folds 
MarioStar78: calls $0.01
vladbratuha: checks 
*** FLOP *** [7h 4h As]
MarioStar78: checks 
vladbratuha: bets $0.03
MarioStar78: folds 
Uncalled bet ($0.03) returned to vladbratuha
vladbratuha collected $0.04 from pot
vladbratuha: doesn't show hand 
*** SUMMARY ***
Total pot $0.04 | Rake $0 
Board [7h 4h As]
Seat 1: MarioStar78 (small blind) folded on the Flop
Seat 2: vladbratuha (big blind) collected ($0.04)
Seat 3: jack77777777777 folded before Flop (didn't bet)
Seat 4: Ivey9687 folded before Flop (didn't bet)
Seat 5: lawlex_2 folded before Flop (didn't bet)
Seat 6: IceAngel82 (button) folded before Flop (didn't bet)



PokerStars Hand #213804770490:  Hold'em No Limit ($0.01/$0.02 USD) - 2020/05/13 20:19:38 MSK [2020/05/13 13:19:38 ET]
Table 'Seginus III' 6-max Seat #1 is the button
Seat 1: MarioStar78 ($3.38 in chips) 
Seat 2: vladbratuha ($3.78 in chips) 
Seat 3: jack77777777777 ($2.24 in chips) 
Seat 4: Ivey9687 ($1.67 in chips) 
Seat 5: lawlex_2 ($3.37 in chips) 
Seat 6: IceAngel82 ($1.94 in chips) 
vladbratuha: posts small blind $0.01
jack77777777777: posts big blind $0.02
*** HOLE CARDS ***
Dealt to lawlex_2 [Td 6h]
Ivey9687: raises $0.02 to $0.04
lawlex_2: folds 
IceAngel82: calls $0.04
MarioStar78: folds 
vladbratuha: folds 
jack77777777777: raises $0.13 to $0.17
Ivey9687: calls $0.13
IceAngel82: calls $0.13
*** FLOP *** [4c 7s 6s]
jack77777777777: bets $2.07 and is all-in
Ivey9687: folds 
IceAngel82: folds 
Uncalled bet ($2.07) returned to jack77777777777
jack77777777777 collected $0.50 from pot
*** SUMMARY ***
Total pot $0.52 | Rake $0.02 
Board [4c 7s 6s]
Seat 1: MarioStar78 (button) folded before Flop (didn't bet)
Seat 2: vladbratuha (small blind) folded before Flop
Seat 3: jack77777777777 (big blind) collected ($0.50)
Seat 4: Ivey9687 folded on the Flop
Seat 5: lawlex_2 folded before Flop (didn't bet)
Seat 6: IceAngel82 folded on the Flop



PokerStars Hand #213804807265:  Hold'em No Limit ($0.01/$0.02 USD) - 2020/05/13 20:20:20 MSK [2020/05/13 13:20:20 ET]
Table 'Seginus III' 6-max Seat #2 is the button
Seat 1: MarioStar78 ($3.38 in chips) 
Seat 2: vladbratuha ($3.77 in chips) 
Seat 3: jack77777777777 ($2.57 in chips) 
Seat 4: Ivey9687 ($1.50 in chips) 
Seat 5: lawlex_2 ($3.37 in chips) 
Seat 6: IceAngel82 ($1.77 in chips) 
jack77777777777: posts small blind $0.01
Ivey9687: posts big blind $0.02
*** HOLE CARDS ***
Dealt to lawlex_2 [4d 7s]
lawlex_2: folds 
IceAngel82: raises $0.05 to $0.07
MarioStar78: folds 
vladbratuha: folds 
jack77777777777: calls $0.06
Ivey9687: folds 
*** FLOP *** [5d 3c 5c]
jack77777777777: checks 
IceAngel82: bets $0.12
jack77777777777: calls $0.12
*** TURN *** [5d 3c 5c] [8h]
jack77777777777: checks 
IceAngel82: bets $0.30
jack77777777777: folds 
Uncalled bet ($0.30) returned to IceAngel82
IceAngel82 collected $0.39 from pot
IceAngel82: doesn't show hand 
*** SUMMARY ***
Total pot $0.40 | Rake $0.01 
Board [5d 3c 5c 8h]
Seat 1: MarioStar78 folded before Flop (didn't bet)
Seat 2: vladbratuha (button) folded before Flop (didn't bet)
Seat 3: jack77777777777 (small blind) folded on the Turn
Seat 4: Ivey9687 (big blind) folded before Flop
Seat 5: lawlex_2 folded before Flop (didn't bet)
Seat 6: IceAngel82 collected ($0.39)



PokerStars Hand #213804842701:  Hold'em No Limit ($0.01/$0.02 USD) - 2020/05/13 20:21:00 MSK [2020/05/13 13:21:00 ET]
Table 'Seginus III' 6-max Seat #3 is the button
Seat 1: MarioStar78 ($3.38 in chips) 
Seat 2: vladbratuha ($3.77 in chips) 
Seat 3: jack77777777777 ($2.38 in chips) 
Seat 4: Ivey9687 ($1.48 in chips) 
Seat 5: lawlex_2 ($3.37 in chips) 
Seat 6: IceAngel82 ($1.97 in chips) 
Ivey9687: posts small blind $0.01
lawlex_2: posts big blind $0.02
*** HOLE CARDS ***
Dealt to lawlex_2 [6s 3c]
IceAngel82: folds 
MarioStar78: folds 
vladbratuha: folds 
jack77777777777: folds 
Ivey9687: calls $0.01
lawlex_2: checks 
*** FLOP *** [8h 4h 4d]
Ivey9687: checks 
lawlex_2: checks 
*** TURN *** [8h 4h 4d] [Kd]
Ivey9687: bets $0.06
lawlex_2: folds 
Uncalled bet ($0.06) returned to Ivey9687
Ivey9687 collected $0.04 from pot
Ivey9687: doesn't show hand 
*** SUMMARY ***
Total pot $0.04 | Rake $0 
Board [8h 4h 4d Kd]
Seat 1: MarioStar78 folded before Flop (didn't bet)
Seat 2: vladbratuha folded before Flop (didn't bet)
Seat 3: jack77777777777 (button) folded before Flop (didn't bet)
Seat 4: Ivey9687 (small blind) collected ($0.04)
Seat 5: lawlex_2 (big blind) folded on the Turn
Seat 6: IceAngel82 folded before Flop (didn't bet)



PokerStars Hand #213804869119:  Hold'em No Limit ($0.01/$0.02 USD) - 2020/05/13 20:21:30 MSK [2020/05/13 13:21:30 ET]
Table 'Seginus III' 6-max Seat #4 is the button
Seat 1: MarioStar78 ($3.38 in chips) 
Seat 2: vladbratuha ($3.77 in chips) 
Seat 3: jack77777777777 ($2.38 in chips) 
Seat 4: Ivey9687 ($1.50 in chips) 
Seat 5: lawlex_2 ($3.35 in chips) 
Seat 6: IceAngel82 ($1.97 in chips) 
lawlex_2: posts small blind $0.01
IceAngel82: posts big blind $0.02
*** HOLE CARDS ***
Dealt to lawlex_2 [7d 8d]
MarioStar78: calls $0.02
vladbratuha: raises $0.06 to $0.08
jack77777777777: folds 
jack77777777777 leaves the table
Ivey9687: folds 
lawlex_2: folds 
IceAngel82: folds 
Gol! eol. Happo joins the table at seat #3 
MarioStar78: calls $0.06
*** FLOP *** [Tc 6h 5d]
MarioStar78: checks 
vladbratuha: bets $0.12
MarioStar78: folds 
Uncalled bet ($0.12) returned to vladbratuha
vladbratuha collected $0.18 from pot
vladbratuha: doesn't show hand 
*** SUMMARY ***
Total pot $0.19 | Rake $0.01 
Board [Tc 6h 5d]
Seat 1: MarioStar78 folded on the Flop
Seat 2: vladbratuha collected ($0.18)
Seat 3: jack77777777777 folded before Flop (didn't bet)
Seat 4: Ivey9687 (button) folded before Flop (didn't bet)
Seat 5: lawlex_2 (small blind) folded before Flop
Seat 6: IceAngel82 (big blind) folded before Flop



PokerStars Hand #213804918659:  Hold'em No Limit ($0.01/$0.02 USD) - 2020/05/13 20:22:26 MSK [2020/05/13 13:22:26 ET]
Table 'Seginus III' 6-max Seat #5 is the button
Seat 1: MarioStar78 ($3.30 in chips) 
Seat 2: vladbratuha ($3.87 in chips) 
Seat 3: Gol! eol. Happo ($0.80 in chips) 
Seat 4: Ivey9687 ($1.50 in chips) 
Seat 5: lawlex_2 ($3.34 in chips) 
Seat 6: IceAngel82 ($1.95 in chips) 
IceAngel82: posts small blind $0.01
MarioStar78: posts big blind $0.02
Gol! eol. Happo: posts big blind $0.02
*** HOLE CARDS ***
Dealt to lawlex_2 [8s 3h]
vladbratuha: raises $0.06 to $0.08
Gol! eol. Happo: calls $0.06
Ivey9687: folds 
lawlex_2: folds 
IceAngel82: folds 
MarioStar78: folds 
*** FLOP *** [2s 9c Js]
vladbratuha: bets $0.10
Gol! eol. Happo: calls $0.10
*** TURN *** [2s 9c Js] [2d]
vladbratuha: bets $0.25
Gol! eol. Happo: calls $0.25
*** RIVER *** [2s 9c Js 2d] [4c]
vladbratuha: bets $0.56
Gol! eol. Happo: calls $0.37 and is all-in
Uncalled bet ($0.19) returned to vladbratuha
*** SHOW DOWN ***
vladbratuha: shows [As Ah] (two pair, Aces and Deuces)
Gol! eol. Happo: shows [3c Jd] (two pair, Jacks and Deuces)
vladbratuha collected $1.57 from pot
*** SUMMARY ***
Total pot $1.63 | Rake $0.06 
Board [2s 9c Js 2d 4c]
Seat 1: MarioStar78 (big blind) folded before Flop
Seat 2: vladbratuha showed [As Ah] and won ($1.57) with two pair, Aces and Deuces
Seat 3: Gol! eol. Happo showed [3c Jd] and lost with two pair, Jacks and Deuces
Seat 4: Ivey9687 folded before Flop (didn't bet)
Seat 5: lawlex_2 (button) folded before Flop (didn't bet)
Seat 6: IceAngel82 (small blind) folded before Flop



PokerStars Hand #213804953518:  Hold'em No Limit ($0.01/$0.02 USD) - 2020/05/13 20:23:06 MSK [2020/05/13 13:23:06 ET]
Table 'Seginus III' 6-max Seat #6 is the button
Seat 1: MarioStar78 ($3.28 in chips) 
Seat 2: vladbratuha ($4.64 in chips) 
Seat 4: Ivey9687 ($1.50 in chips) 
Seat 5: lawlex_2 ($3.34 in chips) 
Seat 6: IceAngel82 ($1.94 in chips) 
MarioStar78: posts small blind $0.01
vladbratuha: posts big blind $0.02
*** HOLE CARDS ***
Dealt to lawlex_2 [Js 7h]
Ivey9687: folds 
lawlex_2: folds 
Gol! eol. Happo leaves the table
IceAngel82: raises $0.05 to $0.07
MarioStar78: folds 
vladbratuha: folds 
Uncalled bet ($0.05) returned to IceAngel82
IceAngel82 collected $0.05 from pot
IceAngel82: doesn't show hand 
*** SUMMARY ***
Total pot $0.05 | Rake $0 
Seat 1: MarioStar78 (small blind) folded before Flop
Seat 2: vladbratuha (big blind) folded before Flop
Seat 4: Ivey9687 folded before Flop (didn't bet)
Seat 5: lawlex_2 folded before Flop (didn't bet)
Seat 6: IceAngel82 (button) collected ($0.05)



PokerStars Hand #213804994539:  Hold'em No Limit ($0.01/$0.02 USD) - 2020/05/13 20:23:49 MSK [2020/05/13 13:23:49 ET]
Table 'Seginus III' 6-max Seat #1 is the button
Seat 1: MarioStar78 ($3.27 in chips) 
Seat 2: vladbratuha ($4.62 in chips) 
Seat 4: Ivey9687 ($1.50 in chips) 
Seat 5: lawlex_2 ($3.34 in chips) 
Seat 6: IceAngel82 ($1.97 in chips) 
vladbratuha: posts small blind $0.01
Ivey9687: posts big blind $0.02
*** HOLE CARDS ***
Dealt to lawlex_2 [Jd 7c]
lawlex_2: folds 
IceAngel82: raises $0.05 to $0.07
MarioStar78: folds 
vladbratuha: folds 
Ivey9687: folds 
Uncalled bet ($0.05) returned to IceAngel82
IceAngel82 collected $0.05 from pot
IceAngel82: doesn't show hand 
*** SUMMARY ***
Total pot $0.05 | Rake $0 
Seat 1: MarioStar78 (button) folded before Flop (didn't bet)
Seat 2: vladbratuha (small blind) folded before Flop
Seat 4: Ivey9687 (big blind) folded before Flop
Seat 5: lawlex_2 folded before Flop (didn't bet)
Seat 6: IceAngel82 collected ($0.05)



PokerStars Hand #213805027047:  Hold'em No Limit ($0.01/$0.02 USD) - 2020/05/13 20:24:26 MSK [2020/05/13 13:24:26 ET]
Table 'Seginus III' 6-max Seat #2 is the button
Seat 1: MarioStar78 ($3.27 in chips) 
Seat 2: vladbratuha ($4.61 in chips) 
Seat 4: Ivey9687 ($1.48 in chips) 
Seat 5: lawlex_2 ($3.34 in chips) 
Seat 6: IceAngel82 ($2 in chips) 
Ivey9687: posts small blind $0.01
lawlex_2: posts big blind $0.02
*** HOLE CARDS ***
Dealt to lawlex_2 [4c Kh]
IceAngel82: folds 
IceAngel82 leaves the table
MarioStar78: calls $0.02
vladbratuha: folds 
Ivey9687: calls $0.01
lawlex_2: checks 
*** FLOP *** [Td 4s 7h]
Ivey9687: checks 
lawlex_2: bets $0.04
MarioStar78: folds 
Dorinrus joins the table at seat #3 
Ivey9687: folds 
Uncalled bet ($0.04) returned to lawlex_2
lawlex_2 collected $0.06 from pot
lawlex_2: doesn't show hand 
*** SUMMARY ***
Total pot $0.06 | Rake $0 
Board [Td 4s 7h]
Seat 1: MarioStar78 folded on the Flop
Seat 2: vladbratuha (button) folded before Flop (didn't bet)
Seat 4: Ivey9687 (small blind) folded on the Flop
Seat 5: lawlex_2 (big blind) collected ($0.06)
Seat 6: IceAngel82 folded before Flop (didn't bet)



PokerStars Hand #213805055050:  Hold'em No Limit ($0.01/$0.02 USD) - 2020/05/13 20:24:58 MSK [2020/05/13 13:24:58 ET]
Table 'Seginus III' 6-max Seat #4 is the button
Seat 1: MarioStar78 ($3.25 in chips) 
Seat 2: vladbratuha ($4.61 in chips) 
Seat 4: Ivey9687 ($1.46 in chips) 
Seat 5: lawlex_2 ($3.38 in chips) 
lawlex_2: posts small blind $0.01
MarioStar78: posts big blind $0.02
Dorinrus: sits out 
*** HOLE CARDS ***
Dealt to lawlex_2 [9s 9h]
vladbratuha: folds 
Ivey9687: raises $0.02 to $0.04
lawlex_2: calls $0.03
MarioStar78: raises $0.06 to $0.10
Ivey9687: folds 
lawlex_2: calls $0.06
*** FLOP *** [4d 6h 2h]
lawlex_2: checks 
MarioStar78: bets $0.10
lawlex_2: folds 
Uncalled bet ($0.10) returned to MarioStar78
MarioStar78 collected $0.23 from pot
MarioStar78: doesn't show hand 
*** SUMMARY ***
Total pot $0.24 | Rake $0.01 
Board [4d 6h 2h]
Seat 1: MarioStar78 (big blind) collected ($0.23)
Seat 2: vladbratuha folded before Flop (didn't bet)
Seat 4: Ivey9687 (button) folded before Flop
Seat 5: lawlex_2 (small blind) folded on the Flop



PokerStars Hand #213805084719:  Hold'em No Limit ($0.01/$0.02 USD) - 2020/05/13 20:25:32 MSK [2020/05/13 13:25:32 ET]
Table 'Seginus III' 6-max Seat #5 is the button
Seat 1: MarioStar78 ($3.38 in chips) 
Seat 2: vladbratuha ($4.61 in chips) 
Seat 4: Ivey9687 ($1.42 in chips) 
Seat 5: lawlex_2 ($3.28 in chips) 
MarioStar78: posts small blind $0.01
vladbratuha: posts big blind $0.02
Dorinrus: sits out 
*** HOLE CARDS ***
Dealt to lawlex_2 [Js Tc]
Ivey9687: folds 
lawlex_2: calls $0.02
MarioStar78: folds 
vladbratuha: checks 
*** FLOP *** [6d Ah Ad]
vladbratuha: checks 
lawlex_2: checks 
*** TURN *** [6d Ah Ad] [6h]
vladbratuha: checks 
lawlex_2: checks 
*** RIVER *** [6d Ah Ad 6h] [4s]
vladbratuha: checks 
lawlex_2: checks 
*** SHOW DOWN ***
vladbratuha: shows [2s 2c] (two pair, Aces and Sixes)
lawlex_2: shows [Js Tc] (two pair, Aces and Sixes - Jack kicker)
lawlex_2 collected $0.05 from pot
*** SUMMARY ***
Total pot $0.05 | Rake $0 
Board [6d Ah Ad 6h 4s]
Seat 1: MarioStar78 (small blind) folded before Flop
Seat 2: vladbratuha (big blind) showed [2s 2c] and lost with two pair, Aces and Sixes
Seat 4: Ivey9687 folded before Flop (didn't bet)
Seat 5: lawlex_2 (button) showed [Js Tc] and won ($0.05) with two pair, Aces and Sixes



PokerStars Hand #213805103388:  Hold'em No Limit ($0.01/$0.02 USD) - 2020/05/13 20:25:53 MSK [2020/05/13 13:25:53 ET]
Table 'Seginus III' 6-max Seat #1 is the button
Seat 1: MarioStar78 ($3.37 in chips) 
Seat 2: vladbratuha ($4.59 in chips) 
Seat 3: Dorinrus ($2 in chips) 
Seat 4: Ivey9687 ($1.42 in chips) 
Seat 5: lawlex_2 ($3.31 in chips) 
vladbratuha: posts small blind $0.01
Dorinrus: posts big blind $0.02
*** HOLE CARDS ***
Dealt to lawlex_2 [6h 8h]
Ivey9687: folds 
lawlex_2: calls $0.02
MarioStar78: folds 
vladbratuha: folds 
Dorinrus: checks 
*** FLOP *** [Jh Th Kh]
Dzmitry28868 joins the table at seat #6 
Dorinrus: checks 
lawlex_2: bets $0.03
Dorinrus: folds 
Uncalled bet ($0.03) returned to lawlex_2
lawlex_2 collected $0.05 from pot
lawlex_2: doesn't show hand 
*** SUMMARY ***
Total pot $0.05 | Rake $0 
Board [Jh Th Kh]
Seat 1: MarioStar78 (button) folded before Flop (didn't bet)
Seat 2: vladbratuha (small blind) folded before Flop
Seat 3: Dorinrus (big blind) folded on the Flop
Seat 4: Ivey9687 folded before Flop (didn't bet)
Seat 5: lawlex_2 collected ($0.05)



PokerStars Hand #213805131774:  Hold'em No Limit ($0.01/$0.02 USD) - 2020/05/13 20:26:25 MSK [2020/05/13 13:26:25 ET]
Table 'Seginus III' 6-max Seat #2 is the button
Seat 1: MarioStar78 ($3.37 in chips) 
Seat 2: vladbratuha ($4.58 in chips) 
Seat 3: Dorinrus ($1.98 in chips) 
Seat 4: Ivey9687 ($1.42 in chips) 
Seat 5: lawlex_2 ($3.34 in chips) 
Dorinrus: posts small blind $0.01
Ivey9687: posts big blind $0.02
Dzmitry28868: sits out 
*** HOLE CARDS ***
Dealt to lawlex_2 [Td Ad]
lawlex_2: raises $0.03 to $0.05
MarioStar78: calls $0.05
vladbratuha: folds 
Dorinrus: folds 
Ivey9687: calls $0.03
*** FLOP *** [8d 8h 8c]
Ivey9687: checks 
lawlex_2: bets $0.10
MarioStar78: folds 
Ivey9687: folds 
Uncalled bet ($0.10) returned to lawlex_2
lawlex_2 collected $0.15 from pot
lawlex_2: doesn't show hand 
*** SUMMARY ***
Total pot $0.16 | Rake $0.01 
Board [8d 8h 8c]
Seat 1: MarioStar78 folded on the Flop
Seat 2: vladbratuha (button) folded before Flop (didn't bet)
Seat 3: Dorinrus (small blind) folded before Flop
Seat 4: Ivey9687 (big blind) folded on the Flop
Seat 5: lawlex_2 collected ($0.15)



PokerStars Hand #213805186972:  Hold'em No Limit ($0.01/$0.02 USD) - 2020/05/13 20:27:28 MSK [2020/05/13 13:27:28 ET]
Table 'Seginus III' 6-max Seat #3 is the button
Seat 1: MarioStar78 ($3.32 in chips) 
Seat 2: vladbratuha ($4.58 in chips) 
Seat 3: Dorinrus ($1.97 in chips) 
Seat 4: Ivey9687 ($1.37 in chips) 
Seat 5: lawlex_2 ($3.44 in chips) 
Ivey9687: posts small blind $0.01
lawlex_2: posts big blind $0.02
Dzmitry28868: sits out 
*** HOLE CARDS ***
Dealt to lawlex_2 [Jd 7h]
MarioStar78: calls $0.02
vladbratuha has timed out
vladbratuha: folds 
Dorinrus: calls $0.02
Ivey9687: calls $0.01
lawlex_2: checks 
*** FLOP *** [Ts 7d 6s]
Ivey9687: checks 
lawlex_2: checks 
MarioStar78: checks 
Dorinrus: bets $0.06
Ivey9687: folds 
lawlex_2: folds 
MarioStar78: folds 
Uncalled bet ($0.06) returned to Dorinrus
Dorinrus collected $0.08 from pot
*** SUMMARY ***
Total pot $0.08 | Rake $0 
Board [Ts 7d 6s]
Seat 1: MarioStar78 folded on the Flop
Seat 2: vladbratuha folded before Flop (didn't bet)
Seat 3: Dorinrus (button) collected ($0.08)
Seat 4: Ivey9687 (small blind) folded on the Flop
Seat 5: lawlex_2 (big blind) folded on the Flop



PokerStars Hand #213805236988:  Hold'em No Limit ($0.01/$0.02 USD) - 2020/05/13 20:28:26 MSK [2020/05/13 13:28:26 ET]
Table 'Seginus III' 6-max Seat #4 is the button
Seat 1: MarioStar78 ($3.30 in chips) 
Seat 2: vladbratuha ($4.58 in chips) 
Seat 3: Dorinrus ($2.03 in chips) 
Seat 4: Ivey9687 ($1.35 in chips) 
Seat 5: lawlex_2 ($3.42 in chips) 
Seat 6: Dzmitry28868 ($2 in chips) 
lawlex_2: posts small blind $0.01
Dzmitry28868: posts big blind $0.02
*** HOLE CARDS ***
Dealt to lawlex_2 [8h Kd]
MarioStar78: folds 
vladbratuha: folds 
Dorinrus: folds 
Ivey9687: raises $0.02 to $0.04
lawlex_2: folds 
Dzmitry28868: calls $0.02
*** FLOP *** [Ad 5s 7c]
Dzmitry28868: checks 
Ivey9687: checks 
*** TURN *** [Ad 5s 7c] [Qd]
Dzmitry28868: bets $0.05
Ivey9687: raises $0.09 to $0.14
Dzmitry28868: calls $0.09
*** RIVER *** [Ad 5s 7c Qd] [6s]
Dzmitry28868: checks 
Ivey9687: checks 
*** SHOW DOWN ***
Dzmitry28868: shows [4d 6d] (a pair of Sixes)
Ivey9687: shows [Qh 9d] (a pair of Queens)
Ivey9687 collected $0.36 from pot
*** SUMMARY ***
Total pot $0.37 | Rake $0.01 
Board [Ad 5s 7c Qd 6s]
Seat 1: MarioStar78 folded before Flop (didn't bet)
Seat 2: vladbratuha folded before Flop (didn't bet)
Seat 3: Dorinrus folded before Flop (didn't bet)
Seat 4: Ivey9687 (button) showed [Qh 9d] and won ($0.36) with a pair of Queens
Seat 5: lawlex_2 (small blind) folded before Flop
Seat 6: Dzmitry28868 (big blind) showed [4d 6d] and lost with a pair of Sixes



PokerStars Hand #213805296462:  Hold'em No Limit ($0.01/$0.02 USD) - 2020/05/13 20:29:33 MSK [2020/05/13 13:29:33 ET]
Table 'Seginus III' 6-max Seat #5 is the button
Seat 1: MarioStar78 ($3.30 in chips) 
Seat 2: vladbratuha ($4.58 in chips) 
Seat 3: Dorinrus ($2.03 in chips) 
Seat 4: Ivey9687 ($1.53 in chips) 
Seat 5: lawlex_2 ($3.41 in chips) 
Seat 6: Dzmitry28868 ($2 in chips) 
Dzmitry28868: posts small blind $0.01
MarioStar78: posts big blind $0.02
*** HOLE CARDS ***
Dealt to lawlex_2 [8d Jd]
vladbratuha: folds 
Dorinrus: folds 
Ivey9687: raises $0.04 to $0.06
lawlex_2: folds 
Dzmitry28868: folds 
MarioStar78: folds 
Uncalled bet ($0.04) returned to Ivey9687
Ivey9687 collected $0.05 from pot
Ivey9687: doesn't show hand 
*** SUMMARY ***
Total pot $0.05 | Rake $0 
Seat 1: MarioStar78 (big blind) folded before Flop
Seat 2: vladbratuha folded before Flop (didn't bet)
Seat 3: Dorinrus folded before Flop (didn't bet)
Seat 4: Ivey9687 collected ($0.05)
Seat 5: lawlex_2 (button) folded before Flop (didn't bet)
Seat 6: Dzmitry28868 (small blind) folded before Flop



PokerStars Hand #213805314860:  Hold'em No Limit ($0.01/$0.02 USD) - 2020/05/13 20:29:54 MSK [2020/05/13 13:29:54 ET]
Table 'Seginus III' 6-max Seat #6 is the button
Seat 1: MarioStar78 ($3.28 in chips) 
Seat 2: vladbratuha ($4.58 in chips) 
Seat 3: Dorinrus ($2.03 in chips) 
Seat 4: Ivey9687 ($1.56 in chips) 
Seat 5: lawlex_2 ($3.41 in chips) 
Seat 6: Dzmitry28868 ($1.99 in chips) 
MarioStar78: posts small blind $0.01
vladbratuha: posts big blind $0.02
*** HOLE CARDS ***
Dealt to lawlex_2 [2d 4c]
Dorinrus: folds 
Ivey9687: raises $0.04 to $0.06
lawlex_2: folds 
Dzmitry28868: folds 
MarioStar78: calls $0.05
vladbratuha: folds 
*** FLOP *** [Kd Ac 2c]
MarioStar78: checks 
Ivey9687: bets $0.08
MarioStar78: folds 
Uncalled bet ($0.08) returned to Ivey9687
Ivey9687 collected $0.14 from pot
Ivey9687: doesn't show hand 
*** SUMMARY ***
Total pot $0.14 | Rake $0 
Board [Kd Ac 2c]
Seat 1: MarioStar78 (small blind) folded on the Flop
Seat 2: vladbratuha (big blind) folded before Flop
Seat 3: Dorinrus folded before Flop (didn't bet)
Seat 4: Ivey9687 collected ($0.14)
Seat 5: lawlex_2 folded before Flop (didn't bet)
Seat 6: Dzmitry28868 (button) folded before Flop (didn't bet)



PokerStars Hand #213805357785:  Hold'em No Limit ($0.01/$0.02 USD) - 2020/05/13 20:30:42 MSK [2020/05/13 13:30:42 ET]
Table 'Seginus III' 6-max Seat #1 is the button
Seat 1: MarioStar78 ($3.22 in chips) 
Seat 2: vladbratuha ($4.56 in chips) 
Seat 3: Dorinrus ($2.03 in chips) 
Seat 4: Ivey9687 ($1.64 in chips) 
Seat 5: lawlex_2 ($3.41 in chips) 
Seat 6: Dzmitry28868 ($1.99 in chips) 
vladbratuha: posts small blind $0.01
Dorinrus: posts big blind $0.02
*** HOLE CARDS ***
Dealt to lawlex_2 [4c Qh]
Ivey9687: folds 
lawlex_2: folds 
Dzmitry28868: folds 
MarioStar78: raises $0.06 to $0.08
vladbratuha: folds 
Dorinrus: folds 
Uncalled bet ($0.06) returned to MarioStar78
MarioStar78 collected $0.05 from pot
MarioStar78: doesn't show hand 
*** SUMMARY ***
Total pot $0.05 | Rake $0 
Seat 1: MarioStar78 (button) collected ($0.05)
Seat 2: vladbratuha (small blind) folded before Flop
Seat 3: Dorinrus (big blind) folded before Flop
Seat 4: Ivey9687 folded before Flop (didn't bet)
Seat 5: lawlex_2 folded before Flop (didn't bet)
Seat 6: Dzmitry28868 folded before Flop (didn't bet)



PokerStars Hand #213805377895:  Hold'em No Limit ($0.01/$0.02 USD) - 2020/05/13 20:31:05 MSK [2020/05/13 13:31:05 ET]
Table 'Seginus III' 6-max Seat #2 is the button
Seat 1: MarioStar78 ($3.25 in chips) 
Seat 2: vladbratuha ($4.55 in chips) 
Seat 3: Dorinrus ($2.01 in chips) 
Seat 4: Ivey9687 ($1.64 in chips) 
Seat 5: lawlex_2 ($3.41 in chips) 
Seat 6: Dzmitry28868 ($1.99 in chips) 
Dorinrus: posts small blind $0.01
Ivey9687: posts big blind $0.02
*** HOLE CARDS ***
Dealt to lawlex_2 [Qh 2c]
lawlex_2: folds 
Dzmitry28868: folds 
MarioStar78: folds 
vladbratuha: raises $0.04 to $0.06
Dorinrus: calls $0.05
Ivey9687: folds 
*** FLOP *** [2s Kh 8s]
Dorinrus: checks 
vladbratuha: bets $0.07
Dorinrus: calls $0.07
*** TURN *** [2s Kh 8s] [9h]
Dorinrus: checks 
vladbratuha: checks 
*** RIVER *** [2s Kh 8s 9h] [6h]
Dorinrus: bets $0.27
vladbratuha: folds 
Uncalled bet ($0.27) returned to Dorinrus
Dorinrus collected $0.27 from pot
*** SUMMARY ***
Total pot $0.28 | Rake $0.01 
Board [2s Kh 8s 9h 6h]
Seat 1: MarioStar78 folded before Flop (didn't bet)
Seat 2: vladbratuha (button) folded on the River
Seat 3: Dorinrus (small blind) collected ($0.27)
Seat 4: Ivey9687 (big blind) folded before Flop
Seat 5: lawlex_2 folded before Flop (didn't bet)
Seat 6: Dzmitry28868 folded before Flop (didn't bet)



PokerStars Hand #213805421894:  Hold'em No Limit ($0.01/$0.02 USD) - 2020/05/13 20:31:54 MSK [2020/05/13 13:31:54 ET]
Table 'Seginus III' 6-max Seat #3 is the button
Seat 1: MarioStar78 ($3.25 in chips) 
Seat 2: vladbratuha ($4.42 in chips) 
Seat 3: Dorinrus ($2.15 in chips) 
Seat 4: Ivey9687 ($1.62 in chips) 
Seat 5: lawlex_2 ($3.41 in chips) 
Seat 6: Dzmitry28868 ($1.99 in chips) 
Ivey9687: posts small blind $0.01
lawlex_2: posts big blind $0.02
*** HOLE CARDS ***
Dealt to lawlex_2 [As 6d]
Dzmitry28868: folds 
MarioStar78: raises $0.04 to $0.06
vladbratuha: folds 
Dorinrus: folds 
Ivey9687: calls $0.05
lawlex_2: folds 
*** FLOP *** [Ac Qs Tc]
Ivey9687: checks 
MarioStar78: bets $0.06
Ivey9687: calls $0.06
*** TURN *** [Ac Qs Tc] [Ks]
Ivey9687: checks 
MarioStar78: bets $0.14
Ivey9687: calls $0.14
*** RIVER *** [Ac Qs Tc Ks] [2s]
Ivey9687: checks 
MarioStar78: checks 
*** SHOW DOWN ***
Ivey9687: shows [Ad 3s] (a pair of Aces)
MarioStar78: shows [Jh Ah] (a straight, Ten to Ace)
MarioStar78 collected $0.52 from pot
*** SUMMARY ***
Total pot $0.54 | Rake $0.02 
Board [Ac Qs Tc Ks 2s]
Seat 1: MarioStar78 showed [Jh Ah] and won ($0.52) with a straight, Ten to Ace
Seat 2: vladbratuha folded before Flop (didn't bet)
Seat 3: Dorinrus (button) folded before Flop (didn't bet)
Seat 4: Ivey9687 (small blind) showed [Ad 3s] and lost with a pair of Aces
Seat 5: lawlex_2 (big blind) folded before Flop
Seat 6: Dzmitry28868 folded before Flop (didn't bet)



